Poker Hand #TM3620221349: Tournament #160076712, Bounty Hunters Big One $1.08 Hold'em No Limit - Level3(80/160) - 2024/08/26 17:50:20
Table '104' 8-max Seat #4 is the button
Seat 1: a07c5d9f (12,518 in chips)
Seat 2: 14abfd9b (23,072 in chips)
Seat 3: 7abeadb8 (15,990 in chips)
Seat 4: Hero (6,849 in chips)
Seat 5: 9fbf9e18 (5,132 in chips)
Seat 6: 73f7416d (22,389 in chips)
Seat 7: 5fd3ba72 (10,744 in chips)
Seat 8: 95ab360e (2,796 in chips)
73f7416d: posts the ante 24
5fd3ba72: posts the ante 24
9fbf9e18: posts the ante 24
7abeadb8: posts the ante 24
95ab360e: posts the ante 24
Hero: posts the ante 24
a07c5d9f: posts the ante 24
14abfd9b: posts the ante 24
9fbf9e18: posts small blind 80
73f7416d: posts big blind 160
*** HOLE CARDS ***
Dealt to a07c5d9f 
Dealt to 14abfd9b 
Dealt to 7abeadb8 
Dealt to Hero [Ah Jh]
Dealt to 9fbf9e18 
Dealt to 73f7416d 
Dealt to 5fd3ba72 
Dealt to 95ab360e 
5fd3ba72: folds
95ab360e: folds
a07c5d9f: raises 160 to 320
14abfd9b: folds
7abeadb8: folds
Hero: raises 536 to 856
9fbf9e18: raises 4,252 to 5,108 and is all-in
73f7416d: folds
a07c5d9f: raises 7,386 to 12,494 and is all-in
Hero: calls 5,969 and is all-in
Uncalled bet (5,669) returned to a07c5d9f
a07c5d9f: shows [Kc As]
Hero: shows [Ah Jh]
9fbf9e18: shows [Tc Ts]
*** FLOP *** [4c 5s Kd]
*** TURN *** [4c 5s Kd] [Ac]
*** RIVER *** [4c 5s Kd Ac] [2d]
*** SHOWDOWN ***
a07c5d9f collected 15,676 from pot
a07c5d9f collected 3,434 from pot
*** SUMMARY ***
Total pot 19,110 | Rake 0 | Jackpot 0 | Bingo 0 | Fortune 0 | Tax 0
Board [4c 5s Kd Ac 2d]
Seat 1: a07c5d9f showed [Kc As] and won (19,110) with Pair of Aces and Pair of Kings
Seat 2: 14abfd9b folded before Flop
Seat 3: 7abeadb8 folded before Flop
Seat 4: Hero (button) showed [Ah Jh] and lost with Pair of Aces
Seat 5: 9fbf9e18 (small blind) showed [Tc Ts] and lost with Pair of Tens
Seat 6: 73f7416d (big blind) folded before Flop
Seat 7: 5fd3ba72 folded before Flop
Seat 8: 95ab360e folded before Flop


Poker Hand #TM3620221331: Tournament #160076712, Bounty Hunters Big One $1.08 Hold'em No Limit - Level2(60/120) - 2024/08/26 17:49:33
Table '104' 8-max Seat #3 is the button
Seat 1: a07c5d9f (12,536 in chips)
Seat 2: 14abfd9b (23,450 in chips)
Seat 3: 7abeadb8 (16,008 in chips)
Seat 4: Hero (6,927 in chips)
Seat 5: 9fbf9e18 (5,510 in chips)
Seat 6: 73f7416d (21,483 in chips)
Seat 7: 5fd3ba72 (10,762 in chips)
Seat 8: 95ab360e (2,814 in chips)
73f7416d: posts the ante 18
5fd3ba72: posts the ante 18
9fbf9e18: posts the ante 18
7abeadb8: posts the ante 18
95ab360e: posts the ante 18
a07c5d9f: posts the ante 18
Hero: posts the ante 18
14abfd9b: posts the ante 18
Hero: posts small blind 60
9fbf9e18: posts big blind 120
*** HOLE CARDS ***
Dealt to a07c5d9f 
Dealt to 14abfd9b 
Dealt to 7abeadb8 
Dealt to Hero [8d 4c]
Dealt to 9fbf9e18 
Dealt to 73f7416d 
Dealt to 5fd3ba72 
Dealt to 95ab360e 
73f7416d: calls 120
5fd3ba72: folds
95ab360e: folds
a07c5d9f: folds
14abfd9b: raises 240 to 360
7abeadb8: folds
Hero: folds
9fbf9e18: calls 240
73f7416d: calls 240
*** FLOP *** [Ah Jh Th]
9fbf9e18: checks
73f7416d: checks
14abfd9b: checks
*** TURN *** [Ah Jh Th] [9s]
9fbf9e18: checks
73f7416d: bets 642
14abfd9b: folds
9fbf9e18: folds
Uncalled bet (642) returned to 73f7416d
*** SHOWDOWN ***
73f7416d collected 1,284 from pot
*** SUMMARY ***
Total pot 1,284 | Rake 0 | Jackpot 0 | Bingo 0 | Fortune 0 | Tax 0
Board [Ah Jh Th 9s]
Seat 1: a07c5d9f folded before Flop
Seat 2: 14abfd9b folded on the Turn
Seat 3: 7abeadb8 (button) folded before Flop
Seat 4: Hero (small blind) folded before Flop
Seat 5: 9fbf9e18 (big blind) folded on the Turn
Seat 6: 73f7416d won (1,284)
Seat 7: 5fd3ba72 folded before Flop
Seat 8: 95ab360e folded before Flop


Poker Hand #TM3620221318: Tournament #160076712, Bounty Hunters Big One $1.08 Hold'em No Limit - Level2(60/120) - 2024/08/26 17:48:42
Table '104' 8-max Seat #2 is the button
Seat 1: a07c5d9f (12,554 in chips)
Seat 2: 14abfd9b (23,468 in chips)
Seat 3: 7abeadb8 (16,086 in chips)
Seat 4: Hero (9,598 in chips)
Seat 5: 9fbf9e18 (2,671 in chips)
Seat 6: 73f7416d (21,501 in chips)
Seat 7: 5fd3ba72 (10,780 in chips)
Seat 8: 95ab360e (2,832 in chips)
73f7416d: posts the ante 18
5fd3ba72: posts the ante 18
9fbf9e18: posts the ante 18
7abeadb8: posts the ante 18
95ab360e: posts the ante 18
a07c5d9f: posts the ante 18
Hero: posts the ante 18
14abfd9b: posts the ante 18
7abeadb8: posts small blind 60
Hero: posts big blind 120
*** HOLE CARDS ***
Dealt to a07c5d9f 
Dealt to 14abfd9b 
Dealt to 7abeadb8 
Dealt to Hero [8d 9d]
Dealt to 9fbf9e18 
Dealt to 73f7416d 
Dealt to 5fd3ba72 
Dealt to 95ab360e 
9fbf9e18: raises 2,533 to 2,653 and is all-in
73f7416d: folds
5fd3ba72: folds
95ab360e: folds
a07c5d9f: folds
14abfd9b: folds
7abeadb8: folds
Hero: calls 2,533
9fbf9e18: shows [Ac Th]
Hero: shows [8d 9d]
*** FLOP *** [2c Qh 9s]
*** TURN *** [2c Qh 9s] [Ks]
*** RIVER *** [2c Qh 9s Ks] [Jh]
73f7416d: shows [4s 4h] (Pair of Fours)
*** SHOWDOWN ***
9fbf9e18 collected 5,510 from pot
*** SUMMARY ***
Total pot 5,510 | Rake 0 | Jackpot 0 | Bingo 0 | Fortune 0 | Tax 0
Board [2c Qh 9s Ks Jh]
Seat 1: a07c5d9f folded before Flop
Seat 2: 14abfd9b (button) folded before Flop
Seat 3: 7abeadb8 (small blind) folded before Flop
Seat 4: Hero (big blind) showed [8d 9d] and lost with Pair of Nines
Seat 5: 9fbf9e18 showed [Ac Th] and won (5,510) with Aces-High Straight
Seat 6: 73f7416d folded before Flop
Seat 7: 5fd3ba72 folded before Flop
Seat 8: 95ab360e folded before Flop


Poker Hand #TM3620221310: Tournament #160076712, Bounty Hunters Big One $1.08 Hold'em No Limit - Level2(60/120) - 2024/08/26 17:48:06
Table '104' 8-max Seat #1 is the button
Seat 1: a07c5d9f (12,572 in chips)
Seat 2: 14abfd9b (23,606 in chips)
Seat 3: 7abeadb8 (15,840 in chips)
Seat 4: Hero (9,616 in chips)
Seat 5: 9fbf9e18 (2,689 in chips)
Seat 6: 73f7416d (21,519 in chips)
Seat 7: 5fd3ba72 (10,798 in chips)
Seat 8: 95ab360e (2,850 in chips)
73f7416d: posts the ante 18
5fd3ba72: posts the ante 18
9fbf9e18: posts the ante 18
7abeadb8: posts the ante 18
95ab360e: posts the ante 18
a07c5d9f: posts the ante 18
Hero: posts the ante 18
14abfd9b: posts the ante 18
14abfd9b: posts small blind 60
7abeadb8: posts big blind 120
*** HOLE CARDS ***
Dealt to a07c5d9f 
Dealt to 14abfd9b 
Dealt to 7abeadb8 
Dealt to Hero [Js 9d]
Dealt to 9fbf9e18 
Dealt to 73f7416d 
Dealt to 5fd3ba72 
Dealt to 95ab360e 
Hero: folds
9fbf9e18: folds
73f7416d: folds
5fd3ba72: folds
95ab360e: folds
a07c5d9f: folds
14abfd9b: calls 60
7abeadb8: checks
*** FLOP *** [3c 8c Kc]
14abfd9b: checks
7abeadb8: checks
*** TURN *** [3c 8c Kc] [Td]
14abfd9b: checks
7abeadb8: checks
*** RIVER *** [3c 8c Kc Td] [9s]
14abfd9b: checks
7abeadb8: checks
14abfd9b: shows [7s 7h] (Pair of Sevens)
7abeadb8: shows [8s 6s] (Pair of Eights)
*** SHOWDOWN ***
7abeadb8 collected 384 from pot
*** SUMMARY ***
Total pot 384 | Rake 0 | Jackpot 0 | Bingo 0 | Fortune 0 | Tax 0
Board [3c 8c Kc Td 9s]
Seat 1: a07c5d9f (button) folded before Flop
Seat 2: 14abfd9b (small blind) showed [7s 7h] and lost with Pair of Sevens
Seat 3: 7abeadb8 (big blind) showed [8s 6s] and won (384) with Pair of Eights
Seat 4: Hero folded before Flop
Seat 5: 9fbf9e18 folded before Flop
Seat 6: 73f7416d folded before Flop
Seat 7: 5fd3ba72 folded before Flop
Seat 8: 95ab360e folded before Flop


Poker Hand #TM3620221294: Tournament #160076712, Bounty Hunters Big One $1.08 Hold'em No Limit - Level2(60/120) - 2024/08/26 17:47:24
Table '104' 8-max Seat #8 is the button
Seat 1: a07c5d9f (9,862 in chips)
Seat 2: 14abfd9b (24,916 in chips)
Seat 3: 7abeadb8 (17,150 in chips)
Seat 4: Hero (9,634 in chips)
Seat 5: 9fbf9e18 (2,707 in chips)
Seat 6: 73f7416d (21,537 in chips)
Seat 7: 5fd3ba72 (10,816 in chips)
Seat 8: 95ab360e (2,868 in chips)
73f7416d: posts the ante 18
5fd3ba72: posts the ante 18
9fbf9e18: posts the ante 18
7abeadb8: posts the ante 18
95ab360e: posts the ante 18
Hero: posts the ante 18
a07c5d9f: posts the ante 18
14abfd9b: posts the ante 18
a07c5d9f: posts small blind 60
14abfd9b: posts big blind 120
*** HOLE CARDS ***
Dealt to a07c5d9f 
Dealt to 14abfd9b 
Dealt to 7abeadb8 
Dealt to Hero [7c 5h]
Dealt to 9fbf9e18 
Dealt to 73f7416d 
Dealt to 5fd3ba72 
Dealt to 95ab360e 
7abeadb8: calls 120
Hero: folds
9fbf9e18: folds
73f7416d: folds
5fd3ba72: folds
95ab360e: folds
a07c5d9f: calls 60
14abfd9b: checks
*** FLOP *** [Ts Qc 4s]
a07c5d9f: checks
14abfd9b: checks
7abeadb8: checks
*** TURN *** [Ts Qc 4s] [8c]
a07c5d9f: bets 167
14abfd9b: calls 167
7abeadb8: calls 167
*** RIVER *** [Ts Qc 4s 8c] [Ad]
a07c5d9f: bets 1,005
14abfd9b: calls 1,005
7abeadb8: calls 1,005
a07c5d9f: shows [Kc Js] (Aces-High Straight)
14abfd9b: shows [2c Qs] (Pair of Queens)
7abeadb8: shows [As Jd] (Pair of Aces)
*** SHOWDOWN ***
a07c5d9f collected 4,020 from pot
*** SUMMARY ***
Total pot 4,020 | Rake 0 | Jackpot 0 | Bingo 0 | Fortune 0 | Tax 0
Board [Ts Qc 4s 8c Ad]
Seat 1: a07c5d9f (small blind) showed [Kc Js] and won (4,020) with Aces-High Straight
Seat 2: 14abfd9b (big blind) showed [2c Qs] and lost with Pair of Queens
Seat 3: 7abeadb8 showed [As Jd] and lost with Pair of Aces
Seat 4: Hero folded before Flop
Seat 5: 9fbf9e18 folded before Flop
Seat 6: 73f7416d folded before Flop
Seat 7: 5fd3ba72 folded before Flop
Seat 8: 95ab360e (button) folded before Flop


Poker Hand #TM3620221283: Tournament #160076712, Bounty Hunters Big One $1.08 Hold'em No Limit - Level2(60/120) - 2024/08/26 17:46:46
Table '104' 8-max Seat #7 is the button
Seat 1: a07c5d9f (10,000 in chips)
Seat 2: 14abfd9b (25,174 in chips)
Seat 3: 7abeadb8 (8,311 in chips)
Seat 4: Hero (9,652 in chips)
Seat 5: 9fbf9e18 (11,018 in chips)
Seat 6: 73f7416d (21,555 in chips)
Seat 7: 5fd3ba72 (10,834 in chips)
Seat 8: 95ab360e (2,946 in chips)
73f7416d: posts the ante 18
5fd3ba72: posts the ante 18
9fbf9e18: posts the ante 18
7abeadb8: posts the ante 18
95ab360e: posts the ante 18
Hero: posts the ante 18
a07c5d9f: posts the ante 18
14abfd9b: posts the ante 18
95ab360e: posts small blind 60
a07c5d9f: posts big blind 120
*** HOLE CARDS ***
Dealt to a07c5d9f 
Dealt to 14abfd9b 
Dealt to 7abeadb8 
Dealt to Hero [2d 9h]
Dealt to 9fbf9e18 
Dealt to 73f7416d 
Dealt to 5fd3ba72 
Dealt to 95ab360e 
14abfd9b: raises 120 to 240
7abeadb8: raises 8,053 to 8,293 and is all-in
Hero: folds
9fbf9e18: raises 2,707 to 11,000 and is all-in
73f7416d: folds
5fd3ba72: folds
95ab360e: folds
a07c5d9f: folds
14abfd9b: folds
Uncalled bet (2,707) returned to 9fbf9e18
9fbf9e18: shows [4h 4c]
7abeadb8: shows [Ad Th]
*** FLOP *** [Kh 3c Td]
*** TURN *** [Kh 3c Td] [Kc]
*** RIVER *** [Kh 3c Td Kc] [8h]
*** SHOWDOWN ***
7abeadb8 collected 17,150 from pot
*** SUMMARY ***
Total pot 17,150 | Rake 0 | Jackpot 0 | Bingo 0 | Fortune 0 | Tax 0
Board [Kh 3c Td Kc 8h]
Seat 1: a07c5d9f (big blind) folded before Flop
Seat 2: 14abfd9b folded before Flop
Seat 3: 7abeadb8 showed [Ad Th] and won (17,150) with Pair of Kings and Pair of Tens
Seat 4: Hero folded before Flop
Seat 5: 9fbf9e18 showed [4h 4c] and lost with Pair of Kings and Pair of Fours
Seat 6: 73f7416d folded before Flop
Seat 7: 5fd3ba72 (button) folded before Flop
Seat 8: 95ab360e (small blind) folded before Flop


Poker Hand #TM3620221254: Tournament #160076712, Bounty Hunters Big One $1.08 Hold'em No Limit - Level2(60/120) - 2024/08/26 17:45:07
Table '104' 8-max Seat #6 is the button
Seat 2: 14abfd9b (25,444 in chips)
Seat 3: 7abeadb8 (8,581 in chips)
Seat 4: Hero (9,922 in chips)
Seat 5: 9fbf9e18 (9,974 in chips)
Seat 6: 73f7416d (21,573 in chips)
Seat 7: 5fd3ba72 (10,912 in chips)
Seat 8: 95ab360e (3,084 in chips)
73f7416d: posts the ante 18
5fd3ba72: posts the ante 18
9fbf9e18: posts the ante 18
7abeadb8: posts the ante 18
95ab360e: posts the ante 18
Hero: posts the ante 18
14abfd9b: posts the ante 18
5fd3ba72: posts small blind 60
95ab360e: posts big blind 120
*** HOLE CARDS ***
Dealt to 14abfd9b 
Dealt to 7abeadb8 
Dealt to Hero [Th 8h]
Dealt to 9fbf9e18 
Dealt to 73f7416d 
Dealt to 5fd3ba72 
Dealt to 95ab360e 
14abfd9b: raises 132 to 252
7abeadb8: calls 252
Hero: calls 252
9fbf9e18: raises 9,704 to 9,956 and is all-in
73f7416d: folds
5fd3ba72: folds
95ab360e: folds
14abfd9b: folds
7abeadb8: folds
Hero: folds
Uncalled bet (9,704) returned to 9fbf9e18
*** SHOWDOWN ***
9fbf9e18 collected 1,314 from pot
*** SUMMARY ***
Total pot 1,314 | Rake 0 | Jackpot 0 | Bingo 0 | Fortune 0 | Tax 0
Seat 2: 14abfd9b folded before Flop
Seat 3: 7abeadb8 folded before Flop
Seat 4: Hero folded before Flop
Seat 5: 9fbf9e18 collected (1,314)
Seat 6: 73f7416d (button) folded before Flop
Seat 7: 5fd3ba72 (small blind) folded before Flop
Seat 8: 95ab360e (big blind) folded before Flop


Poker Hand #TM3620221235: Tournament #160076712, Bounty Hunters Big One $1.08 Hold'em No Limit - Level2(60/120) - 2024/08/26 17:44:06
Table '104' 8-max Seat #5 is the button
Seat 1: 63accd0d (9,555 in chips)
Seat 2: 14abfd9b (24,754 in chips)
Seat 3: 7abeadb8 (8,599 in chips)
Seat 4: Hero (9,940 in chips)
Seat 5: 9fbf9e18 (9,992 in chips)
Seat 6: 73f7416d (21,651 in chips)
Seat 7: 5fd3ba72 (11,182 in chips)
Seat 8: 95ab360e (3,102 in chips)
73f7416d: posts the ante 18
5fd3ba72: posts the ante 18
63accd0d: posts the ante 18
9fbf9e18: posts the ante 18
7abeadb8: posts the ante 18
95ab360e: posts the ante 18
Hero: posts the ante 18
14abfd9b: posts the ante 18
73f7416d: posts small blind 60
5fd3ba72: posts big blind 120
*** HOLE CARDS ***
Dealt to 63accd0d 
Dealt to 14abfd9b 
Dealt to 7abeadb8 
Dealt to Hero [Js 5c]
Dealt to 9fbf9e18 
Dealt to 73f7416d 
Dealt to 5fd3ba72 
Dealt to 95ab360e 
95ab360e: folds
63accd0d: raises 132 to 252
14abfd9b: calls 252
7abeadb8: folds
Hero: folds
9fbf9e18: folds
73f7416d: folds
5fd3ba72: calls 132
*** FLOP *** [8c 2h 7h]
5fd3ba72: checks
63accd0d: checks
14abfd9b: checks
*** TURN *** [8c 2h 7h] [Ac]
5fd3ba72: checks
63accd0d: checks
14abfd9b: checks
*** RIVER *** [8c 2h 7h Ac] [Ad]
5fd3ba72: checks
63accd0d: checks
14abfd9b: checks
5fd3ba72: shows [3d 2c] (Pair of Aces and Pair of Twos)
63accd0d: shows [Qh Ks] (Pair of Aces)
14abfd9b: shows [4h 4d] (Pair of Aces and Pair of Fours)
*** SHOWDOWN ***
14abfd9b collected 960 from pot
*** SUMMARY ***
Total pot 960 | Rake 0 | Jackpot 0 | Bingo 0 | Fortune 0 | Tax 0
Board [8c 2h 7h Ac Ad]
Seat 1: 63accd0d showed [Qh Ks] and lost with Pair of Aces
Seat 2: 14abfd9b showed [4h 4d] and won (960) with Pair of Aces and Pair of Fours
Seat 3: 7abeadb8 folded before Flop
Seat 4: Hero folded before Flop
Seat 5: 9fbf9e18 (button) folded before Flop
Seat 6: 73f7416d (small blind) folded before Flop
Seat 7: 5fd3ba72 (big blind) showed [3d 2c] and lost with Pair of Aces and Pair of Twos
Seat 8: 95ab360e folded before Flop


Poker Hand #TM3620221217: Tournament #160076712, Bounty Hunters Big One $1.08 Hold'em No Limit - Level2(60/120) - 2024/08/26 17:43:04
Table '104' 8-max Seat #4 is the button
Seat 1: 63accd0d (9,573 in chips)
Seat 2: 14abfd9b (23,986 in chips)
Seat 3: 7abeadb8 (8,617 in chips)
Seat 4: Hero (9,958 in chips)
Seat 5: 9fbf9e18 (10,070 in chips)
Seat 6: 73f7416d (22,251 in chips)
Seat 7: 5fd3ba72 (11,200 in chips)
Seat 8: 95ab360e (3,120 in chips)
73f7416d: posts the ante 18
5fd3ba72: posts the ante 18
63accd0d: posts the ante 18
9fbf9e18: posts the ante 18
7abeadb8: posts the ante 18
95ab360e: posts the ante 18
Hero: posts the ante 18
14abfd9b: posts the ante 18
9fbf9e18: posts small blind 60
73f7416d: posts big blind 120
*** HOLE CARDS ***
Dealt to 63accd0d 
Dealt to 14abfd9b 
Dealt to 7abeadb8 
Dealt to Hero [4c Ts]
Dealt to 9fbf9e18 
Dealt to 73f7416d 
Dealt to 5fd3ba72 
Dealt to 95ab360e 
5fd3ba72: folds
95ab360e: folds
63accd0d: folds
14abfd9b: raises 120 to 240
7abeadb8: folds
Hero: folds
9fbf9e18: folds
73f7416d: calls 120
*** FLOP *** [3c 7c 3h]
73f7416d: bets 342
14abfd9b: calls 342
*** TURN *** [3c 7c 3h] [7h]
73f7416d: checks
14abfd9b: bets 452
73f7416d: folds
Uncalled bet (452) returned to 14abfd9b
*** SHOWDOWN ***
14abfd9b collected 1,368 from pot
*** SUMMARY ***
Total pot 1,368 | Rake 0 | Jackpot 0 | Bingo 0 | Fortune 0 | Tax 0
Board [3c 7c 3h 7h]
Seat 1: 63accd0d folded before Flop
Seat 2: 14abfd9b won (1,368)
Seat 3: 7abeadb8 folded before Flop
Seat 4: Hero (button) folded before Flop
Seat 5: 9fbf9e18 (small blind) folded before Flop
Seat 6: 73f7416d (big blind) folded on the Turn
Seat 7: 5fd3ba72 folded before Flop
Seat 8: 95ab360e folded before Flop


Poker Hand #TM3620221212: Tournament #160076712, Bounty Hunters Big One $1.08 Hold'em No Limit - Level2(60/120) - 2024/08/26 17:42:35
Table '104' 8-max Seat #3 is the button
Seat 1: 63accd0d (9,591 in chips)
Seat 2: 14abfd9b (24,244 in chips)
Seat 3: 7abeadb8 (8,071 in chips)
Seat 4: Hero (10,036 in chips)
Seat 5: 9fbf9e18 (10,208 in chips)
Seat 6: 73f7416d (22,269 in chips)
Seat 7: 5fd3ba72 (11,218 in chips)
Seat 8: 95ab360e (3,138 in chips)
73f7416d: posts the ante 18
5fd3ba72: posts the ante 18
63accd0d: posts the ante 18
9fbf9e18: posts the ante 18
7abeadb8: posts the ante 18
95ab360e: posts the ante 18
Hero: posts the ante 18
14abfd9b: posts the ante 18
Hero: posts small blind 60
9fbf9e18: posts big blind 120
*** HOLE CARDS ***
Dealt to 63accd0d 
Dealt to 14abfd9b 
Dealt to 7abeadb8 
Dealt to Hero [Jh 2c]
Dealt to 9fbf9e18 
Dealt to 73f7416d 
Dealt to 5fd3ba72 
Dealt to 95ab360e 
73f7416d: folds
5fd3ba72: folds
95ab360e: folds
63accd0d: folds
14abfd9b: raises 120 to 240
7abeadb8: raises 7,813 to 8,053 and is all-in
Hero: folds
9fbf9e18: folds
14abfd9b: folds
Uncalled bet (7,813) returned to 7abeadb8
*** SHOWDOWN ***
7abeadb8 collected 804 from pot
*** SUMMARY ***
Total pot 804 | Rake 0 | Jackpot 0 | Bingo 0 | Fortune 0 | Tax 0
Seat 1: 63accd0d folded before Flop
Seat 2: 14abfd9b folded before Flop
Seat 3: 7abeadb8 (button) collected (804)
Seat 4: Hero (small blind) folded before Flop
Seat 5: 9fbf9e18 (big blind) folded before Flop
Seat 6: 73f7416d folded before Flop
Seat 7: 5fd3ba72 folded before Flop
Seat 8: 95ab360e folded before Flop


Poker Hand #TM3620221196: Tournament #160076712, Bounty Hunters Big One $1.08 Hold'em No Limit - Level2(60/120) - 2024/08/26 17:41:57
Table '104' 8-max Seat #2 is the button
Seat 1: 63accd0d (9,609 in chips)
Seat 2: 14abfd9b (25,066 in chips)
Seat 3: 7abeadb8 (8,149 in chips)
Seat 4: Hero (10,318 in chips)
Seat 5: 9fbf9e18 (10,226 in chips)
Seat 6: 73f7416d (22,287 in chips)
Seat 7: 5fd3ba72 (9,964 in chips)
Seat 8: 95ab360e (3,156 in chips)
73f7416d: posts the ante 18
5fd3ba72: posts the ante 18
63accd0d: posts the ante 18
9fbf9e18: posts the ante 18
7abeadb8: posts the ante 18
95ab360e: posts the ante 18
Hero: posts the ante 18
14abfd9b: posts the ante 18
7abeadb8: posts small blind 60
Hero: posts big blind 120
*** HOLE CARDS ***
Dealt to 63accd0d 
Dealt to 14abfd9b 
Dealt to 7abeadb8 
Dealt to Hero [8h 8c]
Dealt to 9fbf9e18 
Dealt to 73f7416d 
Dealt to 5fd3ba72 
Dealt to 95ab360e 
9fbf9e18: folds
73f7416d: folds
5fd3ba72: raises 144 to 264
95ab360e: folds
63accd0d: folds
14abfd9b: calls 264
7abeadb8: folds
Hero: calls 144
*** FLOP *** [Jd 3s Ac]
Hero: checks
5fd3ba72: bets 540
14abfd9b: calls 540
Hero: folds
*** TURN *** [Jd 3s Ac] [2d]
5fd3ba72: bets 1,080
14abfd9b: folds
Uncalled bet (1,080) returned to 5fd3ba72
*** SHOWDOWN ***
5fd3ba72 collected 2,076 from pot
*** SUMMARY ***
Total pot 2,076 | Rake 0 | Jackpot 0 | Bingo 0 | Fortune 0 | Tax 0
Board [Jd 3s Ac 2d]
Seat 1: 63accd0d folded before Flop
Seat 2: 14abfd9b (button) folded on the Turn
Seat 3: 7abeadb8 (small blind) folded before Flop
Seat 4: Hero (big blind) folded on the Flop
Seat 5: 9fbf9e18 folded before Flop
Seat 6: 73f7416d folded before Flop
Seat 7: 5fd3ba72 won (2,076)
Seat 8: 95ab360e folded before Flop


Poker Hand #TM3620221188: Tournament #160076712, Bounty Hunters Big One $1.08 Hold'em No Limit - Level2(60/120) - 2024/08/26 17:41:30
Table '104' 8-max Seat #1 is the button
Seat 1: 63accd0d (9,627 in chips)
Seat 2: 14abfd9b (25,144 in chips)
Seat 3: 7abeadb8 (8,287 in chips)
Seat 4: Hero (10,012 in chips)
Seat 5: 9fbf9e18 (10,244 in chips)
Seat 6: 73f7416d (22,305 in chips)
Seat 7: 5fd3ba72 (9,982 in chips)
Seat 8: 95ab360e (3,174 in chips)
73f7416d: posts the ante 18
5fd3ba72: posts the ante 18
63accd0d: posts the ante 18
9fbf9e18: posts the ante 18
7abeadb8: posts the ante 18
95ab360e: posts the ante 18
Hero: posts the ante 18
14abfd9b: posts the ante 18
14abfd9b: posts small blind 60
7abeadb8: posts big blind 120
*** HOLE CARDS ***
Dealt to 63accd0d 
Dealt to 14abfd9b 
Dealt to 7abeadb8 
Dealt to Hero [8h Tc]
Dealt to 9fbf9e18 
Dealt to 73f7416d 
Dealt to 5fd3ba72 
Dealt to 95ab360e 
Hero: calls 120
9fbf9e18: folds
73f7416d: folds
5fd3ba72: folds
95ab360e: folds
63accd0d: folds
14abfd9b: folds
7abeadb8: checks
*** FLOP *** [6d Jc 9h]
7abeadb8: checks
Hero: bets 333
7abeadb8: folds
Uncalled bet (333) returned to Hero
*** SHOWDOWN ***
Hero collected 444 from pot
*** SUMMARY ***
Total pot 444 | Rake 0 | Jackpot 0 | Bingo 0 | Fortune 0 | Tax 0
Board [6d Jc 9h]
Seat 1: 63accd0d (button) folded before Flop
Seat 2: 14abfd9b (small blind) folded before Flop
Seat 3: 7abeadb8 (big blind) folded on the Flop
Seat 4: Hero won (444)
Seat 5: 9fbf9e18 folded before Flop
Seat 6: 73f7416d folded before Flop
Seat 7: 5fd3ba72 folded before Flop
Seat 8: 95ab360e folded before Flop


Poker Hand #TM3620221174: Tournament #160076712, Bounty Hunters Big One $1.08 Hold'em No Limit - Level2(60/120) - 2024/08/26 17:40:42
Table '104' 8-max Seat #8 is the button
Seat 1: 63accd0d (9,705 in chips)
Seat 2: 14abfd9b (25,282 in chips)
Seat 3: 7abeadb8 (9,255 in chips)
Seat 4: Hero (10,030 in chips)
Seat 5: 9fbf9e18 (10,262 in chips)
Seat 6: 73f7416d (23,273 in chips)
Seat 7: 5fd3ba72 (10,000 in chips)
Seat 8: 95ab360e (968 in chips)
73f7416d: posts the ante 18
5fd3ba72: posts the ante 18
63accd0d: posts the ante 18
9fbf9e18: posts the ante 18
7abeadb8: posts the ante 18
95ab360e: posts the ante 18
Hero: posts the ante 18
14abfd9b: posts the ante 18
63accd0d: posts small blind 60
14abfd9b: posts big blind 120
*** HOLE CARDS ***
Dealt to 63accd0d 
Dealt to 14abfd9b 
Dealt to 7abeadb8 
Dealt to Hero [4c 7c]
Dealt to 9fbf9e18 
Dealt to 73f7416d 
Dealt to 5fd3ba72 
Dealt to 95ab360e 
7abeadb8: calls 120
Hero: folds
9fbf9e18: folds
73f7416d: calls 120
5fd3ba72: folds
95ab360e: raises 830 to 950 and is all-in
63accd0d: folds
14abfd9b: folds
7abeadb8: calls 830
73f7416d: calls 830
*** FLOP *** [Ah 2s Qh]
7abeadb8: checks
73f7416d: checks
*** TURN *** [Ah 2s Qh] [4d]
7abeadb8: checks
73f7416d: checks
*** RIVER *** [Ah 2s Qh 4d] [2d]
7abeadb8: checks
73f7416d: checks
7abeadb8: shows [Ks 9c] (Pair of Twos)
73f7416d: shows [6c 8c] (Pair of Twos)
95ab360e: shows [Qs 7s] (Pair of Queens and Pair of Twos)
*** SHOWDOWN ***
95ab360e collected 3,174 from pot
*** SUMMARY ***
Total pot 3,174 | Rake 0 | Jackpot 0 | Bingo 0 | Fortune 0 | Tax 0
Board [Ah 2s Qh 4d 2d]
Seat 1: 63accd0d (small blind) folded before Flop
Seat 2: 14abfd9b (big blind) folded before Flop
Seat 3: 7abeadb8 showed [Ks 9c] and lost with Pair of Twos
Seat 4: Hero folded before Flop
Seat 5: 9fbf9e18 folded before Flop
Seat 6: 73f7416d showed [6c 8c] and lost with Pair of Twos
Seat 7: 5fd3ba72 folded before Flop
Seat 8: 95ab360e (button) showed [Qs 7s] and won (3,174) with Pair of Queens and Pair of Twos


Poker Hand #TM3620221161: Tournament #160076712, Bounty Hunters Big One $1.08 Hold'em No Limit - Level1(50/100) - 2024/08/26 17:39:38
Table '104' 8-max Seat #6 is the button
Seat 1: 63accd0d (9,720 in chips)
Seat 2: 14abfd9b (25,497 in chips)
Seat 3: 7abeadb8 (9,270 in chips)
Seat 4: Hero (10,045 in chips)
Seat 5: 9fbf9e18 (10,477 in chips)
Seat 6: 73f7416d (9,252 in chips)
Seat 7: fa11312b (4,294 in chips)
Seat 8: 95ab360e (10,220 in chips)
73f7416d: posts the ante 15
63accd0d: posts the ante 15
9fbf9e18: posts the ante 15
7abeadb8: posts the ante 15
95ab360e: posts the ante 15
fa11312b: posts the ante 15
Hero: posts the ante 15
14abfd9b: posts the ante 15
fa11312b: posts small blind 50
95ab360e: posts big blind 100
*** HOLE CARDS ***
Dealt to 63accd0d 
Dealt to 14abfd9b 
Dealt to 7abeadb8 
Dealt to Hero [2s Kh]
Dealt to 9fbf9e18 
Dealt to 73f7416d 
Dealt to fa11312b 
Dealt to 95ab360e 
63accd0d: folds
14abfd9b: raises 100 to 200
7abeadb8: folds
Hero: folds
9fbf9e18: calls 200
73f7416d: raises 9,037 to 9,237 and is all-in
fa11312b: calls 4,229 and is all-in
95ab360e: raises 968 to 10,205 and is all-in
14abfd9b: folds
9fbf9e18: folds
Uncalled bet (968) returned to 95ab360e
95ab360e: shows [Jc Js]
73f7416d: shows [As Qd]
fa11312b: shows [8c Ac]
*** FLOP *** [Qh 6h 4s]
*** TURN *** [Qh 6h 4s] [6s]
*** RIVER *** [Qh 6h 4s 6s] [9c]
*** SHOWDOWN ***
73f7416d collected 13,357 from pot
73f7416d collected 9,916 from pot
*** SUMMARY ***
Total pot 23,273 | Rake 0 | Jackpot 0 | Bingo 0 | Fortune 0 | Tax 0
Board [Qh 6h 4s 6s 9c]
Seat 1: 63accd0d folded before Flop
Seat 2: 14abfd9b folded before Flop
Seat 3: 7abeadb8 folded before Flop
Seat 4: Hero folded before Flop
Seat 5: 9fbf9e18 folded before Flop
Seat 6: 73f7416d (button) showed [As Qd] and won (23,273) with Pair of Queens and Pair of Sixes
Seat 7: fa11312b (small blind) showed [8c Ac] and lost with Pair of Sixes
Seat 8: 95ab360e (big blind) showed [Jc Js] and lost with Pair of Jacks and Pair of Sixes


Poker Hand #TM3620221141: Tournament #160076712, Bounty Hunters Big One $1.08 Hold'em No Limit - Level1(50/100) - 2024/08/26 17:38:19
Table '104' 8-max Seat #5 is the button
Seat 1: 63accd0d (9,735 in chips)
Seat 2: 14abfd9b (25,277 in chips)
Seat 3: 7abeadb8 (9,485 in chips)
Seat 4: Hero (10,060 in chips)
Seat 5: 9fbf9e18 (10,492 in chips)
Seat 6: 73f7416d (9,317 in chips)
Seat 7: fa11312b (4,409 in chips)
Seat 8: 95ab360e (10,000 in chips)
73f7416d: posts the ante 15
63accd0d: posts the ante 15
9fbf9e18: posts the ante 15
7abeadb8: posts the ante 15
95ab360e: posts the ante 15
fa11312b: posts the ante 15
Hero: posts the ante 15
14abfd9b: posts the ante 15
73f7416d: posts small blind 50
fa11312b: posts big blind 100
*** HOLE CARDS ***
Dealt to 63accd0d 
Dealt to 14abfd9b 
Dealt to 7abeadb8 
Dealt to Hero [4s Qh]
Dealt to 9fbf9e18 
Dealt to 73f7416d 
Dealt to fa11312b 
Dealt to 95ab360e 
95ab360e: raises 100 to 200
63accd0d: folds
14abfd9b: calls 200
7abeadb8: calls 200
Hero: folds
9fbf9e18: folds
73f7416d: folds
fa11312b: folds
*** FLOP *** [7c 5c 8d]
95ab360e: checks
14abfd9b: checks
7abeadb8: checks
*** TURN *** [7c 5c 8d] [9h]
95ab360e: checks
14abfd9b: bets 435
7abeadb8: folds
95ab360e: calls 435
*** RIVER *** [7c 5c 8d 9h] [6h]
95ab360e: checks
14abfd9b: checks
95ab360e: shows [9d Jd] (Nines-High Straight)
14abfd9b: shows [9s 9c] (Nines-High Straight)
*** SHOWDOWN ***
14abfd9b collected 870 from pot
95ab360e collected 870 from pot
*** SUMMARY ***
Total pot 1,740 | Rake 0 | Jackpot 0 | Bingo 0 | Fortune 0 | Tax 0
Board [7c 5c 8d 9h 6h]
Seat 1: 63accd0d folded before Flop
Seat 2: 14abfd9b showed [9s 9c] and won (870) with Nines-High Straight
Seat 3: 7abeadb8 folded on the Turn
Seat 4: Hero folded before Flop
Seat 5: 9fbf9e18 (button) folded before Flop
Seat 6: 73f7416d (small blind) folded before Flop
Seat 7: fa11312b (big blind) folded before Flop
Seat 8: 95ab360e showed [9d Jd] and won (870) with Nines-High Straight


Poker Hand #TM3620221121: Tournament #160076712, Bounty Hunters Big One $1.08 Hold'em No Limit - Level1(50/100) - 2024/08/26 17:37:19
Table '104' 8-max Seat #4 is the button
Seat 1: 63accd0d (9,750 in chips)
Seat 2: 14abfd9b (24,434 in chips)
Seat 3: 7abeadb8 (9,500 in chips)
Seat 4: Hero (10,075 in chips)
Seat 5: 9fbf9e18 (10,707 in chips)
Seat 6: 73f7416d (9,885 in chips)
Seat 7: fa11312b (4,424 in chips)
73f7416d: posts the ante 15
63accd0d: posts the ante 15
9fbf9e18: posts the ante 15
7abeadb8: posts the ante 15
fa11312b: posts the ante 15
Hero: posts the ante 15
14abfd9b: posts the ante 15
9fbf9e18: posts small blind 50
73f7416d: posts big blind 100
*** HOLE CARDS ***
Dealt to 63accd0d 
Dealt to 14abfd9b 
Dealt to 7abeadb8 
Dealt to Hero [4d 5c]
Dealt to 9fbf9e18 
Dealt to 73f7416d 
Dealt to fa11312b 
fa11312b: folds
63accd0d: folds
14abfd9b: raises 100 to 200
7abeadb8: folds
Hero: folds
9fbf9e18: calls 150
73f7416d: calls 100
*** FLOP *** [7d Ad 4h]
9fbf9e18: checks
73f7416d: checks
14abfd9b: bets 353
9fbf9e18: folds
73f7416d: calls 353
*** TURN *** [7d Ad 4h] [4s]
73f7416d: checks
14abfd9b: bets 1,059
73f7416d: folds
Uncalled bet (1,059) returned to 14abfd9b
*** SHOWDOWN ***
14abfd9b collected 1,411 from pot
*** SUMMARY ***
Total pot 1,411 | Rake 0 | Jackpot 0 | Bingo 0 | Fortune 0 | Tax 0
Board [7d Ad 4h 4s]
Seat 1: 63accd0d folded before Flop
Seat 2: 14abfd9b won (1,411)
Seat 3: 7abeadb8 folded before Flop
Seat 4: Hero (button) folded before Flop
Seat 5: 9fbf9e18 (small blind) folded on the Flop
Seat 6: 73f7416d (big blind) folded on the Turn
Seat 7: fa11312b folded before Flop


Poker Hand #TM3620221100: Tournament #160076712, Bounty Hunters Big One $1.08 Hold'em No Limit - Level1(50/100) - 2024/08/26 17:35:46
Table '104' 8-max Seat #3 is the button
Seat 1: 63accd0d (9,765 in chips)
Seat 2: 14abfd9b (7,743 in chips)
Seat 3: 7abeadb8 (10,005 in chips)
Seat 4: Hero (10,140 in chips)
Seat 5: 9fbf9e18 (20,662 in chips)
Seat 6: 73f7416d (10,000 in chips)
Seat 7: fa11312b (9,955 in chips)
Seat 8: add08c3 (19,685 in chips)
73f7416d: posts the ante 15
add08c3: posts the ante 15
63accd0d: posts the ante 15
9fbf9e18: posts the ante 15
7abeadb8: posts the ante 15
fa11312b: posts the ante 15
Hero: posts the ante 15
14abfd9b: posts the ante 15
Hero: posts small blind 50
9fbf9e18: posts big blind 100
*** HOLE CARDS ***
Dealt to 63accd0d 
Dealt to 14abfd9b 
Dealt to 7abeadb8 
Dealt to Hero [6c Qh]
Dealt to 9fbf9e18 
Dealt to 73f7416d 
Dealt to fa11312b 
Dealt to add08c3 
73f7416d: calls 100
fa11312b: calls 100
add08c3: raises 390 to 490
63accd0d: folds
14abfd9b: calls 490
7abeadb8: calls 490
Hero: folds
9fbf9e18: raises 20,157 to 20,647 and is all-in
73f7416d: folds
fa11312b: calls 9,840 and is all-in
add08c3: folds
14abfd9b: calls 7,238 and is all-in
7abeadb8: folds
Uncalled bet (10,707) returned to 9fbf9e18
9fbf9e18: shows [As Qs]
fa11312b: shows [8s 8h]
14abfd9b: shows [Ks Js]
*** FLOP *** [2s Td 6s]
*** TURN *** [2s Td 6s] [Jd]
*** RIVER *** [2s Td 6s Jd] [9c]
add08c3: shows [Th Ah] (Pair of Tens)
73f7416d: shows [5c 5d] (Pair of Fives)
*** SHOWDOWN ***
14abfd9b collected 24,434 from pot
fa11312b collected 4,424 from pot
*** SUMMARY ***
Total pot 28,858 | Rake 0 | Jackpot 0 | Bingo 0 | Fortune 0 | Tax 0
Board [2s Td 6s Jd 9c]
Seat 1: 63accd0d folded before Flop
Seat 2: 14abfd9b showed [Ks Js] and won (24,434) with Pair of Jacks
Seat 3: 7abeadb8 (button) folded before Flop
Seat 4: Hero (small blind) folded before Flop
Seat 5: 9fbf9e18 (big blind) showed [As Qs] and lost with Ace-High
Seat 6: 73f7416d folded before Flop
Seat 7: fa11312b showed [8s 8h] and won (4,424) with Pair of Eights
Seat 8: add08c3 folded before Flop


Poker Hand #TM3620221093: Tournament #160076712, Bounty Hunters Big One $1.08 Hold'em No Limit - Level1(50/100) - 2024/08/26 17:35:22
Table '104' 8-max Seat #2 is the button
Seat 1: 63accd0d (9,780 in chips)
Seat 2: 14abfd9b (7,758 in chips)
Seat 3: 7abeadb8 (10,070 in chips)
Seat 4: Hero (10,000 in chips)
Seat 5: 9fbf9e18 (20,677 in chips)
Seat 7: fa11312b (9,970 in chips)
Seat 8: add08c3 (19,700 in chips)
add08c3: posts the ante 15
63accd0d: posts the ante 15
9fbf9e18: posts the ante 15
7abeadb8: posts the ante 15
fa11312b: posts the ante 15
Hero: posts the ante 15
14abfd9b: posts the ante 15
7abeadb8: posts small blind 50
Hero: posts big blind 100
*** HOLE CARDS ***
Dealt to 63accd0d 
Dealt to 14abfd9b 
Dealt to 7abeadb8 
Dealt to Hero [9c Kh]
Dealt to 9fbf9e18 
Dealt to fa11312b 
Dealt to add08c3 
9fbf9e18: folds
fa11312b: folds
add08c3: folds
63accd0d: folds
14abfd9b: folds
7abeadb8: folds
Uncalled bet (50) returned to Hero
*** SHOWDOWN ***
Hero collected 205 from pot
*** SUMMARY ***
Total pot 205 | Rake 0 | Jackpot 0 | Bingo 0 | Fortune 0 | Tax 0
Seat 1: 63accd0d folded before Flop
Seat 2: 14abfd9b (button) folded before Flop
Seat 3: 7abeadb8 (small blind) folded before Flop
Seat 4: Hero (big blind) collected (205)
Seat 5: 9fbf9e18 folded before Flop
Seat 7: fa11312b folded before Flop
Seat 8: add08c3 folded before Flop


