Poker Hand #TM80882791: Tournament #156320229, Short Deck $1 ShortDeck No Limit - Level2(50) - 2024/08/03 22:25:15
Table '3' 6-max Seat #3 is the button
Seat 1: 89911a05 (15,989 in chips)
Seat 2: e47e6b5a (19,537 in chips)
Seat 3: 1cc4f5aa (9,300 in chips)
Seat 4: 6a65c3ce (8,163 in chips)
Seat 5: 8de1474d (5,322 in chips)
Seat 6: Hero (414 in chips)
e47e6b5a: posts the ante 50
89911a05: posts the ante 50
8de1474d: posts the ante 50
1cc4f5aa: posts the ante 50
6a65c3ce: posts the ante 50
Hero: posts the ante 50
1cc4f5aa: posts button blind 50
*** HOLE CARDS ***
Dealt to 89911a05 
Dealt to e47e6b5a 
Dealt to 1cc4f5aa 
Dealt to 6a65c3ce 
Dealt to 8de1474d 
Dealt to Hero [Kc Kd]
6a65c3ce: raises 200 to 250
8de1474d: calls 250
Hero: raises 114 to 364 and is all-in
89911a05: raises 521 to 885
e47e6b5a: calls 885
1cc4f5aa: calls 835
6a65c3ce: calls 635
8de1474d: calls 635
*** FLOP *** [9h Qc 8c]
6a65c3ce: checks
8de1474d: bets 4,387 and is all-in
89911a05: calls 4,387
e47e6b5a: raises 14,215 to 18,602 and is all-in
1cc4f5aa: folds
6a65c3ce: folds
89911a05: calls 10,667 and is all-in
Uncalled bet (3,548) returned to e47e6b5a
e47e6b5a: shows [Ac Tc] (Ace-High)
8de1474d: shows [9s 6s] (Pair of Nines)
Hero: shows [Kc Kd] (Pair of Kings)
89911a05: shows [Jc Kh] (King-High)
*** TURN *** [9h Qc 8c] [7c]
*** RIVER *** [9h Qc 8c 7c] [Ks]
6a65c3ce: shows [As Qd] (Pair of Queens)
*** SHOWDOWN ***
e47e6b5a collected 2,484 from pot
e47e6b5a collected 15,766 from pot
e47e6b5a collected 21,334 from pot
*** SUMMARY ***
Total pot 39,584 | Rake 0 | Jackpot 0 | Bingo 0 | Fortune 0 | Tax 0
Board [9h Qc 8c 7c Ks]
Seat 1: 89911a05 showed [Jc Kh] and lost with Pair of Kings
Seat 2: e47e6b5a showed [Ac Tc] and won (39,584) with Ace High Flush
Seat 3: 1cc4f5aa (button) folded on the Flop
Seat 4: 6a65c3ce folded on the Flop
Seat 5: 8de1474d showed [9s 6s] and lost with Pair of Nines
Seat 6: Hero showed [Kc Kd] and lost with Three Kings


Poker Hand #TM80882790: Tournament #156320229, Short Deck $1 ShortDeck No Limit - Level2(50) - 2024/08/03 22:23:35
Table '3' 6-max Seat #2 is the button
Seat 1: 89911a05 (16,039 in chips)
Seat 2: e47e6b5a (19,637 in chips)
Seat 3: 1cc4f5aa (9,900 in chips)
Seat 4: 6a65c3ce (8,213 in chips)
Seat 5: 8de1474d (3,922 in chips)
Seat 6: Hero (1,014 in chips)
e47e6b5a: posts the ante 50
89911a05: posts the ante 50
8de1474d: posts the ante 50
6a65c3ce: posts the ante 50
1cc4f5aa: posts the ante 50
Hero: posts the ante 50
e47e6b5a: posts button blind 50
*** HOLE CARDS ***
Dealt to 89911a05 
Dealt to e47e6b5a 
Dealt to 1cc4f5aa 
Dealt to 6a65c3ce 
Dealt to 8de1474d 
Dealt to Hero [Qd Kh]
1cc4f5aa: calls 50
6a65c3ce: folds
8de1474d: calls 50
Hero: calls 50
89911a05: folds
e47e6b5a: checks
*** FLOP *** [6h 7d Js]
1cc4f5aa: checks
8de1474d: checks
Hero: checks
e47e6b5a: checks
*** TURN *** [6h 7d Js] [9s]
1cc4f5aa: checks
8de1474d: bets 500
Hero: calls 500
e47e6b5a: folds
1cc4f5aa: calls 500
*** RIVER *** [6h 7d Js 9s] [8c]
1cc4f5aa: checks
8de1474d: checks
Hero: checks
1cc4f5aa: shows [9c Qs] (Pair of Nines)
8de1474d: shows [9d 7h] (Pair of Nines and Pair of Sevens)
Hero: shows [Qd Kh] (King-High)
*** SHOWDOWN ***
8de1474d collected 2,000 from pot
*** SUMMARY ***
Total pot 2,000 | Rake 0 | Jackpot 0 | Bingo 0 | Fortune 0 | Tax 0
Board [6h 7d Js 9s 8c]
Seat 1: 89911a05 folded before Flop
Seat 2: e47e6b5a (button) folded on the Turn
Seat 3: 1cc4f5aa showed [9c Qs] and lost with Pair of Nines
Seat 4: 6a65c3ce folded before Flop
Seat 5: 8de1474d showed [9d 7h] and won (2,000) with Pair of Nines and Pair of Sevens
Seat 6: Hero showed [Qd Kh] and lost with King-High


Poker Hand #TM80882789: Tournament #156320229, Short Deck $1 ShortDeck No Limit - Level2(50) - 2024/08/03 22:22:19
Table '3' 6-max Seat #1 is the button
Seat 1: 89911a05 (17,263 in chips)
Seat 2: e47e6b5a (19,687 in chips)
Seat 3: 1cc4f5aa (10,000 in chips)
Seat 4: 6a65c3ce (9,437 in chips)
Seat 5: 8de1474d (1,224 in chips)
Seat 6: Hero (1,114 in chips)
e47e6b5a: posts the ante 50
89911a05: posts the ante 50
8de1474d: posts the ante 50
6a65c3ce: posts the ante 50
1cc4f5aa: posts the ante 50
Hero: posts the ante 50
89911a05: posts button blind 50
*** HOLE CARDS ***
Dealt to 89911a05 
Dealt to e47e6b5a 
Dealt to 1cc4f5aa 
Dealt to 6a65c3ce 
Dealt to 8de1474d 
Dealt to Hero [Qs 8s]
e47e6b5a: folds
1cc4f5aa: calls 50
6a65c3ce: calls 50
8de1474d: calls 50
Hero: calls 50
89911a05: checks
*** FLOP *** [8c Td Kd]
1cc4f5aa: checks
6a65c3ce: bets 413
8de1474d: raises 711 to 1,124 and is all-in
Hero: folds
89911a05: calls 1,124
1cc4f5aa: folds
6a65c3ce: calls 711
*** TURN *** [8c Td Kd] [9s]
6a65c3ce: checks
89911a05: checks
*** RIVER *** [8c Td Kd 9s] [6s]
6a65c3ce: checks
89911a05: checks
6a65c3ce: shows [Js Kc] (Pair of Kings)
8de1474d: shows [Qd Jc] (Kings-High Straight)
89911a05: shows [Jd Ts] (Pair of Tens)
*** SHOWDOWN ***
8de1474d collected 3,922 from pot
*** SUMMARY ***
Total pot 3,922 | Rake 0 | Jackpot 0 | Bingo 0 | Fortune 0 | Tax 0
Board [8c Td Kd 9s 6s]
Seat 1: 89911a05 (button) showed [Jd Ts] and lost with Pair of Tens
Seat 2: e47e6b5a folded before Flop
Seat 3: 1cc4f5aa folded on the Flop
Seat 4: 6a65c3ce showed [Js Kc] and lost with Pair of Kings
Seat 5: 8de1474d showed [Qd Jc] and won (3,922) with Kings-High Straight
Seat 6: Hero folded on the Flop


Poker Hand #TM80882788: Tournament #156320229, Short Deck $1 ShortDeck No Limit - Level2(50) - 2024/08/03 22:20:32
Table '3' 6-max Seat #6 is the button
Seat 1: 89911a05 (17,763 in chips)
Seat 2: e47e6b5a (20,187 in chips)
Seat 4: 6a65c3ce (9,487 in chips)
Seat 5: 8de1474d (1,022 in chips)
Seat 6: Hero (266 in chips)
e47e6b5a: posts the ante 50
8de1474d: posts the ante 50
89911a05: posts the ante 50
6a65c3ce: posts the ante 50
Hero: posts the ante 50
Hero: posts button blind 50
*** HOLE CARDS ***
Dealt to 89911a05 
Dealt to e47e6b5a 
Dealt to 6a65c3ce 
Dealt to 8de1474d 
Dealt to Hero [Js 9h]
89911a05: calls 50
e47e6b5a: raises 400 to 450
6a65c3ce: folds
8de1474d: calls 450
Hero: calls 166 and is all-in
89911a05: calls 400
*** FLOP *** [Jd Ad Jh]
89911a05: checks
e47e6b5a: checks
8de1474d: checks
*** TURN *** [Jd Ad Jh] [9c]
89911a05: checks
e47e6b5a: checks
8de1474d: checks
*** RIVER *** [Jd Ad Jh 9c] [Qh]
89911a05: checks
e47e6b5a: checks
8de1474d: checks
89911a05: shows [7s 8s] (Pair of Jacks)
e47e6b5a: shows [Qc Tc] (Pair of Queens and Pair of Jacks)
8de1474d: shows [As 7h] (Pair of Aces and Pair of Jacks)
Hero: shows [Js 9h] (Jacks Full over Nines)
*** SHOWDOWN ***
Hero collected 1,114 from pot
8de1474d collected 702 from pot
*** SUMMARY ***
Total pot 1,816 | Rake 0 | Jackpot 0 | Bingo 0 | Fortune 0 | Tax 0
Board [Jd Ad Jh 9c Qh]
Seat 1: 89911a05 showed [7s 8s] and lost with Pair of Jacks
Seat 2: e47e6b5a showed [Qc Tc] and lost with Pair of Queens and Pair of Jacks
Seat 4: 6a65c3ce folded before Flop
Seat 5: 8de1474d showed [As 7h] and won (702) with Pair of Aces and Pair of Jacks
Seat 6: Hero (button) showed [Js 9h] and won (1,114) with Jacks Full over Nines


Poker Hand #TM80882787: Tournament #156320229, Short Deck $1 ShortDeck No Limit - Level1(40) - 2024/08/03 22:17:49
Table '3' 6-max Seat #5 is the button
Seat 1: 89911a05 (17,949 in chips)
Seat 2: e47e6b5a (20,227 in chips)
Seat 3: efccc5be (9,601 in chips)
Seat 4: 6a65c3ce (9,527 in chips)
Seat 5: 8de1474d (2,909 in chips)
Seat 6: Hero (9,867 in chips)
e47e6b5a: posts the ante 40
8de1474d: posts the ante 40
89911a05: posts the ante 40
efccc5be: posts the ante 40
6a65c3ce: posts the ante 40
Hero: posts the ante 40
8de1474d: posts button blind 40
*** HOLE CARDS ***
Dealt to 89911a05 
Dealt to e47e6b5a 
Dealt to efccc5be 
Dealt to 6a65c3ce 
Dealt to 8de1474d 
Dealt to Hero [Kd Kh]
Hero: raises 106 to 146
89911a05: calls 146
e47e6b5a: folds
efccc5be: raises 718 to 864
6a65c3ce: folds
8de1474d: calls 824
Hero: calls 718
89911a05: folds
*** FLOP *** [Tc Ts Jc]
Hero: checks
efccc5be: bets 983
8de1474d: calls 983
Hero: raises 7,980 to 8,963 and is all-in
efccc5be: calls 7,714 and is all-in
8de1474d: folds
Uncalled bet (266) returned to Hero
Hero: shows [Kd Kh] (Pair of Kings and Pair of Tens)
efccc5be: shows [As Ac] (Pair of Aces and Pair of Tens)
*** TURN *** [Tc Ts Jc] [7d]
*** RIVER *** [Tc Ts Jc 7d] [9c]
*** SHOWDOWN ***
efccc5be collected 21,355 from pot
*** SUMMARY ***
Total pot 21,355 | Rake 0 | Jackpot 0 | Bingo 0 | Fortune 0 | Tax 0
Board [Tc Ts Jc 7d 9c]
Seat 1: 89911a05 folded before Flop
Seat 2: e47e6b5a folded before Flop
Seat 3: efccc5be showed [As Ac] and won (21,355) with Pair of Aces and Pair of Tens
Seat 4: 6a65c3ce folded before Flop
Seat 5: 8de1474d (button) folded on the Flop
Seat 6: Hero showed [Kd Kh] and lost with Pair of Kings and Pair of Tens


Poker Hand #TM80882786: Tournament #156320229, Short Deck $1 ShortDeck No Limit - Level1(40) - 2024/08/03 22:16:13
Table '3' 6-max Seat #4 is the button
Seat 1: 89911a05 (17,309 in chips)
Seat 2: e47e6b5a (20,267 in chips)
Seat 3: efccc5be (9,641 in chips)
Seat 4: 6a65c3ce (9,787 in chips)
Seat 5: 8de1474d (3,169 in chips)
Seat 6: Hero (9,907 in chips)
e47e6b5a: posts the ante 40
89911a05: posts the ante 40
8de1474d: posts the ante 40
efccc5be: posts the ante 40
6a65c3ce: posts the ante 40
Hero: posts the ante 40
6a65c3ce: posts button blind 40
*** HOLE CARDS ***
Dealt to 89911a05 
Dealt to e47e6b5a 
Dealt to efccc5be 
Dealt to 6a65c3ce 
Dealt to 8de1474d 
Dealt to Hero [6s 8s]
8de1474d: calls 40
Hero: folds
89911a05: raises 180 to 220
e47e6b5a: folds
efccc5be: folds
6a65c3ce: calls 180
8de1474d: calls 180
*** FLOP *** [As 9c 8d]
8de1474d: checks
89911a05: checks
6a65c3ce: checks
*** TURN *** [As 9c 8d] [Ad]
8de1474d: checks
89911a05: checks
6a65c3ce: checks
*** RIVER *** [As 9c 8d Ad] [9h]
8de1474d: checks
89911a05: checks
6a65c3ce: checks
8de1474d: shows [6d 6h] (Pair of Aces and Pair of Nines)
89911a05: shows [Kd Qd] (Pair of Aces and Pair of Nines)
6a65c3ce: shows [8c Th] (Pair of Aces and Pair of Nines)
*** SHOWDOWN ***
89911a05 collected 900 from pot
*** SUMMARY ***
Total pot 900 | Rake 0 | Jackpot 0 | Bingo 0 | Fortune 0 | Tax 0
Board [As 9c 8d Ad 9h]
Seat 1: 89911a05 showed [Kd Qd] and won (900) with Pair of Aces and Pair of Nines
Seat 2: e47e6b5a folded before Flop
Seat 3: efccc5be folded before Flop
Seat 4: 6a65c3ce (button) showed [8c Th] and lost with Pair of Aces and Pair of Nines
Seat 5: 8de1474d showed [6d 6h] and lost with Pair of Aces and Pair of Nines
Seat 6: Hero folded before Flop


Poker Hand #TM80882785: Tournament #156320229, Short Deck $1 ShortDeck No Limit - Level1(40) - 2024/08/03 22:14:21
Table '3' 6-max Seat #3 is the button
Seat 1: 89911a05 (10,000 in chips)
Seat 2: e47e6b5a (20,307 in chips)
Seat 3: efccc5be (9,840 in chips)
Seat 4: 6a65c3ce (9,827 in chips)
Seat 5: 8de1474d (10,159 in chips)
Seat 6: Hero (9,947 in chips)
e47e6b5a: posts the ante 40
89911a05: posts the ante 40
8de1474d: posts the ante 40
efccc5be: posts the ante 40
6a65c3ce: posts the ante 40
Hero: posts the ante 40
efccc5be: posts button blind 40
*** HOLE CARDS ***
Dealt to 89911a05 
Dealt to e47e6b5a 
Dealt to efccc5be 
Dealt to 6a65c3ce 
Dealt to 8de1474d 
Dealt to Hero [Qc 7c]
6a65c3ce: folds
8de1474d: calls 40
Hero: folds
89911a05: raises 119 to 159
e47e6b5a: folds
efccc5be: calls 119
8de1474d: calls 119
*** FLOP *** [6d Qd Jh]
8de1474d: checks
89911a05: bets 359
efccc5be: folds
8de1474d: calls 359
*** TURN *** [6d Qd Jh] [Ah]
8de1474d: checks
89911a05: bets 474
8de1474d: raises 2,383 to 2,857
89911a05: calls 2,383
*** RIVER *** [6d Qd Jh Ah] [Th]
8de1474d: bets 3,575
89911a05: calls 3,575
8de1474d: shows [Ac Qs] (Pair of Aces and Pair of Queens)
89911a05: shows [Qh Kc] (Aces-High Straight)
*** SHOWDOWN ***
89911a05 collected 14,299 from pot
*** SUMMARY ***
Total pot 14,299 | Rake 0 | Jackpot 0 | Bingo 0 | Fortune 0 | Tax 0
Board [6d Qd Jh Ah Th]
Seat 1: 89911a05 showed [Qh Kc] and won (14,299) with Aces-High Straight
Seat 2: e47e6b5a folded before Flop
Seat 3: efccc5be (button) folded on the Flop
Seat 4: 6a65c3ce folded before Flop
Seat 5: 8de1474d showed [Ac Qs] and lost with Pair of Aces and Pair of Queens
Seat 6: Hero folded before Flop


Poker Hand #TM80882784: Tournament #156320229, Short Deck $1 ShortDeck No Limit - Level1(40) - 2024/08/03 22:12:39
Table '3' 6-max Seat #2 is the button
Seat 2: e47e6b5a (20,480 in chips)
Seat 3: efccc5be (9,880 in chips)
Seat 4: 6a65c3ce (10,000 in chips)
Seat 5: 8de1474d (9,600 in chips)
Seat 6: Hero (10,120 in chips)
e47e6b5a: posts the ante 40
8de1474d: posts the ante 40
efccc5be: posts the ante 40
6a65c3ce: posts the ante 40
Hero: posts the ante 40
e47e6b5a: posts button blind 40
*** HOLE CARDS ***
Dealt to e47e6b5a 
Dealt to efccc5be 
Dealt to 6a65c3ce 
Dealt to 8de1474d 
Dealt to Hero [6d 8c]
efccc5be: folds
6a65c3ce: raises 93 to 133
8de1474d: calls 133
Hero: calls 133
e47e6b5a: calls 93
*** FLOP *** [8h Ac Tc]
6a65c3ce: checks
8de1474d: checks
Hero: checks
e47e6b5a: checks
*** TURN *** [8h Ac Tc] [Qs]
6a65c3ce: checks
8de1474d: checks
Hero: checks
e47e6b5a: checks
*** RIVER *** [8h Ac Tc Qs] [6h]
6a65c3ce: checks
8de1474d: bets 366
Hero: folds
e47e6b5a: folds
6a65c3ce: folds
Uncalled bet (366) returned to 8de1474d
*** SHOWDOWN ***
8de1474d collected 732 from pot
*** SUMMARY ***
Total pot 732 | Rake 0 | Jackpot 0 | Bingo 0 | Fortune 0 | Tax 0
Board [8h Ac Tc Qs 6h]
Seat 2: e47e6b5a (button) folded on the River
Seat 3: efccc5be folded before Flop
Seat 4: 6a65c3ce folded on the River
Seat 5: 8de1474d won (732)
Seat 6: Hero folded on the River


Poker Hand #TM80882783: Tournament #156320229, Short Deck $1 ShortDeck No Limit - Level1(40) - 2024/08/03 22:11:44
Table '3' 6-max Seat #1 is the button
Seat 1: ea3136b1 (9,600 in chips)
Seat 2: e47e6b5a (20,520 in chips)
Seat 3: efccc5be (9,960 in chips)
Seat 5: 8de1474d (9,920 in chips)
Seat 6: Hero (10,160 in chips)
e47e6b5a: posts the ante 40
8de1474d: posts the ante 40
efccc5be: posts the ante 40
Hero: posts the ante 40
ea3136b1: posts the ante 40
ea3136b1: posts button blind 40
*** HOLE CARDS ***
Dealt to ea3136b1 
Dealt to e47e6b5a 
Dealt to efccc5be 
Dealt to 8de1474d 
Dealt to Hero [7c 9d]
e47e6b5a: folds
efccc5be: calls 40
8de1474d: calls 40
Hero: folds
ea3136b1: raises 240 to 280
efccc5be: folds
8de1474d: calls 240
*** FLOP *** [7d Js 6s]
8de1474d: checks
ea3136b1: bets 400
8de1474d: folds
Uncalled bet (400) returned to ea3136b1
*** SHOWDOWN ***
ea3136b1 collected 800 from pot
*** SUMMARY ***
Total pot 800 | Rake 0 | Jackpot 0 | Bingo 0 | Fortune 0 | Tax 0
Board [7d Js 6s]
Seat 1: ea3136b1 (button) won (800)
Seat 2: e47e6b5a folded before Flop
Seat 3: efccc5be folded before Flop
Seat 5: 8de1474d folded on the Flop
Seat 6: Hero folded before Flop


Poker Hand #TM80962494: Tournament #156320229, Short Deck $1 ShortDeck No Limit - Level1(40) - 2024/08/03 22:10:01
Table '5' 6-max Seat #2 is the button
Seat 1: 785c40a0 (10,000 in chips)
Seat 2: 398402c3 (10,000 in chips)
Seat 3: 482c9c7b (10,000 in chips)
Seat 4: Hero (10,000 in chips)
785c40a0: posts the ante 40
398402c3: posts the ante 40
482c9c7b: posts the ante 40
Hero: posts the ante 40
398402c3: posts button blind 40
*** HOLE CARDS ***
Dealt to 785c40a0 
Dealt to 398402c3 
Dealt to 482c9c7b 
Dealt to Hero [8h 9h]
482c9c7b: folds
Hero: raises 80 to 120
785c40a0: folds
398402c3: folds
Uncalled bet (80) returned to Hero
*** SHOWDOWN ***
Hero collected 240 from pot
*** SUMMARY ***
Total pot 240 | Rake 0 | Jackpot 0 | Bingo 0 | Fortune 0 | Tax 0
Seat 1: 785c40a0 folded before Flop
Seat 2: 398402c3 (button) folded before Flop
Seat 3: 482c9c7b folded before Flop
Seat 4: Hero collected (240)


