Poker Hand #TM3449968692: Tournament #149964808, Bounty Hunters Special $1.08 Hold'em No Limit - Level17(1,250/2,500) - 2024/07/03 23:29:36
Table '8' 8-max Seat #7 is the button
Seat 1: 5e4b9d4f (142,222 in chips)
Seat 2: 4250e296 (56,964 in chips)
Seat 3: d2253be4 (42,633 in chips)
Seat 4: 802b707d (53 in chips)
Seat 5: Hero (113,144 in chips)
Seat 6: 17e1b126 (49,135 in chips)
Seat 7: bd8abd3 (40,451 in chips)
Seat 8: 3ed018f9 (213,827 in chips)
4250e296: posts the ante 350
5e4b9d4f: posts the ante 350
802b707d: posts the ante 53
d2253be4: posts the ante 350
17e1b126: posts the ante 350
3ed018f9: posts the ante 350
Hero: posts the ante 350
bd8abd3: posts the ante 350
3ed018f9: posts small blind 1,250
5e4b9d4f: posts big blind 2,500
*** HOLE CARDS ***
Dealt to 5e4b9d4f 
Dealt to 4250e296 
Dealt to d2253be4 
Dealt to 802b707d 
Dealt to Hero [Qh Ac]
Dealt to 17e1b126 
Dealt to bd8abd3 
Dealt to 3ed018f9 
4250e296: folds
d2253be4: folds
Hero: raises 3,750 to 6,250
17e1b126: folds
bd8abd3: folds
3ed018f9: calls 5,000
5e4b9d4f: calls 3,750
*** FLOP *** [2s Ad 4s]
3ed018f9: checks
5e4b9d4f: checks
Hero: bets 10,627
3ed018f9: calls 10,627
5e4b9d4f: calls 10,627
*** TURN *** [2s Ad 4s] [8c]
3ed018f9: checks
5e4b9d4f: checks
Hero: bets 53,134
3ed018f9: raises 119,552 to 172,686
5e4b9d4f: folds
Hero: calls 42,783 and is all-in
Uncalled bet (76,769) returned to 3ed018f9
3ed018f9: shows [8h 8d] (Three Eights)
802b707d: shows [3s Th] (Ace-High)
Hero: shows [Qh Ac] (Pair of Aces)
*** RIVER *** [2s Ad 4s 8c] [5d]
*** SHOWDOWN ***
802b707d collected 424 from pot
3ed018f9 collected 244,544 from pot
*** SUMMARY ***
Total pot 244,968 | Rake 0 | Jackpot 0 | Bingo 0 | Fortune 0 | Tax 0
Board [2s Ad 4s 8c 5d]
Seat 1: 5e4b9d4f (big blind) folded on the Turn
Seat 2: 4250e296 folded before Flop
Seat 3: d2253be4 folded before Flop
Seat 4: 802b707d showed [3s Th] and won (424) with Fives-High Straight
Seat 5: Hero showed [Qh Ac] and lost with Pair of Aces
Seat 6: 17e1b126 folded before Flop
Seat 7: bd8abd3 (button) folded before Flop
Seat 8: 3ed018f9 (small blind) showed [8h 8d] and won (244,544) with Three Eights


Poker Hand #TM3449968656: Tournament #149964808, Bounty Hunters Special $1.08 Hold'em No Limit - Level17(1,250/2,500) - 2024/07/03 23:28:56
Table '8' 8-max Seat #6 is the button
Seat 1: 5e4b9d4f (142,572 in chips)
Seat 2: 4250e296 (57,314 in chips)
Seat 3: d2253be4 (42,983 in chips)
Seat 4: 802b707d (403 in chips)
Seat 5: Hero (113,494 in chips)
Seat 6: 17e1b126 (49,485 in chips)
Seat 7: bd8abd3 (42,051 in chips)
Seat 8: 3ed018f9 (210,127 in chips)
4250e296: posts the ante 350
5e4b9d4f: posts the ante 350
802b707d: posts the ante 350
d2253be4: posts the ante 350
17e1b126: posts the ante 350
3ed018f9: posts the ante 350
Hero: posts the ante 350
bd8abd3: posts the ante 350
bd8abd3: posts small blind 1,250
3ed018f9: posts big blind 2,500
*** HOLE CARDS ***
Dealt to 5e4b9d4f 
Dealt to 4250e296 
Dealt to d2253be4 
Dealt to 802b707d 
Dealt to Hero [9h 6s]
Dealt to 17e1b126 
Dealt to bd8abd3 
Dealt to 3ed018f9 
5e4b9d4f: folds
4250e296: folds
d2253be4: folds
802b707d: folds
Hero: folds
17e1b126: folds
bd8abd3: folds
Uncalled bet (1,250) returned to 3ed018f9
*** SHOWDOWN ***
3ed018f9 collected 5,300 from pot
*** SUMMARY ***
Total pot 5,300 | Rake 0 | Jackpot 0 | Bingo 0 | Fortune 0 | Tax 0
Seat 1: 5e4b9d4f folded before Flop
Seat 2: 4250e296 folded before Flop
Seat 3: d2253be4 folded before Flop
Seat 4: 802b707d folded before Flop
Seat 5: Hero folded before Flop
Seat 6: 17e1b126 (button) folded before Flop
Seat 7: bd8abd3 (small blind) folded before Flop
Seat 8: 3ed018f9 (big blind) collected (5,300)


Poker Hand #TM3449968601: Tournament #149964808, Bounty Hunters Special $1.08 Hold'em No Limit - Level17(1,250/2,500) - 2024/07/03 23:28:03
Table '8' 8-max Seat #5 is the button
Seat 1: 5e4b9d4f (142,922 in chips)
Seat 2: 4250e296 (57,664 in chips)
Seat 3: d2253be4 (43,333 in chips)
Seat 4: 802b707d (753 in chips)
Seat 5: Hero (113,844 in chips)
Seat 6: 17e1b126 (54,835 in chips)
Seat 7: bd8abd3 (44,901 in chips)
Seat 8: 3ed018f9 (200,177 in chips)
4250e296: posts the ante 350
5e4b9d4f: posts the ante 350
802b707d: posts the ante 350
d2253be4: posts the ante 350
3ed018f9: posts the ante 350
17e1b126: posts the ante 350
Hero: posts the ante 350
bd8abd3: posts the ante 350
17e1b126: posts small blind 1,250
bd8abd3: posts big blind 2,500
*** HOLE CARDS ***
Dealt to 5e4b9d4f 
Dealt to 4250e296 
Dealt to d2253be4 
Dealt to 802b707d 
Dealt to Hero [Jh 4d]
Dealt to 17e1b126 
Dealt to bd8abd3 
Dealt to 3ed018f9 
3ed018f9: raises 2,500 to 5,000
5e4b9d4f: folds
4250e296: folds
d2253be4: folds
802b707d: folds
Hero: folds
17e1b126: calls 3,750
bd8abd3: folds
*** FLOP *** [8h 7h 5c]
17e1b126: checks
3ed018f9: bets 11,475
17e1b126: folds
Uncalled bet (11,475) returned to 3ed018f9
*** SHOWDOWN ***
3ed018f9 collected 15,300 from pot
*** SUMMARY ***
Total pot 15,300 | Rake 0 | Jackpot 0 | Bingo 0 | Fortune 0 | Tax 0
Board [8h 7h 5c]
Seat 1: 5e4b9d4f folded before Flop
Seat 2: 4250e296 folded before Flop
Seat 3: d2253be4 folded before Flop
Seat 4: 802b707d folded before Flop
Seat 5: Hero (button) folded before Flop
Seat 6: 17e1b126 (small blind) folded on the Flop
Seat 7: bd8abd3 (big blind) folded before Flop
Seat 8: 3ed018f9 won (15,300)


Poker Hand #TM3449968560: Tournament #149964808, Bounty Hunters Special $1.08 Hold'em No Limit - Level17(1,250/2,500) - 2024/07/03 23:27:25
Table '8' 8-max Seat #4 is the button
Seat 1: 5e4b9d4f (143,272 in chips)
Seat 2: 4250e296 (58,014 in chips)
Seat 3: d2253be4 (43,683 in chips)
Seat 4: 802b707d (1,103 in chips)
Seat 5: Hero (103,894 in chips)
Seat 6: 17e1b126 (57,685 in chips)
Seat 7: bd8abd3 (45,251 in chips)
Seat 8: 3ed018f9 (205,527 in chips)
4250e296: posts the ante 350
5e4b9d4f: posts the ante 350
802b707d: posts the ante 350
d2253be4: posts the ante 350
3ed018f9: posts the ante 350
17e1b126: posts the ante 350
Hero: posts the ante 350
bd8abd3: posts the ante 350
Hero: posts small blind 1,250
17e1b126: posts big blind 2,500
*** HOLE CARDS ***
Dealt to 5e4b9d4f 
Dealt to 4250e296 
Dealt to d2253be4 
Dealt to 802b707d 
Dealt to Hero [Jc Js]
Dealt to 17e1b126 
Dealt to bd8abd3 
Dealt to 3ed018f9 
bd8abd3: folds
3ed018f9: raises 2,500 to 5,000
5e4b9d4f: folds
4250e296: folds
d2253be4: folds
802b707d: folds
Hero: raises 98,544 to 103,544 and is all-in
17e1b126: folds
3ed018f9: folds
Uncalled bet (98,544) returned to Hero
*** SHOWDOWN ***
Hero collected 15,300 from pot
*** SUMMARY ***
Total pot 15,300 | Rake 0 | Jackpot 0 | Bingo 0 | Fortune 0 | Tax 0
Seat 1: 5e4b9d4f folded before Flop
Seat 2: 4250e296 folded before Flop
Seat 3: d2253be4 folded before Flop
Seat 4: 802b707d (button) folded before Flop
Seat 5: Hero (small blind) collected (15,300)
Seat 6: 17e1b126 (big blind) folded before Flop
Seat 7: bd8abd3 folded before Flop
Seat 8: 3ed018f9 folded before Flop


Poker Hand #TM3449968462: Tournament #149964808, Bounty Hunters Special $1.08 Hold'em No Limit - Level17(1,250/2,500) - 2024/07/03 23:25:45
Table '8' 8-max Seat #3 is the button
Seat 1: 5e4b9d4f (146,122 in chips)
Seat 2: 4250e296 (58,364 in chips)
Seat 3: d2253be4 (51,170 in chips)
Seat 4: 802b707d (2,703 in chips)
Seat 5: Hero (88,057 in chips)
Seat 6: 17e1b126 (58,035 in chips)
Seat 7: bd8abd3 (45,601 in chips)
Seat 8: 3ed018f9 (208,377 in chips)
4250e296: posts the ante 350
5e4b9d4f: posts the ante 350
d2253be4: posts the ante 350
802b707d: posts the ante 350
3ed018f9: posts the ante 350
17e1b126: posts the ante 350
Hero: posts the ante 350
bd8abd3: posts the ante 350
802b707d: posts small blind 1,250
Hero: posts big blind 2,500
*** HOLE CARDS ***
Dealt to 5e4b9d4f 
Dealt to 4250e296 
Dealt to d2253be4 
Dealt to 802b707d 
Dealt to Hero [Kc 9c]
Dealt to 17e1b126 
Dealt to bd8abd3 
Dealt to 3ed018f9 
17e1b126: folds
bd8abd3: folds
3ed018f9: calls 2,500
5e4b9d4f: calls 2,500
4250e296: folds
d2253be4: calls 2,500
802b707d: folds
Hero: checks
*** FLOP *** [Jc 6h 6s]
Hero: checks
3ed018f9: checks
5e4b9d4f: checks
d2253be4: checks
*** TURN *** [Jc 6h 6s] [9s]
Hero: bets 4,637
3ed018f9: folds
5e4b9d4f: folds
d2253be4: calls 4,637
*** RIVER *** [Jc 6h 6s 9s] [6c]
Hero: bets 7,697
d2253be4: folds
Uncalled bet (7,697) returned to Hero
Hero: shows [9c] (Sixes Full over Nines)
*** SHOWDOWN ***
Hero collected 23,324 from pot
*** SUMMARY ***
Total pot 23,324 | Rake 0 | Jackpot 0 | Bingo 0 | Fortune 0 | Tax 0
Board [Jc 6h 6s 9s 6c]
Seat 1: 5e4b9d4f folded on the Turn
Seat 2: 4250e296 folded before Flop
Seat 3: d2253be4 (button) folded on the River
Seat 4: 802b707d (small blind) folded before Flop
Seat 5: Hero (big blind) showed [9c] and won (23,324)
Seat 6: 17e1b126 folded before Flop
Seat 7: bd8abd3 folded before Flop
Seat 8: 3ed018f9 folded on the Turn


Poker Hand #TM3449968392: Tournament #149964808, Bounty Hunters Special $1.08 Hold'em No Limit - Level17(1,250/2,500) - 2024/07/03 23:24:31
Table '8' 8-max Seat #2 is the button
Seat 1: 5e4b9d4f (153,972 in chips)
Seat 2: 4250e296 (58,714 in chips)
Seat 3: d2253be4 (52,770 in chips)
Seat 4: 802b707d (5,553 in chips)
Seat 5: Hero (95,907 in chips)
Seat 6: 17e1b126 (58,385 in chips)
Seat 7: bd8abd3 (45,951 in chips)
Seat 8: 3ed018f9 (187,177 in chips)
4250e296: posts the ante 350
5e4b9d4f: posts the ante 350
802b707d: posts the ante 350
d2253be4: posts the ante 350
3ed018f9: posts the ante 350
17e1b126: posts the ante 350
Hero: posts the ante 350
bd8abd3: posts the ante 350
d2253be4: posts small blind 1,250
802b707d: posts big blind 2,500
*** HOLE CARDS ***
Dealt to 5e4b9d4f 
Dealt to 4250e296 
Dealt to d2253be4 
Dealt to 802b707d 
Dealt to Hero [4d 4c]
Dealt to 17e1b126 
Dealt to bd8abd3 
Dealt to 3ed018f9 
Hero: calls 2,500
17e1b126: folds
bd8abd3: folds
3ed018f9: raises 5,000 to 7,500
5e4b9d4f: calls 7,500
4250e296: folds
d2253be4: folds
802b707d: folds
Hero: calls 5,000
*** FLOP *** [Qh Kc 5s]
Hero: checks
3ed018f9: bets 14,525
5e4b9d4f: folds
Hero: folds
Uncalled bet (14,525) returned to 3ed018f9
*** SHOWDOWN ***
3ed018f9 collected 29,050 from pot
*** SUMMARY ***
Total pot 29,050 | Rake 0 | Jackpot 0 | Bingo 0 | Fortune 0 | Tax 0
Board [Qh Kc 5s]
Seat 1: 5e4b9d4f folded on the Flop
Seat 2: 4250e296 (button) folded before Flop
Seat 3: d2253be4 (small blind) folded before Flop
Seat 4: 802b707d (big blind) folded before Flop
Seat 5: Hero folded on the Flop
Seat 6: 17e1b126 folded before Flop
Seat 7: bd8abd3 folded before Flop
Seat 8: 3ed018f9 won (29,050)


Poker Hand #TM3449968295: Tournament #149964808, Bounty Hunters Special $1.08 Hold'em No Limit - Level16(1,000/2,000) - 2024/07/03 23:22:44
Table '8' 8-max Seat #1 is the button
Seat 1: 5e4b9d4f (154,272 in chips)
Seat 2: 4250e296 (63,014 in chips)
Seat 3: d2253be4 (38,670 in chips)
Seat 4: 802b707d (9,853 in chips)
Seat 5: Hero (96,207 in chips)
Seat 6: 17e1b126 (58,685 in chips)
Seat 7: bd8abd3 (46,251 in chips)
Seat 8: 3ed018f9 (191,477 in chips)
5e4b9d4f: posts the ante 300
4250e296: posts the ante 300
802b707d: posts the ante 300
d2253be4: posts the ante 300
3ed018f9: posts the ante 300
17e1b126: posts the ante 300
Hero: posts the ante 300
bd8abd3: posts the ante 300
4250e296: posts small blind 1,000
d2253be4: posts big blind 2,000
*** HOLE CARDS ***
Dealt to 5e4b9d4f 
Dealt to 4250e296 
Dealt to d2253be4 
Dealt to 802b707d 
Dealt to Hero [4s 7s]
Dealt to 17e1b126 
Dealt to bd8abd3 
Dealt to 3ed018f9 
802b707d: raises 2,000 to 4,000
Hero: folds
17e1b126: folds
bd8abd3: folds
3ed018f9: calls 4,000
5e4b9d4f: folds
4250e296: calls 3,000
d2253be4: calls 2,000
*** FLOP *** [3h 7c Qc]
4250e296: checks
d2253be4: checks
802b707d: checks
3ed018f9: checks
*** TURN *** [3h 7c Qc] [8h]
4250e296: checks
d2253be4: checks
802b707d: checks
3ed018f9: checks
*** RIVER *** [3h 7c Qc 8h] [5c]
4250e296: checks
d2253be4: checks
802b707d: checks
3ed018f9: checks
4250e296: shows [2d 2s] (Pair of Twos)
d2253be4: shows [2c 5h] (Pair of Fives)
802b707d: shows [Js Tc] (Queen-High)
3ed018f9: shows [9s Jd] (Queen-High)
*** SHOWDOWN ***
d2253be4 collected 18,400 from pot
*** SUMMARY ***
Total pot 18,400 | Rake 0 | Jackpot 0 | Bingo 0 | Fortune 0 | Tax 0
Board [3h 7c Qc 8h 5c]
Seat 1: 5e4b9d4f (button) folded before Flop
Seat 2: 4250e296 (small blind) showed [2d 2s] and lost with Pair of Twos
Seat 3: d2253be4 (big blind) showed [2c 5h] and won (18,400) with Pair of Fives
Seat 4: 802b707d showed [Js Tc] and lost with Queen-High
Seat 5: Hero folded before Flop
Seat 6: 17e1b126 folded before Flop
Seat 7: bd8abd3 folded before Flop
Seat 8: 3ed018f9 showed [9s Jd] and lost with Queen-High


Poker Hand #TM3449968218: Tournament #149964808, Bounty Hunters Special $1.08 Hold'em No Limit - Level16(1,000/2,000) - 2024/07/03 23:21:37
Table '8' 8-max Seat #8 is the button
Seat 1: 5e4b9d4f (144,372 in chips)
Seat 2: 4250e296 (71,414 in chips)
Seat 4: 802b707d (10,153 in chips)
Seat 5: Hero (96,507 in chips)
Seat 6: 17e1b126 (58,985 in chips)
Seat 7: bd8abd3 (46,551 in chips)
Seat 8: 3ed018f9 (191,777 in chips)
4250e296: posts the ante 300
5e4b9d4f: posts the ante 300
802b707d: posts the ante 300
3ed018f9: posts the ante 300
17e1b126: posts the ante 300
Hero: posts the ante 300
bd8abd3: posts the ante 300
5e4b9d4f: posts small blind 1,000
4250e296: posts big blind 2,000
*** HOLE CARDS ***
Dealt to 5e4b9d4f 
Dealt to 4250e296 
Dealt to 802b707d 
Dealt to Hero [8d Kc]
Dealt to 17e1b126 
Dealt to bd8abd3 
Dealt to 3ed018f9 
802b707d: folds
Hero: folds
17e1b126: folds
bd8abd3: folds
3ed018f9: folds
5e4b9d4f: calls 1,000
4250e296: checks
*** FLOP *** [Qd 2d 7s]
5e4b9d4f: checks
4250e296: checks
*** TURN *** [Qd 2d 7s] [Ks]
5e4b9d4f: checks
4250e296: checks
*** RIVER *** [Qd 2d 7s Ks] [Js]
5e4b9d4f: bets 6,100
4250e296: calls 6,100
5e4b9d4f: shows [Ts Ac] (Aces-High Straight)
4250e296: shows [5h Jd] (Pair of Jacks)
*** SHOWDOWN ***
5e4b9d4f collected 18,300 from pot
*** SUMMARY ***
Total pot 18,300 | Rake 0 | Jackpot 0 | Bingo 0 | Fortune 0 | Tax 0
Board [Qd 2d 7s Ks Js]
Seat 1: 5e4b9d4f (small blind) showed [Ts Ac] and won (18,300) with Aces-High Straight
Seat 2: 4250e296 (big blind) showed [5h Jd] and lost with Pair of Jacks
Seat 4: 802b707d folded before Flop
Seat 5: Hero folded before Flop
Seat 6: 17e1b126 folded before Flop
Seat 7: bd8abd3 folded before Flop
Seat 8: 3ed018f9 (button) folded before Flop


Poker Hand #TM3449968172: Tournament #149964808, Bounty Hunters Special $1.08 Hold'em No Limit - Level16(1,000/2,000) - 2024/07/03 23:20:49
Table '8' 8-max Seat #7 is the button
Seat 1: 5e4b9d4f (146,672 in chips)
Seat 2: 4250e296 (71,714 in chips)
Seat 3: ebbb8fdf (5,911 in chips)
Seat 5: Hero (96,807 in chips)
Seat 6: 17e1b126 (59,285 in chips)
Seat 7: bd8abd3 (46,851 in chips)
Seat 8: 3ed018f9 (182,366 in chips)
ebbb8fdf: posts the ante 300
4250e296: posts the ante 300
5e4b9d4f: posts the ante 300
17e1b126: posts the ante 300
3ed018f9: posts the ante 300
Hero: posts the ante 300
bd8abd3: posts the ante 300
3ed018f9: posts small blind 1,000
5e4b9d4f: posts big blind 2,000
*** HOLE CARDS ***
Dealt to 5e4b9d4f 
Dealt to 4250e296 
Dealt to ebbb8fdf 
Dealt to Hero [2s 4s]
Dealt to 17e1b126 
Dealt to bd8abd3 
Dealt to 3ed018f9 
4250e296: folds
ebbb8fdf: raises 3,611 to 5,611 and is all-in
Hero: folds
17e1b126: folds
bd8abd3: folds
3ed018f9: raises 15,322 to 20,933
5e4b9d4f: folds
Uncalled bet (15,322) returned to 3ed018f9
3ed018f9: shows [Ad Tc]
ebbb8fdf: shows [Th Td]
*** FLOP *** [3h Ac 8h]
*** TURN *** [3h Ac 8h] [9h]
*** RIVER *** [3h Ac 8h 9h] [8d]
*** SHOWDOWN ***
3ed018f9 collected 15,322 from pot
*** SUMMARY ***
Total pot 15,322 | Rake 0 | Jackpot 0 | Bingo 0 | Fortune 0 | Tax 0
Board [3h Ac 8h 9h 8d]
Seat 1: 5e4b9d4f (big blind) folded before Flop
Seat 2: 4250e296 folded before Flop
Seat 3: ebbb8fdf showed [Th Td] and lost with Pair of Tens and Pair of Eights
Seat 5: Hero folded before Flop
Seat 6: 17e1b126 folded before Flop
Seat 7: bd8abd3 (button) folded before Flop
Seat 8: 3ed018f9 (small blind) showed [Ad Tc] and won (15,322) with Pair of Aces and Pair of Eights


Poker Hand #TM3449968143: Tournament #149964808, Bounty Hunters Special $1.08 Hold'em No Limit - Level16(1,000/2,000) - 2024/07/03 23:20:22
Table '8' 8-max Seat #6 is the button
Seat 1: 5e4b9d4f (146,972 in chips)
Seat 2: 4250e296 (72,014 in chips)
Seat 3: ebbb8fdf (6,211 in chips)
Seat 5: Hero (97,107 in chips)
Seat 6: 17e1b126 (59,585 in chips)
Seat 7: bd8abd3 (48,151 in chips)
Seat 8: 3ed018f9 (179,566 in chips)
ebbb8fdf: posts the ante 300
4250e296: posts the ante 300
5e4b9d4f: posts the ante 300
17e1b126: posts the ante 300
3ed018f9: posts the ante 300
Hero: posts the ante 300
bd8abd3: posts the ante 300
bd8abd3: posts small blind 1,000
3ed018f9: posts big blind 2,000
*** HOLE CARDS ***
Dealt to 5e4b9d4f 
Dealt to 4250e296 
Dealt to ebbb8fdf 
Dealt to Hero [4h As]
Dealt to 17e1b126 
Dealt to bd8abd3 
Dealt to 3ed018f9 
5e4b9d4f: folds
4250e296: folds
ebbb8fdf: folds
Hero: folds
17e1b126: folds
bd8abd3: folds
Uncalled bet (1,000) returned to 3ed018f9
*** SHOWDOWN ***
3ed018f9 collected 4,100 from pot
*** SUMMARY ***
Total pot 4,100 | Rake 0 | Jackpot 0 | Bingo 0 | Fortune 0 | Tax 0
Seat 1: 5e4b9d4f folded before Flop
Seat 2: 4250e296 folded before Flop
Seat 3: ebbb8fdf folded before Flop
Seat 5: Hero folded before Flop
Seat 6: 17e1b126 (button) folded before Flop
Seat 7: bd8abd3 (small blind) folded before Flop
Seat 8: 3ed018f9 (big blind) collected (4,100)


Poker Hand #TM3449968030: Tournament #149964808, Bounty Hunters Special $1.08 Hold'em No Limit - Level16(1,000/2,000) - 2024/07/03 23:18:38
Table '8' 8-max Seat #5 is the button
Seat 1: 5e4b9d4f (92,184 in chips)
Seat 2: 4250e296 (72,314 in chips)
Seat 3: ebbb8fdf (6,511 in chips)
Seat 4: a5661ff2 (16,322 in chips)
Seat 5: Hero (97,407 in chips)
Seat 6: 17e1b126 (60,885 in chips)
Seat 7: bd8abd3 (50,451 in chips)
Seat 8: 3ed018f9 (213,532 in chips)
ebbb8fdf: posts the ante 300
a5661ff2: posts the ante 300
4250e296: posts the ante 300
5e4b9d4f: posts the ante 300
3ed018f9: posts the ante 300
17e1b126: posts the ante 300
Hero: posts the ante 300
bd8abd3: posts the ante 300
17e1b126: posts small blind 1,000
bd8abd3: posts big blind 2,000
*** HOLE CARDS ***
Dealt to 5e4b9d4f 
Dealt to 4250e296 
Dealt to ebbb8fdf 
Dealt to a5661ff2 
Dealt to Hero [2s 8s]
Dealt to 17e1b126 
Dealt to bd8abd3 
Dealt to 3ed018f9 
3ed018f9: raises 4,000 to 6,000
5e4b9d4f: calls 6,000
4250e296: folds
ebbb8fdf: folds
a5661ff2: raises 10,022 to 16,022 and is all-in
Hero: folds
17e1b126: folds
bd8abd3: folds
3ed018f9: calls 10,022
5e4b9d4f: calls 10,022
*** FLOP *** [7h Qh Js]
3ed018f9: checks
5e4b9d4f: bets 17,644
3ed018f9: calls 17,644
*** TURN *** [7h Qh Js] [2c]
3ed018f9: checks
5e4b9d4f: bets 44,377
3ed018f9: folds
Uncalled bet (44,377) returned to 5e4b9d4f
5e4b9d4f: shows [Jc Jd] (Three Jacks)
a5661ff2: shows [Qd Ah] (Pair of Queens)
*** RIVER *** [7h Qh Js 2c] [7s]
*** SHOWDOWN ***
5e4b9d4f collected 53,466 from pot
5e4b9d4f collected 35,288 from pot
*** SUMMARY ***
Total pot 88,754 | Rake 0 | Jackpot 0 | Bingo 0 | Fortune 0 | Tax 0
Board [7h Qh Js 2c 7s]
Seat 1: 5e4b9d4f showed [Jc Jd] and won (88,754) with Jacks Full over Sevens
Seat 2: 4250e296 folded before Flop
Seat 3: ebbb8fdf folded before Flop
Seat 4: a5661ff2 showed [Qd Ah] and lost with Pair of Queens and Pair of Sevens
Seat 5: Hero (button) folded before Flop
Seat 6: 17e1b126 (small blind) folded before Flop
Seat 7: bd8abd3 (big blind) folded before Flop
Seat 8: 3ed018f9 folded on the Turn


Poker Hand #TM3449967939: Tournament #149964808, Bounty Hunters Special $1.08 Hold'em No Limit - Level16(1,000/2,000) - 2024/07/03 23:17:12
Table '8' 8-max Seat #4 is the button
Seat 1: 5e4b9d4f (94,484 in chips)
Seat 2: 4250e296 (59,452 in chips)
Seat 3: ebbb8fdf (6,811 in chips)
Seat 4: a5661ff2 (16,622 in chips)
Seat 5: Hero (98,707 in chips)
Seat 6: 17e1b126 (63,185 in chips)
Seat 7: bd8abd3 (50,751 in chips)
Seat 8: 3ed018f9 (219,594 in chips)
ebbb8fdf: posts the ante 300
a5661ff2: posts the ante 300
4250e296: posts the ante 300
5e4b9d4f: posts the ante 300
3ed018f9: posts the ante 300
17e1b126: posts the ante 300
Hero: posts the ante 300
bd8abd3: posts the ante 300
Hero: posts small blind 1,000
17e1b126: posts big blind 2,000
*** HOLE CARDS ***
Dealt to 5e4b9d4f 
Dealt to 4250e296 
Dealt to ebbb8fdf 
Dealt to a5661ff2 
Dealt to Hero [4h Td]
Dealt to 17e1b126 
Dealt to bd8abd3 
Dealt to 3ed018f9 
bd8abd3: folds
3ed018f9: calls 2,000
5e4b9d4f: calls 2,000
4250e296: calls 2,000
ebbb8fdf: folds
a5661ff2: folds
Hero: folds
17e1b126: checks
*** FLOP *** [Js 3d 8h]
17e1b126: checks
3ed018f9: bets 3,762
5e4b9d4f: folds
4250e296: raises 11,238 to 15,000
17e1b126: folds
3ed018f9: folds
Uncalled bet (11,238) returned to 4250e296
*** SHOWDOWN ***
4250e296 collected 18,924 from pot
*** SUMMARY ***
Total pot 18,924 | Rake 0 | Jackpot 0 | Bingo 0 | Fortune 0 | Tax 0
Board [Js 3d 8h]
Seat 1: 5e4b9d4f folded on the Flop
Seat 2: 4250e296 won (18,924)
Seat 3: ebbb8fdf folded before Flop
Seat 4: a5661ff2 (button) folded before Flop
Seat 5: Hero (small blind) folded before Flop
Seat 6: 17e1b126 (big blind) folded on the Flop
Seat 7: bd8abd3 folded before Flop
Seat 8: 3ed018f9 folded on the Flop


Poker Hand #TM3449967892: Tournament #149964808, Bounty Hunters Special $1.08 Hold'em No Limit - Level16(1,000/2,000) - 2024/07/03 23:16:31
Table '8' 8-max Seat #3 is the button
Seat 1: 5e4b9d4f (96,784 in chips)
Seat 2: 4250e296 (59,752 in chips)
Seat 3: ebbb8fdf (7,111 in chips)
Seat 4: a5661ff2 (17,922 in chips)
Seat 5: Hero (101,007 in chips)
Seat 6: 17e1b126 (63,485 in chips)
Seat 7: bd8abd3 (51,051 in chips)
Seat 8: 3ed018f9 (212,494 in chips)
ebbb8fdf: posts the ante 300
a5661ff2: posts the ante 300
4250e296: posts the ante 300
5e4b9d4f: posts the ante 300
3ed018f9: posts the ante 300
17e1b126: posts the ante 300
Hero: posts the ante 300
bd8abd3: posts the ante 300
a5661ff2: posts small blind 1,000
Hero: posts big blind 2,000
*** HOLE CARDS ***
Dealt to 5e4b9d4f 
Dealt to 4250e296 
Dealt to ebbb8fdf 
Dealt to a5661ff2 
Dealt to Hero [3s Tc]
Dealt to 17e1b126 
Dealt to bd8abd3 
Dealt to 3ed018f9 
17e1b126: folds
bd8abd3: folds
3ed018f9: calls 2,000
5e4b9d4f: calls 2,000
4250e296: folds
ebbb8fdf: folds
a5661ff2: folds
Hero: checks
*** FLOP *** [Jh Ks 2c]
Hero: checks
3ed018f9: bets 4,700
5e4b9d4f: folds
Hero: folds
Uncalled bet (4,700) returned to 3ed018f9
*** SHOWDOWN ***
3ed018f9 collected 9,400 from pot
*** SUMMARY ***
Total pot 9,400 | Rake 0 | Jackpot 0 | Bingo 0 | Fortune 0 | Tax 0
Board [Jh Ks 2c]
Seat 1: 5e4b9d4f folded on the Flop
Seat 2: 4250e296 folded before Flop
Seat 3: ebbb8fdf (button) folded before Flop
Seat 4: a5661ff2 (small blind) folded before Flop
Seat 5: Hero (big blind) folded on the Flop
Seat 6: 17e1b126 folded before Flop
Seat 7: bd8abd3 folded before Flop
Seat 8: 3ed018f9 won (9,400)


Poker Hand #TM3449967826: Tournament #149964808, Bounty Hunters Special $1.08 Hold'em No Limit - Level16(1,000/2,000) - 2024/07/03 23:15:28
Table '8' 8-max Seat #2 is the button
Seat 1: 5e4b9d4f (99,084 in chips)
Seat 2: 4250e296 (50,652 in chips)
Seat 3: ebbb8fdf (8,411 in chips)
Seat 4: a5661ff2 (20,222 in chips)
Seat 5: Hero (101,307 in chips)
Seat 6: 17e1b126 (63,785 in chips)
Seat 7: bd8abd3 (51,351 in chips)
Seat 8: 3ed018f9 (214,794 in chips)
ebbb8fdf: posts the ante 300
a5661ff2: posts the ante 300
4250e296: posts the ante 300
5e4b9d4f: posts the ante 300
3ed018f9: posts the ante 300
17e1b126: posts the ante 300
Hero: posts the ante 300
bd8abd3: posts the ante 300
ebbb8fdf: posts small blind 1,000
a5661ff2: posts big blind 2,000
*** HOLE CARDS ***
Dealt to 5e4b9d4f 
Dealt to 4250e296 
Dealt to ebbb8fdf 
Dealt to a5661ff2 
Dealt to Hero [Qs 9c]
Dealt to 17e1b126 
Dealt to bd8abd3 
Dealt to 3ed018f9 
Hero: folds
17e1b126: folds
bd8abd3: folds
3ed018f9: calls 2,000
5e4b9d4f: calls 2,000
4250e296: calls 2,000
ebbb8fdf: folds
a5661ff2: checks
*** FLOP *** [Js Ah 7s]
a5661ff2: checks
3ed018f9: checks
5e4b9d4f: checks
4250e296: bets 5,700
a5661ff2: folds
3ed018f9: folds
5e4b9d4f: folds
Uncalled bet (5,700) returned to 4250e296
*** SHOWDOWN ***
4250e296 collected 11,400 from pot
*** SUMMARY ***
Total pot 11,400 | Rake 0 | Jackpot 0 | Bingo 0 | Fortune 0 | Tax 0
Board [Js Ah 7s]
Seat 1: 5e4b9d4f folded on the Flop
Seat 2: 4250e296 (button) won (11,400)
Seat 3: ebbb8fdf (small blind) folded before Flop
Seat 4: a5661ff2 (big blind) folded on the Flop
Seat 5: Hero folded before Flop
Seat 6: 17e1b126 folded before Flop
Seat 7: bd8abd3 folded before Flop
Seat 8: 3ed018f9 folded on the Flop


Poker Hand #TM3449967731: Tournament #149964808, Bounty Hunters Special $1.08 Hold'em No Limit - Level15(800/1,600) - 2024/07/03 23:13:56
Table '8' 8-max Seat #1 is the button
Seat 1: 5e4b9d4f (99,334 in chips)
Seat 2: 4250e296 (54,262 in chips)
Seat 3: ebbb8fdf (16,008 in chips)
Seat 4: a5661ff2 (20,472 in chips)
Seat 5: Hero (101,557 in chips)
Seat 6: 17e1b126 (51,328 in chips)
Seat 7: bd8abd3 (51,601 in chips)
Seat 8: 3ed018f9 (215,044 in chips)
ebbb8fdf: posts the ante 250
a5661ff2: posts the ante 250
5e4b9d4f: posts the ante 250
4250e296: posts the ante 250
3ed018f9: posts the ante 250
17e1b126: posts the ante 250
Hero: posts the ante 250
bd8abd3: posts the ante 250
4250e296: posts small blind 800
ebbb8fdf: posts big blind 1,600
*** HOLE CARDS ***
Dealt to 5e4b9d4f 
Dealt to 4250e296 
Dealt to ebbb8fdf 
Dealt to a5661ff2 
Dealt to Hero [4d 6d]
Dealt to 17e1b126 
Dealt to bd8abd3 
Dealt to 3ed018f9 
a5661ff2: folds
Hero: folds
17e1b126: raises 1,760 to 3,360
bd8abd3: folds
3ed018f9: folds
5e4b9d4f: folds
4250e296: calls 2,560
ebbb8fdf: calls 1,760
*** FLOP *** [Th Qs 3s]
4250e296: checks
ebbb8fdf: checks
17e1b126: checks
*** TURN *** [Th Qs 3s] [Js]
4250e296: checks
ebbb8fdf: checks
17e1b126: bets 3,987
4250e296: folds
ebbb8fdf: calls 3,987
*** RIVER *** [Th Qs 3s Js] [Qc]
ebbb8fdf: checks
17e1b126: bets 10,830
ebbb8fdf: folds
Uncalled bet (10,830) returned to 17e1b126
*** SHOWDOWN ***
17e1b126 collected 20,054 from pot
*** SUMMARY ***
Total pot 20,054 | Rake 0 | Jackpot 0 | Bingo 0 | Fortune 0 | Tax 0
Board [Th Qs 3s Js Qc]
Seat 1: 5e4b9d4f (button) folded before Flop
Seat 2: 4250e296 (small blind) folded on the Turn
Seat 3: ebbb8fdf (big blind) folded on the River
Seat 4: a5661ff2 folded before Flop
Seat 5: Hero folded before Flop
Seat 6: 17e1b126 won (20,054)
Seat 7: bd8abd3 folded before Flop
Seat 8: 3ed018f9 folded before Flop


Poker Hand #TM3449967674: Tournament #149964808, Bounty Hunters Special $1.08 Hold'em No Limit - Level15(800/1,600) - 2024/07/03 23:13:06
Table '8' 8-max Seat #8 is the button
Seat 1: 5e4b9d4f (95,984 in chips)
Seat 2: 4250e296 (56,112 in chips)
Seat 3: ebbb8fdf (16,258 in chips)
Seat 4: a5661ff2 (20,722 in chips)
Seat 5: Hero (101,807 in chips)
Seat 6: 17e1b126 (51,578 in chips)
Seat 7: bd8abd3 (51,851 in chips)
Seat 8: 3ed018f9 (215,294 in chips)
ebbb8fdf: posts the ante 250
a5661ff2: posts the ante 250
4250e296: posts the ante 250
5e4b9d4f: posts the ante 250
3ed018f9: posts the ante 250
17e1b126: posts the ante 250
Hero: posts the ante 250
bd8abd3: posts the ante 250
5e4b9d4f: posts small blind 800
4250e296: posts big blind 1,600
*** HOLE CARDS ***
Dealt to 5e4b9d4f 
Dealt to 4250e296 
Dealt to ebbb8fdf 
Dealt to a5661ff2 
Dealt to Hero [6c Ts]
Dealt to 17e1b126 
Dealt to bd8abd3 
Dealt to 3ed018f9 
ebbb8fdf: folds
a5661ff2: folds
Hero: folds
17e1b126: folds
bd8abd3: folds
3ed018f9: folds
5e4b9d4f: calls 800
4250e296: checks
*** FLOP *** [3c Ks 2h]
5e4b9d4f: checks
4250e296: checks
*** TURN *** [3c Ks 2h] [8h]
5e4b9d4f: checks
4250e296: checks
*** RIVER *** [3c Ks 2h 8h] [3d]
5e4b9d4f: checks
4250e296: checks
5e4b9d4f: shows [Qd Th] (Pair of Treys)
4250e296: shows [Td 9h] (Pair of Treys)
*** SHOWDOWN ***
5e4b9d4f collected 5,200 from pot
*** SUMMARY ***
Total pot 5,200 | Rake 0 | Jackpot 0 | Bingo 0 | Fortune 0 | Tax 0
Board [3c Ks 2h 8h 3d]
Seat 1: 5e4b9d4f (small blind) showed [Qd Th] and won (5,200) with Pair of Treys
Seat 2: 4250e296 (big blind) showed [Td 9h] and lost with Pair of Treys
Seat 3: ebbb8fdf folded before Flop
Seat 4: a5661ff2 folded before Flop
Seat 5: Hero folded before Flop
Seat 6: 17e1b126 folded before Flop
Seat 7: bd8abd3 folded before Flop
Seat 8: 3ed018f9 (button) folded before Flop


Poker Hand #TM3449967629: Tournament #149964808, Bounty Hunters Special $1.08 Hold'em No Limit - Level15(800/1,600) - 2024/07/03 23:12:23
Table '8' 8-max Seat #7 is the button
Seat 1: 5e4b9d4f (101,034 in chips)
Seat 2: 4250e296 (56,362 in chips)
Seat 3: ebbb8fdf (16,508 in chips)
Seat 4: a5661ff2 (20,972 in chips)
Seat 5: Hero (94,457 in chips)
Seat 6: 17e1b126 (51,828 in chips)
Seat 7: bd8abd3 (52,101 in chips)
Seat 8: 3ed018f9 (216,344 in chips)
ebbb8fdf: posts the ante 250
a5661ff2: posts the ante 250
4250e296: posts the ante 250
5e4b9d4f: posts the ante 250
17e1b126: posts the ante 250
3ed018f9: posts the ante 250
Hero: posts the ante 250
bd8abd3: posts the ante 250
3ed018f9: posts small blind 800
5e4b9d4f: posts big blind 1,600
*** HOLE CARDS ***
Dealt to 5e4b9d4f 
Dealt to 4250e296 
Dealt to ebbb8fdf 
Dealt to a5661ff2 
Dealt to Hero [As Ad]
Dealt to 17e1b126 
Dealt to bd8abd3 
Dealt to 3ed018f9 
4250e296: folds
ebbb8fdf: folds
a5661ff2: folds
Hero: raises 3,200 to 4,800
17e1b126: folds
bd8abd3: folds
3ed018f9: folds
5e4b9d4f: calls 3,200
*** FLOP *** [Js Qd Kh]
5e4b9d4f: checks
Hero: bets 12,400
5e4b9d4f: folds
Uncalled bet (12,400) returned to Hero
*** SHOWDOWN ***
Hero collected 12,400 from pot
*** SUMMARY ***
Total pot 12,400 | Rake 0 | Jackpot 0 | Bingo 0 | Fortune 0 | Tax 0
Board [Js Qd Kh]
Seat 1: 5e4b9d4f (big blind) folded on the Flop
Seat 2: 4250e296 folded before Flop
Seat 3: ebbb8fdf folded before Flop
Seat 4: a5661ff2 folded before Flop
Seat 5: Hero won (12,400)
Seat 6: 17e1b126 folded before Flop
Seat 7: bd8abd3 (button) folded before Flop
Seat 8: 3ed018f9 (small blind) folded before Flop


Poker Hand #TM3449967594: Tournament #149964808, Bounty Hunters Special $1.08 Hold'em No Limit - Level15(800/1,600) - 2024/07/03 23:11:49
Table '8' 8-max Seat #6 is the button
Seat 1: 5e4b9d4f (101,284 in chips)
Seat 2: 4250e296 (56,612 in chips)
Seat 3: ebbb8fdf (16,758 in chips)
Seat 4: a5661ff2 (16,822 in chips)
Seat 5: Hero (94,707 in chips)
Seat 6: 17e1b126 (52,078 in chips)
Seat 7: bd8abd3 (53,151 in chips)
Seat 8: 3ed018f9 (218,194 in chips)
ebbb8fdf: posts the ante 250
a5661ff2: posts the ante 250
4250e296: posts the ante 250
5e4b9d4f: posts the ante 250
17e1b126: posts the ante 250
3ed018f9: posts the ante 250
Hero: posts the ante 250
bd8abd3: posts the ante 250
bd8abd3: posts small blind 800
3ed018f9: posts big blind 1,600
*** HOLE CARDS ***
Dealt to 5e4b9d4f 
Dealt to 4250e296 
Dealt to ebbb8fdf 
Dealt to a5661ff2 
Dealt to Hero [4d 8c]
Dealt to 17e1b126 
Dealt to bd8abd3 
Dealt to 3ed018f9 
5e4b9d4f: folds
4250e296: folds
ebbb8fdf: folds
a5661ff2: raises 14,400 to 16,000
Hero: folds
17e1b126: folds
bd8abd3: folds
3ed018f9: folds
Uncalled bet (14,400) returned to a5661ff2
*** SHOWDOWN ***
a5661ff2 collected 6,000 from pot
*** SUMMARY ***
Total pot 6,000 | Rake 0 | Jackpot 0 | Bingo 0 | Fortune 0 | Tax 0
Seat 1: 5e4b9d4f folded before Flop
Seat 2: 4250e296 folded before Flop
Seat 3: ebbb8fdf folded before Flop
Seat 4: a5661ff2 collected (6,000)
Seat 5: Hero folded before Flop
Seat 6: 17e1b126 (button) folded before Flop
Seat 7: bd8abd3 (small blind) folded before Flop
Seat 8: 3ed018f9 (big blind) folded before Flop


Poker Hand #TM3449967558: Tournament #149964808, Bounty Hunters Special $1.08 Hold'em No Limit - Level15(800/1,600) - 2024/07/03 23:11:19
Table '8' 8-max Seat #5 is the button
Seat 1: 5e4b9d4f (101,534 in chips)
Seat 2: 4250e296 (56,862 in chips)
Seat 3: ebbb8fdf (17,008 in chips)
Seat 4: a5661ff2 (17,072 in chips)
Seat 5: Hero (94,957 in chips)
Seat 6: 17e1b126 (53,128 in chips)
Seat 7: bd8abd3 (55,001 in chips)
Seat 8: 3ed018f9 (214,044 in chips)
ebbb8fdf: posts the ante 250
a5661ff2: posts the ante 250
4250e296: posts the ante 250
5e4b9d4f: posts the ante 250
3ed018f9: posts the ante 250
17e1b126: posts the ante 250
Hero: posts the ante 250
bd8abd3: posts the ante 250
17e1b126: posts small blind 800
bd8abd3: posts big blind 1,600
*** HOLE CARDS ***
Dealt to 5e4b9d4f 
Dealt to 4250e296 
Dealt to ebbb8fdf 
Dealt to a5661ff2 
Dealt to Hero [8d Js]
Dealt to 17e1b126 
Dealt to bd8abd3 
Dealt to 3ed018f9 
3ed018f9: raises 3,200 to 4,800
5e4b9d4f: folds
4250e296: folds
ebbb8fdf: folds
a5661ff2: folds
Hero: folds
17e1b126: folds
bd8abd3: folds
Uncalled bet (3,200) returned to 3ed018f9
*** SHOWDOWN ***
3ed018f9 collected 6,000 from pot
*** SUMMARY ***
Total pot 6,000 | Rake 0 | Jackpot 0 | Bingo 0 | Fortune 0 | Tax 0
Seat 1: 5e4b9d4f folded before Flop
Seat 2: 4250e296 folded before Flop
Seat 3: ebbb8fdf folded before Flop
Seat 4: a5661ff2 folded before Flop
Seat 5: Hero (button) folded before Flop
Seat 6: 17e1b126 (small blind) folded before Flop
Seat 7: bd8abd3 (big blind) folded before Flop
Seat 8: 3ed018f9 collected (6,000)


Poker Hand #TM3449967448: Tournament #149964808, Bounty Hunters Special $1.08 Hold'em No Limit - Level15(800/1,600) - 2024/07/03 23:09:37
Table '8' 8-max Seat #4 is the button
Seat 1: 5e4b9d4f (111,459 in chips)
Seat 2: 4250e296 (57,112 in chips)
Seat 4: a5661ff2 (17,322 in chips)
Seat 5: Hero (78,982 in chips)
Seat 6: 17e1b126 (54,978 in chips)
Seat 7: bd8abd3 (55,251 in chips)
Seat 8: 3ed018f9 (217,494 in chips)
a5661ff2: posts the ante 250
4250e296: posts the ante 250
5e4b9d4f: posts the ante 250
3ed018f9: posts the ante 250
17e1b126: posts the ante 250
Hero: posts the ante 250
bd8abd3: posts the ante 250
Hero: posts small blind 800
17e1b126: posts big blind 1,600
*** HOLE CARDS ***
Dealt to 5e4b9d4f 
Dealt to 4250e296 
Dealt to a5661ff2 
Dealt to Hero [Qs Ts]
Dealt to 17e1b126 
Dealt to bd8abd3 
Dealt to 3ed018f9 
bd8abd3: folds
3ed018f9: calls 1,600
5e4b9d4f: calls 1,600
4250e296: folds
a5661ff2: folds
Hero: calls 800
17e1b126: checks
*** FLOP *** [Jd As Kd]
Hero: checks
17e1b126: checks
3ed018f9: checks
5e4b9d4f: checks
*** TURN *** [Jd As Kd] [9d]
Hero: bets 1,600
17e1b126: folds
3ed018f9: calls 1,600
5e4b9d4f: calls 1,600
*** RIVER *** [Jd As Kd 9d] [8c]
Hero: bets 6,475
3ed018f9: folds
5e4b9d4f: calls 6,475
Hero: shows [Qs Ts] (Aces-High Straight)
5e4b9d4f: shows [9c Ks] (Pair of Kings and Pair of Nines)
*** SHOWDOWN ***
Hero collected 25,900 from pot
*** SUMMARY ***
Total pot 25,900 | Rake 0 | Jackpot 0 | Bingo 0 | Fortune 0 | Tax 0
Board [Jd As Kd 9d 8c]
Seat 1: 5e4b9d4f showed [9c Ks] and lost with Pair of Kings and Pair of Nines
Seat 2: 4250e296 folded before Flop
Seat 4: a5661ff2 (button) folded before Flop
Seat 5: Hero (small blind) showed [Qs Ts] and won (25,900) with Aces-High Straight
Seat 6: 17e1b126 (big blind) folded on the Turn
Seat 7: bd8abd3 folded before Flop
Seat 8: 3ed018f9 folded on the River


Poker Hand #TM3449967389: Tournament #149964808, Bounty Hunters Special $1.08 Hold'em No Limit - Level15(800/1,600) - 2024/07/03 23:08:38
Table '8' 8-max Seat #2 is the button
Seat 1: 5e4b9d4f (111,709 in chips)
Seat 2: 4250e296 (60,562 in chips)
Seat 3: aa4e3dbf (13,913 in chips)
Seat 4: a5661ff2 (19,172 in chips)
Seat 5: Hero (79,232 in chips)
Seat 6: 17e1b126 (55,228 in chips)
Seat 7: bd8abd3 (55,501 in chips)
Seat 8: 3ed018f9 (197,281 in chips)
a5661ff2: posts the ante 250
4250e296: posts the ante 250
5e4b9d4f: posts the ante 250
3ed018f9: posts the ante 250
17e1b126: posts the ante 250
aa4e3dbf: posts the ante 250
Hero: posts the ante 250
bd8abd3: posts the ante 250
aa4e3dbf: posts small blind 800
a5661ff2: posts big blind 1,600
*** HOLE CARDS ***
Dealt to 5e4b9d4f 
Dealt to 4250e296 
Dealt to aa4e3dbf 
Dealt to a5661ff2 
Dealt to Hero [Tc 3c]
Dealt to 17e1b126 
Dealt to bd8abd3 
Dealt to 3ed018f9 
Hero: folds
17e1b126: folds
bd8abd3: folds
3ed018f9: raises 1,600 to 3,200
5e4b9d4f: folds
4250e296: calls 3,200
aa4e3dbf: raises 10,463 to 13,663 and is all-in
a5661ff2: folds
3ed018f9: calls 10,463
4250e296: folds
aa4e3dbf: shows [As Ts]
3ed018f9: shows [Kh 6h]
*** FLOP *** [7d 9d 9c]
*** TURN *** [7d 9d 9c] [6d]
*** RIVER *** [7d 9d 9c 6d] [4h]
*** SHOWDOWN ***
3ed018f9 collected 34,126 from pot
*** SUMMARY ***
Total pot 34,126 | Rake 0 | Jackpot 0 | Bingo 0 | Fortune 0 | Tax 0
Board [7d 9d 9c 6d 4h]
Seat 1: 5e4b9d4f folded before Flop
Seat 2: 4250e296 (button) folded before Flop
Seat 3: aa4e3dbf (small blind) showed [As Ts] and lost with Pair of Nines
Seat 4: a5661ff2 (big blind) folded before Flop
Seat 5: Hero folded before Flop
Seat 6: 17e1b126 folded before Flop
Seat 7: bd8abd3 folded before Flop
Seat 8: 3ed018f9 showed [Kh 6h] and won (34,126) with Pair of Nines and Pair of Sixes


Poker Hand #TM3449967318: Tournament #149964808, Bounty Hunters Special $1.08 Hold'em No Limit - Level14(600/1,200) - 2024/07/03 23:07:16
Table '8' 8-max Seat #8 is the button
Seat 2: 4250e296 (52,282 in chips)
Seat 3: aa4e3dbf (16,493 in chips)
Seat 4: a5661ff2 (24,152 in chips)
Seat 5: Hero (79,412 in chips)
Seat 6: 17e1b126 (55,408 in chips)
Seat 7: bd8abd3 (55,681 in chips)
Seat 8: 3ed018f9 (197,461 in chips)
a5661ff2: posts the ante 180
4250e296: posts the ante 180
3ed018f9: posts the ante 180
17e1b126: posts the ante 180
aa4e3dbf: posts the ante 180
Hero: posts the ante 180
bd8abd3: posts the ante 180
4250e296: posts small blind 600
aa4e3dbf: posts big blind 1,200
*** HOLE CARDS ***
Dealt to 4250e296 
Dealt to aa4e3dbf 
Dealt to a5661ff2 
Dealt to Hero [9c Qh]
Dealt to 17e1b126 
Dealt to bd8abd3 
Dealt to 3ed018f9 
a5661ff2: raises 1,200 to 2,400
Hero: folds
17e1b126: folds
bd8abd3: folds
3ed018f9: folds
4250e296: calls 1,800
aa4e3dbf: calls 1,200
*** FLOP *** [Kc Kh 3d]
4250e296: checks
aa4e3dbf: checks
a5661ff2: checks
*** TURN *** [Kc Kh 3d] [3c]
4250e296: checks
aa4e3dbf: checks
a5661ff2: checks
*** RIVER *** [Kc Kh 3d 3c] [6c]
4250e296: bets 2,400
aa4e3dbf: folds
a5661ff2: calls 2,400
4250e296: shows [8d Kd] (Kings Full over Treys)
a5661ff2: shows [7h 6h] (Pair of Kings and Pair of Sixes)
*** SHOWDOWN ***
4250e296 collected 13,260 from pot
*** SUMMARY ***
Total pot 13,260 | Rake 0 | Jackpot 0 | Bingo 0 | Fortune 0 | Tax 0
Board [Kc Kh 3d 3c 6c]
Seat 2: 4250e296 (small blind) showed [8d Kd] and won (13,260) with Kings Full over Treys
Seat 3: aa4e3dbf (big blind) folded on the River
Seat 4: a5661ff2 showed [7h 6h] and lost with Pair of Kings and Pair of Sixes
Seat 5: Hero folded before Flop
Seat 6: 17e1b126 folded before Flop
Seat 7: bd8abd3 folded before Flop
Seat 8: 3ed018f9 (button) folded before Flop


Poker Hand #TM3449967268: Tournament #149964808, Bounty Hunters Special $1.08 Hold'em No Limit - Level14(600/1,200) - 2024/07/03 23:06:29
Table '8' 8-max Seat #7 is the button
Seat 2: 4250e296 (53,662 in chips)
Seat 3: aa4e3dbf (16,673 in chips)
Seat 4: a5661ff2 (24,332 in chips)
Seat 5: Hero (79,592 in chips)
Seat 6: 17e1b126 (55,588 in chips)
Seat 7: bd8abd3 (55,861 in chips)
Seat 8: 3ed018f9 (195,181 in chips)
a5661ff2: posts the ante 180
4250e296: posts the ante 180
17e1b126: posts the ante 180
3ed018f9: posts the ante 180
aa4e3dbf: posts the ante 180
Hero: posts the ante 180
bd8abd3: posts the ante 180
3ed018f9: posts small blind 600
4250e296: posts big blind 1,200
*** HOLE CARDS ***
Dealt to 4250e296 
Dealt to aa4e3dbf 
Dealt to a5661ff2 
Dealt to Hero [Ad 4c]
Dealt to 17e1b126 
Dealt to bd8abd3 
Dealt to 3ed018f9 
aa4e3dbf: folds
a5661ff2: folds
Hero: folds
17e1b126: folds
bd8abd3: folds
3ed018f9: calls 600
4250e296: checks
*** FLOP *** [6d 2c 8c]
3ed018f9: checks
4250e296: checks
*** TURN *** [6d 2c 8c] [4d]
3ed018f9: bets 1,830
4250e296: folds
Uncalled bet (1,830) returned to 3ed018f9
*** SHOWDOWN ***
3ed018f9 collected 3,660 from pot
*** SUMMARY ***
Total pot 3,660 | Rake 0 | Jackpot 0 | Bingo 0 | Fortune 0 | Tax 0
Board [6d 2c 8c 4d]
Seat 2: 4250e296 (big blind) folded on the Turn
Seat 3: aa4e3dbf folded before Flop
Seat 4: a5661ff2 folded before Flop
Seat 5: Hero folded before Flop
Seat 6: 17e1b126 folded before Flop
Seat 7: bd8abd3 (button) folded before Flop
Seat 8: 3ed018f9 (small blind) won (3,660)


Poker Hand #TM3449967165: Tournament #149964808, Bounty Hunters Special $1.08 Hold'em No Limit - Level14(600/1,200) - 2024/07/03 23:04:52
Table '8' 8-max Seat #6 is the button
Seat 1: a0d81f3c (14,670 in chips)
Seat 2: 4250e296 (36,112 in chips)
Seat 3: aa4e3dbf (16,853 in chips)
Seat 4: a5661ff2 (24,512 in chips)
Seat 5: Hero (79,772 in chips)
Seat 6: 17e1b126 (55,768 in chips)
Seat 7: bd8abd3 (56,641 in chips)
Seat 8: 3ed018f9 (196,561 in chips)
a5661ff2: posts the ante 180
4250e296: posts the ante 180
a0d81f3c: posts the ante 180
17e1b126: posts the ante 180
3ed018f9: posts the ante 180
aa4e3dbf: posts the ante 180
Hero: posts the ante 180
bd8abd3: posts the ante 180
bd8abd3: posts small blind 600
3ed018f9: posts big blind 1,200
*** HOLE CARDS ***
Dealt to a0d81f3c 
Dealt to 4250e296 
Dealt to aa4e3dbf 
Dealt to a5661ff2 
Dealt to Hero [Td Ks]
Dealt to 17e1b126 
Dealt to bd8abd3 
Dealt to 3ed018f9 
a0d81f3c: calls 1,200
4250e296: raises 2,400 to 3,600
aa4e3dbf: folds
a5661ff2: folds
Hero: folds
17e1b126: folds
bd8abd3: folds
3ed018f9: folds
a0d81f3c: calls 2,400
*** FLOP *** [3d 8d Jh]
a0d81f3c: bets 1,200
4250e296: calls 1,200
*** TURN *** [3d 8d Jh] [4d]
a0d81f3c: bets 1,200
4250e296: raises 29,932 to 31,132 and is all-in
a0d81f3c: calls 8,490 and is all-in
Uncalled bet (21,442) returned to 4250e296
4250e296: shows [Kd Ts] (King-High)
a0d81f3c: shows [4s Jc] (Pair of Jacks and Pair of Fours)
*** RIVER *** [3d 8d Jh 4d] [7d]
*** SHOWDOWN ***
4250e296 collected 32,220 from pot
*** SUMMARY ***
Total pot 32,220 | Rake 0 | Jackpot 0 | Bingo 0 | Fortune 0 | Tax 0
Board [3d 8d Jh 4d 7d]
Seat 1: a0d81f3c showed [4s Jc] and lost with Pair of Jacks and Pair of Fours
Seat 2: 4250e296 showed [Kd Ts] and won (32,220) with King High Flush
Seat 3: aa4e3dbf folded before Flop
Seat 4: a5661ff2 folded before Flop
Seat 5: Hero folded before Flop
Seat 6: 17e1b126 (button) folded before Flop
Seat 7: bd8abd3 (small blind) folded before Flop
Seat 8: 3ed018f9 (big blind) folded before Flop


Poker Hand #TM3449967138: Tournament #149964808, Bounty Hunters Special $1.08 Hold'em No Limit - Level14(600/1,200) - 2024/07/03 23:04:28
Table '8' 8-max Seat #5 is the button
Seat 1: a0d81f3c (14,850 in chips)
Seat 2: 4250e296 (36,292 in chips)
Seat 3: aa4e3dbf (17,033 in chips)
Seat 4: a5661ff2 (24,692 in chips)
Seat 5: Hero (79,952 in chips)
Seat 6: 17e1b126 (53,308 in chips)
Seat 7: bd8abd3 (58,021 in chips)
Seat 8: 3ed018f9 (196,741 in chips)
a5661ff2: posts the ante 180
4250e296: posts the ante 180
a0d81f3c: posts the ante 180
3ed018f9: posts the ante 180
17e1b126: posts the ante 180
aa4e3dbf: posts the ante 180
Hero: posts the ante 180
bd8abd3: posts the ante 180
17e1b126: posts small blind 600
bd8abd3: posts big blind 1,200
*** HOLE CARDS ***
Dealt to a0d81f3c 
Dealt to 4250e296 
Dealt to aa4e3dbf 
Dealt to a5661ff2 
Dealt to Hero [7c Ad]
Dealt to 17e1b126 
Dealt to bd8abd3 
Dealt to 3ed018f9 
3ed018f9: folds
a0d81f3c: folds
4250e296: folds
aa4e3dbf: folds
a5661ff2: folds
Hero: folds
17e1b126: raises 1,200 to 2,400
bd8abd3: folds
Uncalled bet (1,200) returned to 17e1b126
*** SHOWDOWN ***
17e1b126 collected 3,840 from pot
*** SUMMARY ***
Total pot 3,840 | Rake 0 | Jackpot 0 | Bingo 0 | Fortune 0 | Tax 0
Seat 1: a0d81f3c folded before Flop
Seat 2: 4250e296 folded before Flop
Seat 3: aa4e3dbf folded before Flop
Seat 4: a5661ff2 folded before Flop
Seat 5: Hero (button) folded before Flop
Seat 6: 17e1b126 (small blind) collected (3,840)
Seat 7: bd8abd3 (big blind) folded before Flop
Seat 8: 3ed018f9 folded before Flop


Poker Hand #TM3449967060: Tournament #149964808, Bounty Hunters Special $1.08 Hold'em No Limit - Level14(600/1,200) - 2024/07/03 23:03:12
Table '8' 8-max Seat #4 is the button
Seat 1: a0d81f3c (16,230 in chips)
Seat 2: 4250e296 (36,472 in chips)
Seat 3: aa4e3dbf (17,213 in chips)
Seat 4: a5661ff2 (24,872 in chips)
Seat 5: Hero (82,996 in chips)
Seat 6: 17e1b126 (47,984 in chips)
Seat 7: bd8abd3 (58,201 in chips)
Seat 8: 3ed018f9 (196,921 in chips)
a5661ff2: posts the ante 180
4250e296: posts the ante 180
a0d81f3c: posts the ante 180
3ed018f9: posts the ante 180
17e1b126: posts the ante 180
aa4e3dbf: posts the ante 180
Hero: posts the ante 180
bd8abd3: posts the ante 180
Hero: posts small blind 600
17e1b126: posts big blind 1,200
*** HOLE CARDS ***
Dealt to a0d81f3c 
Dealt to 4250e296 
Dealt to aa4e3dbf 
Dealt to a5661ff2 
Dealt to Hero [Ks 9d]
Dealt to 17e1b126 
Dealt to bd8abd3 
Dealt to 3ed018f9 
bd8abd3: folds
3ed018f9: folds
a0d81f3c: calls 1,200
4250e296: folds
aa4e3dbf: folds
a5661ff2: folds
Hero: calls 600
17e1b126: checks
*** FLOP *** [4h 3h 4c]
Hero: bets 1,664
17e1b126: calls 1,664
a0d81f3c: folds
*** TURN *** [4h 3h 4c] [Qh]
Hero: checks
17e1b126: checks
*** RIVER *** [4h 3h 4c Qh] [8h]
Hero: checks
17e1b126: checks
Hero: shows [Ks 9d] (Pair of Fours)
17e1b126: shows [Kc 3d] (Pair of Fours and Pair of Treys)
*** SHOWDOWN ***
17e1b126 collected 8,368 from pot
*** SUMMARY ***
Total pot 8,368 | Rake 0 | Jackpot 0 | Bingo 0 | Fortune 0 | Tax 0
Board [4h 3h 4c Qh 8h]
Seat 1: a0d81f3c folded on the Flop
Seat 2: 4250e296 folded before Flop
Seat 3: aa4e3dbf folded before Flop
Seat 4: a5661ff2 (button) folded before Flop
Seat 5: Hero (small blind) showed [Ks 9d] and lost with Pair of Fours
Seat 6: 17e1b126 (big blind) showed [Kc 3d] and won (8,368) with Pair of Fours and Pair of Treys
Seat 7: bd8abd3 folded before Flop
Seat 8: 3ed018f9 folded before Flop


Poker Hand #TM3449966983: Tournament #149964808, Bounty Hunters Special $1.08 Hold'em No Limit - Level14(600/1,200) - 2024/07/03 23:01:47
Table '8' 8-max Seat #3 is the button
Seat 1: a0d81f3c (16,410 in chips)
Seat 2: 4250e296 (36,652 in chips)
Seat 3: aa4e3dbf (17,393 in chips)
Seat 4: a5661ff2 (65,830 in chips)
Seat 5: Hero (40,958 in chips)
Seat 6: 17e1b126 (48,164 in chips)
Seat 7: bd8abd3 (58,381 in chips)
Seat 8: 3ed018f9 (197,101 in chips)
a5661ff2: posts the ante 180
4250e296: posts the ante 180
a0d81f3c: posts the ante 180
3ed018f9: posts the ante 180
17e1b126: posts the ante 180
aa4e3dbf: posts the ante 180
Hero: posts the ante 180
bd8abd3: posts the ante 180
a5661ff2: posts small blind 600
Hero: posts big blind 1,200
*** HOLE CARDS ***
Dealt to a0d81f3c 
Dealt to 4250e296 
Dealt to aa4e3dbf 
Dealt to a5661ff2 
Dealt to Hero [Ah Qc]
Dealt to 17e1b126 
Dealt to bd8abd3 
Dealt to 3ed018f9 
17e1b126: folds
bd8abd3: folds
3ed018f9: folds
a0d81f3c: folds
4250e296: folds
aa4e3dbf: folds
a5661ff2: calls 600
Hero: raises 6,000 to 7,200
a5661ff2: raises 58,450 to 65,650 and is all-in
Hero: calls 33,578 and is all-in
Uncalled bet (24,872) returned to a5661ff2
a5661ff2: shows [4h 4c]
Hero: shows [Ah Qc]
*** FLOP *** [Tc Qd Td]
*** TURN *** [Tc Qd Td] [3d]
*** RIVER *** [Tc Qd Td 3d] [2h]
*** SHOWDOWN ***
Hero collected 82,996 from pot
*** SUMMARY ***
Total pot 82,996 | Rake 0 | Jackpot 0 | Bingo 0 | Fortune 0 | Tax 0
Board [Tc Qd Td 3d 2h]
Seat 1: a0d81f3c folded before Flop
Seat 2: 4250e296 folded before Flop
Seat 3: aa4e3dbf (button) folded before Flop
Seat 4: a5661ff2 (small blind) showed [4h 4c] and lost with Pair of Tens and Pair of Fours
Seat 5: Hero (big blind) showed [Ah Qc] and won (82,996) with Pair of Queens and Pair of Tens
Seat 6: 17e1b126 folded before Flop
Seat 7: bd8abd3 folded before Flop
Seat 8: 3ed018f9 folded before Flop


Poker Hand #TM3449966866: Tournament #149964808, Bounty Hunters Special $1.08 Hold'em No Limit - Level14(600/1,200) - 2024/07/03 22:53:58
Table '8' 8-max Seat #2 is the button
Seat 1: a0d81f3c (16,590 in chips)
Seat 2: 4250e296 (47,512 in chips)
Seat 3: aa4e3dbf (18,173 in chips)
Seat 4: a5661ff2 (53,290 in chips)
Seat 5: Hero (41,138 in chips)
Seat 6: 17e1b126 (48,344 in chips)
Seat 7: bd8abd3 (58,561 in chips)
Seat 8: 3ed018f9 (197,281 in chips)
a5661ff2: posts the ante 180
4250e296: posts the ante 180
a0d81f3c: posts the ante 180
3ed018f9: posts the ante 180
17e1b126: posts the ante 180
aa4e3dbf: posts the ante 180
Hero: posts the ante 180
bd8abd3: posts the ante 180
aa4e3dbf: posts small blind 600
a5661ff2: posts big blind 1,200
*** HOLE CARDS ***
Dealt to a0d81f3c 
Dealt to 4250e296 
Dealt to aa4e3dbf 
Dealt to a5661ff2 
Dealt to Hero [9s Tc]
Dealt to 17e1b126 
Dealt to bd8abd3 
Dealt to 3ed018f9 
Hero: folds
17e1b126: folds
bd8abd3: folds
3ed018f9: folds
a0d81f3c: folds
4250e296: raises 1,200 to 2,400
aa4e3dbf: folds
a5661ff2: calls 1,200
*** FLOP *** [8s Jh 7h]
a5661ff2: checks
4250e296: bets 2,258
a5661ff2: raises 6,022 to 8,280
4250e296: calls 6,022
*** TURN *** [8s Jh 7h] [4d]
a5661ff2: bets 17,550
4250e296: folds
Uncalled bet (17,550) returned to a5661ff2
*** SHOWDOWN ***
a5661ff2 collected 23,400 from pot
*** SUMMARY ***
Total pot 23,400 | Rake 0 | Jackpot 0 | Bingo 0 | Fortune 0 | Tax 0
Board [8s Jh 7h 4d]
Seat 1: a0d81f3c folded before Flop
Seat 2: 4250e296 (button) folded on the Turn
Seat 3: aa4e3dbf (small blind) folded before Flop
Seat 4: a5661ff2 (big blind) won (23,400)
Seat 5: Hero folded before Flop
Seat 6: 17e1b126 folded before Flop
Seat 7: bd8abd3 folded before Flop
Seat 8: 3ed018f9 folded before Flop


Poker Hand #TM3449966844: Tournament #149964808, Bounty Hunters Special $1.08 Hold'em No Limit - Level14(600/1,200) - 2024/07/03 22:53:35
Table '8' 8-max Seat #1 is the button
Seat 1: a0d81f3c (16,770 in chips)
Seat 2: 4250e296 (45,232 in chips)
Seat 3: aa4e3dbf (19,553 in chips)
Seat 4: a5661ff2 (53,470 in chips)
Seat 5: Hero (41,318 in chips)
Seat 7: bd8abd3 (58,741 in chips)
Seat 8: 3ed018f9 (197,461 in chips)
a5661ff2: posts the ante 180
a0d81f3c: posts the ante 180
4250e296: posts the ante 180
3ed018f9: posts the ante 180
aa4e3dbf: posts the ante 180
Hero: posts the ante 180
bd8abd3: posts the ante 180
4250e296: posts small blind 600
aa4e3dbf: posts big blind 1,200
*** HOLE CARDS ***
Dealt to a0d81f3c 
Dealt to 4250e296 
Dealt to aa4e3dbf 
Dealt to a5661ff2 
Dealt to Hero [Td 2d]
Dealt to bd8abd3 
Dealt to 3ed018f9 
a5661ff2: folds
Hero: folds
bd8abd3: folds
3ed018f9: folds
a0d81f3c: folds
4250e296: raises 43,852 to 45,052 and is all-in
aa4e3dbf: folds
Uncalled bet (43,852) returned to 4250e296
*** SHOWDOWN ***
4250e296 collected 3,660 from pot
*** SUMMARY ***
Total pot 3,660 | Rake 0 | Jackpot 0 | Bingo 0 | Fortune 0 | Tax 0
Seat 1: a0d81f3c (button) folded before Flop
Seat 2: 4250e296 (small blind) collected (3,660)
Seat 3: aa4e3dbf (big blind) folded before Flop
Seat 4: a5661ff2 folded before Flop
Seat 5: Hero folded before Flop
Seat 7: bd8abd3 folded before Flop
Seat 8: 3ed018f9 folded before Flop


Poker Hand #TM3449966811: Tournament #149964808, Bounty Hunters Special $1.08 Hold'em No Limit - Level14(600/1,200) - 2024/07/03 22:52:48
Table '8' 8-max Seat #8 is the button
Seat 1: a0d81f3c (19,350 in chips)
Seat 2: 4250e296 (46,612 in chips)
Seat 3: aa4e3dbf (19,733 in chips)
Seat 4: a5661ff2 (53,650 in chips)
Seat 5: Hero (36,638 in chips)
Seat 7: bd8abd3 (58,921 in chips)
Seat 8: 3ed018f9 (197,641 in chips)
a5661ff2: posts the ante 180
4250e296: posts the ante 180
a0d81f3c: posts the ante 180
3ed018f9: posts the ante 180
aa4e3dbf: posts the ante 180
Hero: posts the ante 180
bd8abd3: posts the ante 180
a0d81f3c: posts small blind 600
4250e296: posts big blind 1,200
*** HOLE CARDS ***
Dealt to a0d81f3c 
Dealt to 4250e296 
Dealt to aa4e3dbf 
Dealt to a5661ff2 
Dealt to Hero [Qh As]
Dealt to bd8abd3 
Dealt to 3ed018f9 
aa4e3dbf: folds
a5661ff2: folds
Hero: raises 1,200 to 2,400
bd8abd3: folds
3ed018f9: folds
a0d81f3c: calls 1,800
4250e296: folds
*** FLOP *** [7h Ac 6s]
a0d81f3c: checks
Hero: bets 1,200
a0d81f3c: folds
Uncalled bet (1,200) returned to Hero
*** SHOWDOWN ***
Hero collected 7,260 from pot
*** SUMMARY ***
Total pot 7,260 | Rake 0 | Jackpot 0 | Bingo 0 | Fortune 0 | Tax 0
Board [7h Ac 6s]
Seat 1: a0d81f3c (small blind) folded on the Flop
Seat 2: 4250e296 (big blind) folded before Flop
Seat 3: aa4e3dbf folded before Flop
Seat 4: a5661ff2 folded before Flop
Seat 5: Hero won (7,260)
Seat 7: bd8abd3 folded before Flop
Seat 8: 3ed018f9 (button) folded before Flop


Poker Hand #TM3449966772: Tournament #149964808, Bounty Hunters Special $1.08 Hold'em No Limit - Level13(500/1,000) - 2024/07/03 22:52:01
Table '8' 8-max Seat #7 is the button
Seat 1: a0d81f3c (24,550 in chips)
Seat 2: 4250e296 (46,762 in chips)
Seat 3: aa4e3dbf (12,783 in chips)
Seat 4: a5661ff2 (53,800 in chips)
Seat 5: Hero (36,788 in chips)
Seat 7: bd8abd3 (59,071 in chips)
Seat 8: 3ed018f9 (198,791 in chips)
a5661ff2: posts the ante 150
4250e296: posts the ante 150
a0d81f3c: posts the ante 150
3ed018f9: posts the ante 150
aa4e3dbf: posts the ante 150
Hero: posts the ante 150
bd8abd3: posts the ante 150
3ed018f9: posts small blind 500
a0d81f3c: posts big blind 1,000
*** HOLE CARDS ***
Dealt to a0d81f3c 
Dealt to 4250e296 
Dealt to aa4e3dbf 
Dealt to a5661ff2 
Dealt to Hero [2s 7s]
Dealt to bd8abd3 
Dealt to 3ed018f9 
4250e296: folds
aa4e3dbf: calls 1,000
a5661ff2: folds
Hero: folds
bd8abd3: folds
3ed018f9: calls 500
a0d81f3c: checks
*** FLOP *** [9d 3d 6c]
3ed018f9: checks
a0d81f3c: checks
aa4e3dbf: bets 4,050
3ed018f9: folds
a0d81f3c: calls 4,050
*** TURN *** [9d 3d 6c] [Qs]
a0d81f3c: checks
aa4e3dbf: bets 7,583 and is all-in
a0d81f3c: folds
Uncalled bet (7,583) returned to aa4e3dbf
*** SHOWDOWN ***
aa4e3dbf collected 12,150 from pot
*** SUMMARY ***
Total pot 12,150 | Rake 0 | Jackpot 0 | Bingo 0 | Fortune 0 | Tax 0
Board [9d 3d 6c Qs]
Seat 1: a0d81f3c (big blind) folded on the Turn
Seat 2: 4250e296 folded before Flop
Seat 3: aa4e3dbf won (12,150)
Seat 4: a5661ff2 folded before Flop
Seat 5: Hero folded before Flop
Seat 7: bd8abd3 (button) folded before Flop
Seat 8: 3ed018f9 (small blind) folded on the Flop


Poker Hand #TM3449966716: Tournament #149964808, Bounty Hunters Special $1.08 Hold'em No Limit - Level13(500/1,000) - 2024/07/03 22:50:48
Table '8' 8-max Seat #6 is the button
Seat 1: a0d81f3c (25,700 in chips)
Seat 2: 4250e296 (46,912 in chips)
Seat 3: aa4e3dbf (12,933 in chips)
Seat 4: a5661ff2 (57,300 in chips)
Seat 5: Hero (36,938 in chips)
Seat 6: 8e5de257 (31,010 in chips)
Seat 7: bd8abd3 (59,721 in chips)
Seat 8: 3ed018f9 (162,031 in chips)
8e5de257: posts the ante 150
a5661ff2: posts the ante 150
4250e296: posts the ante 150
a0d81f3c: posts the ante 150
3ed018f9: posts the ante 150
aa4e3dbf: posts the ante 150
Hero: posts the ante 150
bd8abd3: posts the ante 150
bd8abd3: posts small blind 500
3ed018f9: posts big blind 1,000
*** HOLE CARDS ***
Dealt to a0d81f3c 
Dealt to 4250e296 
Dealt to aa4e3dbf 
Dealt to a5661ff2 
Dealt to Hero [2h 3c]
Dealt to 8e5de257 
Dealt to bd8abd3 
Dealt to 3ed018f9 
a0d81f3c: calls 1,000
4250e296: folds
aa4e3dbf: folds
a5661ff2: raises 2,350 to 3,350
Hero: folds
8e5de257: raises 27,510 to 30,860 and is all-in
bd8abd3: folds
3ed018f9: calls 29,860
a0d81f3c: folds
a5661ff2: folds
8e5de257: shows [Ad Qh]
3ed018f9: shows [Ac 6c]
*** FLOP *** [9h 9c 6h]
*** TURN *** [9h 9c 6h] [2s]
*** RIVER *** [9h 9c 6h 2s] [7h]
aa4e3dbf: shows [9s] (Three Nines)
*** SHOWDOWN ***
3ed018f9 collected 67,770 from pot
*** SUMMARY ***
Total pot 67,770 | Rake 0 | Jackpot 0 | Bingo 0 | Fortune 0 | Tax 0
Board [9h 9c 6h 2s 7h]
Seat 1: a0d81f3c folded before Flop
Seat 2: 4250e296 folded before Flop
Seat 3: aa4e3dbf folded before Flop
Seat 4: a5661ff2 folded before Flop
Seat 5: Hero folded before Flop
Seat 6: 8e5de257 (button) showed [Ad Qh] and lost with Pair of Nines
Seat 7: bd8abd3 (small blind) folded before Flop
Seat 8: 3ed018f9 (big blind) showed [Ac 6c] and won (67,770) with Pair of Nines and Pair of Sixes


Poker Hand #TM3449966680: Tournament #149964808, Bounty Hunters Special $1.08 Hold'em No Limit - Level13(500/1,000) - 2024/07/03 22:50:03
Table '8' 8-max Seat #5 is the button
Seat 1: a0d81f3c (20,150 in chips)
Seat 2: 4250e296 (47,062 in chips)
Seat 3: aa4e3dbf (13,083 in chips)
Seat 4: a5661ff2 (57,450 in chips)
Seat 5: Hero (37,088 in chips)
Seat 6: 8e5de257 (31,660 in chips)
Seat 7: bd8abd3 (60,871 in chips)
Seat 8: 3ed018f9 (165,181 in chips)
8e5de257: posts the ante 150
a5661ff2: posts the ante 150
4250e296: posts the ante 150
a0d81f3c: posts the ante 150
3ed018f9: posts the ante 150
aa4e3dbf: posts the ante 150
Hero: posts the ante 150
bd8abd3: posts the ante 150
8e5de257: posts small blind 500
bd8abd3: posts big blind 1,000
*** HOLE CARDS ***
Dealt to a0d81f3c 
Dealt to 4250e296 
Dealt to aa4e3dbf 
Dealt to a5661ff2 
Dealt to Hero [As 6h]
Dealt to 8e5de257 
Dealt to bd8abd3 
Dealt to 3ed018f9 
3ed018f9: raises 1,000 to 2,000
a0d81f3c: calls 2,000
4250e296: folds
aa4e3dbf: folds
a5661ff2: folds
Hero: folds
8e5de257: folds
bd8abd3: folds
*** FLOP *** [8h 2h 3d]
3ed018f9: checks
a0d81f3c: checks
*** TURN *** [8h 2h 3d] [5h]
3ed018f9: checks
a0d81f3c: bets 1,000
3ed018f9: calls 1,000
*** RIVER *** [8h 2h 3d 5h] [Ad]
3ed018f9: checks
a0d81f3c: bets 1,000
3ed018f9: folds
Uncalled bet (1,000) returned to a0d81f3c
*** SHOWDOWN ***
a0d81f3c collected 8,700 from pot
*** SUMMARY ***
Total pot 8,700 | Rake 0 | Jackpot 0 | Bingo 0 | Fortune 0 | Tax 0
Board [8h 2h 3d 5h Ad]
Seat 1: a0d81f3c won (8,700)
Seat 2: 4250e296 folded before Flop
Seat 3: aa4e3dbf folded before Flop
Seat 4: a5661ff2 folded before Flop
Seat 5: Hero (button) folded before Flop
Seat 6: 8e5de257 (small blind) folded before Flop
Seat 7: bd8abd3 (big blind) folded before Flop
Seat 8: 3ed018f9 folded on the River


Poker Hand #TM3449966631: Tournament #149964808, Bounty Hunters Special $1.08 Hold'em No Limit - Level13(500/1,000) - 2024/07/03 22:49:01
Table '8' 8-max Seat #4 is the button
Seat 1: a0d81f3c (20,300 in chips)
Seat 2: 4250e296 (40,301 in chips)
Seat 3: aa4e3dbf (17,444 in chips)
Seat 4: a5661ff2 (57,600 in chips)
Seat 5: Hero (37,738 in chips)
Seat 6: 8e5de257 (32,810 in chips)
Seat 7: bd8abd3 (61,021 in chips)
Seat 8: 3ed018f9 (165,331 in chips)
8e5de257: posts the ante 150
a5661ff2: posts the ante 150
4250e296: posts the ante 150
a0d81f3c: posts the ante 150
3ed018f9: posts the ante 150
aa4e3dbf: posts the ante 150
Hero: posts the ante 150
bd8abd3: posts the ante 150
Hero: posts small blind 500
8e5de257: posts big blind 1,000
*** HOLE CARDS ***
Dealt to a0d81f3c 
Dealt to 4250e296 
Dealt to aa4e3dbf 
Dealt to a5661ff2 
Dealt to Hero [3c Jd]
Dealt to 8e5de257 
Dealt to bd8abd3 
Dealt to 3ed018f9 
bd8abd3: folds
3ed018f9: folds
a0d81f3c: folds
4250e296: raises 1,000 to 2,000
aa4e3dbf: calls 2,000
a5661ff2: folds
Hero: folds
8e5de257: folds
*** FLOP *** [7c Th Ks]
4250e296: checks
aa4e3dbf: bets 2,211
4250e296: calls 2,211
*** TURN *** [7c Th Ks] [3h]
4250e296: checks
aa4e3dbf: checks
*** RIVER *** [7c Th Ks 3h] [8s]
4250e296: bets 35,940 and is all-in
aa4e3dbf: folds
Uncalled bet (35,940) returned to 4250e296
*** SHOWDOWN ***
4250e296 collected 11,122 from pot
*** SUMMARY ***
Total pot 11,122 | Rake 0 | Jackpot 0 | Bingo 0 | Fortune 0 | Tax 0
Board [7c Th Ks 3h 8s]
Seat 1: a0d81f3c folded before Flop
Seat 2: 4250e296 won (11,122)
Seat 3: aa4e3dbf folded on the River
Seat 4: a5661ff2 (button) folded before Flop
Seat 5: Hero (small blind) folded before Flop
Seat 6: 8e5de257 (big blind) folded before Flop
Seat 7: bd8abd3 folded before Flop
Seat 8: 3ed018f9 folded before Flop


Poker Hand #TM3449966592: Tournament #149964808, Bounty Hunters Special $1.08 Hold'em No Limit - Level13(500/1,000) - 2024/07/03 22:48:15
Table '8' 8-max Seat #3 is the button
Seat 1: a0d81f3c (21,450 in chips)
Seat 2: 4250e296 (40,451 in chips)
Seat 3: aa4e3dbf (11,894 in chips)
Seat 4: a5661ff2 (58,250 in chips)
Seat 5: Hero (38,888 in chips)
Seat 6: 8e5de257 (33,960 in chips)
Seat 7: bd8abd3 (61,171 in chips)
Seat 8: 3ed018f9 (166,481 in chips)
8e5de257: posts the ante 150
a5661ff2: posts the ante 150
4250e296: posts the ante 150
a0d81f3c: posts the ante 150
3ed018f9: posts the ante 150
aa4e3dbf: posts the ante 150
Hero: posts the ante 150
bd8abd3: posts the ante 150
a5661ff2: posts small blind 500
Hero: posts big blind 1,000
*** HOLE CARDS ***
Dealt to a0d81f3c 
Dealt to 4250e296 
Dealt to aa4e3dbf 
Dealt to a5661ff2 
Dealt to Hero [Qc Ts]
Dealt to 8e5de257 
Dealt to bd8abd3 
Dealt to 3ed018f9 
8e5de257: calls 1,000
bd8abd3: folds
3ed018f9: calls 1,000
a0d81f3c: calls 1,000
4250e296: folds
aa4e3dbf: raises 10,744 to 11,744 and is all-in
a5661ff2: folds
Hero: folds
8e5de257: folds
3ed018f9: folds
a0d81f3c: folds
Uncalled bet (10,744) returned to aa4e3dbf
*** SHOWDOWN ***
aa4e3dbf collected 6,700 from pot
*** SUMMARY ***
Total pot 6,700 | Rake 0 | Jackpot 0 | Bingo 0 | Fortune 0 | Tax 0
Seat 1: a0d81f3c folded before Flop
Seat 2: 4250e296 folded before Flop
Seat 3: aa4e3dbf (button) collected (6,700)
Seat 4: a5661ff2 (small blind) folded before Flop
Seat 5: Hero (big blind) folded before Flop
Seat 6: 8e5de257 folded before Flop
Seat 7: bd8abd3 folded before Flop
Seat 8: 3ed018f9 folded before Flop


Poker Hand #TM3449966556: Tournament #149964808, Bounty Hunters Special $1.08 Hold'em No Limit - Level13(500/1,000) - 2024/07/03 22:47:27
Table '8' 8-max Seat #2 is the button
Seat 1: a0d81f3c (15,900 in chips)
Seat 2: 4250e296 (40,601 in chips)
Seat 3: aa4e3dbf (12,544 in chips)
Seat 4: a5661ff2 (59,400 in chips)
Seat 5: Hero (39,038 in chips)
Seat 6: 8e5de257 (37,110 in chips)
Seat 7: bd8abd3 (61,321 in chips)
Seat 8: 3ed018f9 (166,631 in chips)
8e5de257: posts the ante 150
a5661ff2: posts the ante 150
4250e296: posts the ante 150
a0d81f3c: posts the ante 150
3ed018f9: posts the ante 150
aa4e3dbf: posts the ante 150
Hero: posts the ante 150
bd8abd3: posts the ante 150
aa4e3dbf: posts small blind 500
a5661ff2: posts big blind 1,000
*** HOLE CARDS ***
Dealt to a0d81f3c 
Dealt to 4250e296 
Dealt to aa4e3dbf 
Dealt to a5661ff2 
Dealt to Hero [5s 4d]
Dealt to 8e5de257 
Dealt to bd8abd3 
Dealt to 3ed018f9 
Hero: folds
8e5de257: calls 1,000
bd8abd3: folds
3ed018f9: folds
a0d81f3c: calls 1,000
4250e296: folds
aa4e3dbf: folds
a5661ff2: checks
*** FLOP *** [7s 7c 6s]
a5661ff2: checks
8e5de257: checks
a0d81f3c: bets 1,000
a5661ff2: folds
8e5de257: calls 1,000
*** TURN *** [7s 7c 6s] [Kc]
8e5de257: checks
a0d81f3c: bets 1,000
8e5de257: calls 1,000
*** RIVER *** [7s 7c 6s Kc] [Js]
8e5de257: checks
a0d81f3c: bets 1,000
8e5de257: folds
Uncalled bet (1,000) returned to a0d81f3c
*** SHOWDOWN ***
a0d81f3c collected 8,700 from pot
*** SUMMARY ***
Total pot 8,700 | Rake 0 | Jackpot 0 | Bingo 0 | Fortune 0 | Tax 0
Board [7s 7c 6s Kc Js]
Seat 1: a0d81f3c won (8,700)
Seat 2: 4250e296 (button) folded before Flop
Seat 3: aa4e3dbf (small blind) folded before Flop
Seat 4: a5661ff2 (big blind) folded on the Flop
Seat 5: Hero folded before Flop
Seat 6: 8e5de257 folded on the River
Seat 7: bd8abd3 folded before Flop
Seat 8: 3ed018f9 folded before Flop


Poker Hand #TM3449966517: Tournament #149964808, Bounty Hunters Special $1.08 Hold'em No Limit - Level13(500/1,000) - 2024/07/03 22:46:43
Table '8' 8-max Seat #1 is the button
Seat 1: a0d81f3c (20,050 in chips)
Seat 2: 4250e296 (41,251 in chips)
Seat 3: aa4e3dbf (13,694 in chips)
Seat 4: a5661ff2 (59,550 in chips)
Seat 5: Hero (39,188 in chips)
Seat 6: 8e5de257 (30,560 in chips)
Seat 7: bd8abd3 (61,471 in chips)
Seat 8: 3ed018f9 (166,781 in chips)
8e5de257: posts the ante 150
a5661ff2: posts the ante 150
a0d81f3c: posts the ante 150
4250e296: posts the ante 150
3ed018f9: posts the ante 150
aa4e3dbf: posts the ante 150
Hero: posts the ante 150
bd8abd3: posts the ante 150
4250e296: posts small blind 500
aa4e3dbf: posts big blind 1,000
*** HOLE CARDS ***
Dealt to a0d81f3c 
Dealt to 4250e296 
Dealt to aa4e3dbf 
Dealt to a5661ff2 
Dealt to Hero [5s Jc]
Dealt to 8e5de257 
Dealt to bd8abd3 
Dealt to 3ed018f9 
a5661ff2: folds
Hero: folds
8e5de257: raises 3,000 to 4,000
bd8abd3: folds
3ed018f9: folds
a0d81f3c: calls 4,000
4250e296: folds
aa4e3dbf: folds
*** FLOP *** [Th 7c 2d]
8e5de257: bets 26,410 and is all-in
a0d81f3c: folds
Uncalled bet (26,410) returned to 8e5de257
*** SHOWDOWN ***
8e5de257 collected 10,700 from pot
*** SUMMARY ***
Total pot 10,700 | Rake 0 | Jackpot 0 | Bingo 0 | Fortune 0 | Tax 0
Board [Th 7c 2d]
Seat 1: a0d81f3c (button) folded on the Flop
Seat 2: 4250e296 (small blind) folded before Flop
Seat 3: aa4e3dbf (big blind) folded before Flop
Seat 4: a5661ff2 folded before Flop
Seat 5: Hero folded before Flop
Seat 6: 8e5de257 won (10,700)
Seat 7: bd8abd3 folded before Flop
Seat 8: 3ed018f9 folded before Flop


Poker Hand #TM3449966466: Tournament #149964808, Bounty Hunters Special $1.08 Hold'em No Limit - Level13(500/1,000) - 2024/07/03 22:45:46
Table '8' 8-max Seat #8 is the button
Seat 1: a0d81f3c (21,200 in chips)
Seat 2: 4250e296 (42,401 in chips)
Seat 3: aa4e3dbf (13,844 in chips)
Seat 4: a5661ff2 (59,700 in chips)
Seat 5: Hero (39,338 in chips)
Seat 7: bd8abd3 (61,621 in chips)
Seat 8: 3ed018f9 (163,881 in chips)
a5661ff2: posts the ante 150
4250e296: posts the ante 150
a0d81f3c: posts the ante 150
3ed018f9: posts the ante 150
aa4e3dbf: posts the ante 150
Hero: posts the ante 150
bd8abd3: posts the ante 150
a0d81f3c: posts small blind 500
4250e296: posts big blind 1,000
*** HOLE CARDS ***
Dealt to a0d81f3c 
Dealt to 4250e296 
Dealt to aa4e3dbf 
Dealt to a5661ff2 
Dealt to Hero [Ac 2h]
Dealt to bd8abd3 
Dealt to 3ed018f9 
aa4e3dbf: folds
a5661ff2: folds
Hero: folds
bd8abd3: folds
3ed018f9: calls 1,000
a0d81f3c: calls 500
4250e296: checks
*** FLOP *** [7h 8d Jd]
a0d81f3c: checks
4250e296: checks
3ed018f9: checks
*** TURN *** [7h 8d Jd] [Qd]
a0d81f3c: checks
4250e296: checks
3ed018f9: bets 2,025
a0d81f3c: folds
4250e296: folds
Uncalled bet (2,025) returned to 3ed018f9
*** SHOWDOWN ***
3ed018f9 collected 4,050 from pot
*** SUMMARY ***
Total pot 4,050 | Rake 0 | Jackpot 0 | Bingo 0 | Fortune 0 | Tax 0
Board [7h 8d Jd Qd]
Seat 1: a0d81f3c (small blind) folded on the Turn
Seat 2: 4250e296 (big blind) folded on the Turn
Seat 3: aa4e3dbf folded before Flop
Seat 4: a5661ff2 folded before Flop
Seat 5: Hero folded before Flop
Seat 7: bd8abd3 folded before Flop
Seat 8: 3ed018f9 (button) won (4,050)


Poker Hand #TM3449966410: Tournament #149964808, Bounty Hunters Special $1.08 Hold'em No Limit - Level12(400/800) - 2024/07/03 22:44:36
Table '8' 8-max Seat #7 is the button
Seat 1: a0d81f3c (22,120 in chips)
Seat 2: 4250e296 (42,521 in chips)
Seat 3: aa4e3dbf (13,964 in chips)
Seat 4: a5661ff2 (25,385 in chips)
Seat 5: Hero (41,058 in chips)
Seat 6: 3a31f62d (5,930 in chips)
Seat 7: bd8abd3 (61,741 in chips)
Seat 8: 3ed018f9 (189,266 in chips)
3a31f62d: posts the ante 120
a5661ff2: posts the ante 120
4250e296: posts the ante 120
a0d81f3c: posts the ante 120
3ed018f9: posts the ante 120
aa4e3dbf: posts the ante 120
Hero: posts the ante 120
bd8abd3: posts the ante 120
3ed018f9: posts small blind 400
a0d81f3c: posts big blind 800
*** HOLE CARDS ***
Dealt to a0d81f3c 
Dealt to 4250e296 
Dealt to aa4e3dbf 
Dealt to a5661ff2 
Dealt to Hero [9h Kc]
Dealt to 3a31f62d 
Dealt to bd8abd3 
Dealt to 3ed018f9 
4250e296: folds
aa4e3dbf: folds
a5661ff2: raises 800 to 1,600
Hero: calls 1,600
3a31f62d: raises 4,210 to 5,810 and is all-in
bd8abd3: folds
3ed018f9: calls 5,410
a0d81f3c: folds
a5661ff2: raises 19,455 to 25,265 and is all-in
Hero: folds
3ed018f9: calls 19,455
a5661ff2: shows [Kh As]
3a31f62d: shows [3c Ah]
3ed018f9: shows [7c Qc]
*** FLOP *** [Ts 2c 4d]
*** TURN *** [Ts 2c 4d] [8c]
*** RIVER *** [Ts 2c 4d 8c] [Ad]
*** SHOWDOWN ***
a5661ff2 collected 20,790 from pot
a5661ff2 collected 38,910 from pot
*** SUMMARY ***
Total pot 59,700 | Rake 0 | Jackpot 0 | Bingo 0 | Fortune 0 | Tax 0
Board [Ts 2c 4d 8c Ad]
Seat 1: a0d81f3c (big blind) folded before Flop
Seat 2: 4250e296 folded before Flop
Seat 3: aa4e3dbf folded before Flop
Seat 4: a5661ff2 showed [Kh As] and won (59,700) with Pair of Aces
Seat 5: Hero folded before Flop
Seat 6: 3a31f62d showed [3c Ah] and lost with Pair of Aces
Seat 7: bd8abd3 (button) folded before Flop
Seat 8: 3ed018f9 (small blind) showed [7c Qc] and lost with Ace-High


Poker Hand #TM3449966374: Tournament #149964808, Bounty Hunters Special $1.08 Hold'em No Limit - Level12(400/800) - 2024/07/03 22:43:39
Table '8' 8-max Seat #6 is the button
Seat 1: a0d81f3c (23,040 in chips)
Seat 2: 4250e296 (42,641 in chips)
Seat 3: aa4e3dbf (24,524 in chips)
Seat 4: a5661ff2 (7,595 in chips)
Seat 5: Hero (41,178 in chips)
Seat 6: 3a31f62d (10,560 in chips)
Seat 7: bd8abd3 (62,261 in chips)
Seat 8: 3ed018f9 (190,186 in chips)
3a31f62d: posts the ante 120
a5661ff2: posts the ante 120
4250e296: posts the ante 120
a0d81f3c: posts the ante 120
3ed018f9: posts the ante 120
aa4e3dbf: posts the ante 120
Hero: posts the ante 120
bd8abd3: posts the ante 120
bd8abd3: posts small blind 400
3ed018f9: posts big blind 800
*** HOLE CARDS ***
Dealt to a0d81f3c 
Dealt to 4250e296 
Dealt to aa4e3dbf 
Dealt to a5661ff2 
Dealt to Hero [2s Jc]
Dealt to 3a31f62d 
Dealt to bd8abd3 
Dealt to 3ed018f9 
a0d81f3c: calls 800
4250e296: folds
aa4e3dbf: raises 800 to 1,600
a5661ff2: raises 5,875 to 7,475 and is all-in
Hero: folds
3a31f62d: raises 2,965 to 10,440 and is all-in
bd8abd3: folds
3ed018f9: folds
a0d81f3c: folds
aa4e3dbf: calls 8,840
3a31f62d: shows [As 6s]
aa4e3dbf: shows [8c 9d]
a5661ff2: shows [Ks Ac]
*** FLOP *** [Qc Js 2d]
*** TURN *** [Qc Js 2d] [Kd]
*** RIVER *** [Qc Js 2d Kd] [7c]
*** SHOWDOWN ***
a5661ff2 collected 25,385 from pot
3a31f62d collected 5,930 from pot
*** SUMMARY ***
Total pot 31,315 | Rake 0 | Jackpot 0 | Bingo 0 | Fortune 0 | Tax 0
Board [Qc Js 2d Kd 7c]
Seat 1: a0d81f3c folded before Flop
Seat 2: 4250e296 folded before Flop
Seat 3: aa4e3dbf showed [8c 9d] and lost with King-High
Seat 4: a5661ff2 showed [Ks Ac] and won (25,385) with Pair of Kings
Seat 5: Hero folded before Flop
Seat 6: 3a31f62d (button) showed [As 6s] and won (5,930) with Ace-High
Seat 7: bd8abd3 (small blind) folded before Flop
Seat 8: 3ed018f9 (big blind) folded before Flop


Poker Hand #TM3449966359: Tournament #149964808, Bounty Hunters Special $1.08 Hold'em No Limit - Level12(400/800) - 2024/07/03 22:43:23
Table '8' 8-max Seat #5 is the button
Seat 1: a0d81f3c (23,160 in chips)
Seat 2: 4250e296 (42,761 in chips)
Seat 3: aa4e3dbf (24,644 in chips)
Seat 4: a5661ff2 (7,715 in chips)
Seat 5: Hero (41,298 in chips)
Seat 6: 3a31f62d (11,080 in chips)
Seat 7: bd8abd3 (63,181 in chips)
Seat 8: 3ed018f9 (188,146 in chips)
3a31f62d: posts the ante 120
a5661ff2: posts the ante 120
4250e296: posts the ante 120
a0d81f3c: posts the ante 120
3ed018f9: posts the ante 120
aa4e3dbf: posts the ante 120
Hero: posts the ante 120
bd8abd3: posts the ante 120
3a31f62d: posts small blind 400
bd8abd3: posts big blind 800
*** HOLE CARDS ***
Dealt to a0d81f3c 
Dealt to 4250e296 
Dealt to aa4e3dbf 
Dealt to a5661ff2 
Dealt to Hero [5c Jd]
Dealt to 3a31f62d 
Dealt to bd8abd3 
Dealt to 3ed018f9 
3ed018f9: raises 800 to 1,600
a0d81f3c: folds
4250e296: folds
aa4e3dbf: folds
a5661ff2: folds
Hero: folds
3a31f62d: folds
bd8abd3: folds
Uncalled bet (800) returned to 3ed018f9
*** SHOWDOWN ***
3ed018f9 collected 2,960 from pot
*** SUMMARY ***
Total pot 2,960 | Rake 0 | Jackpot 0 | Bingo 0 | Fortune 0 | Tax 0
Seat 1: a0d81f3c folded before Flop
Seat 2: 4250e296 folded before Flop
Seat 3: aa4e3dbf folded before Flop
Seat 4: a5661ff2 folded before Flop
Seat 5: Hero (button) folded before Flop
Seat 6: 3a31f62d (small blind) folded before Flop
Seat 7: bd8abd3 (big blind) folded before Flop
Seat 8: 3ed018f9 collected (2,960)


Poker Hand #TM3449966320: Tournament #149964808, Bounty Hunters Special $1.08 Hold'em No Limit - Level12(400/800) - 2024/07/03 22:42:30
Table '8' 8-max Seat #4 is the button
Seat 1: a0d81f3c (23,280 in chips)
Seat 2: 4250e296 (42,881 in chips)
Seat 3: aa4e3dbf (24,764 in chips)
Seat 4: a5661ff2 (7,835 in chips)
Seat 5: Hero (41,818 in chips)
Seat 6: 3a31f62d (25,920 in chips)
Seat 7: bd8abd3 (63,301 in chips)
Seat 8: 3ed018f9 (172,186 in chips)
3a31f62d: posts the ante 120
a5661ff2: posts the ante 120
4250e296: posts the ante 120
a0d81f3c: posts the ante 120
3ed018f9: posts the ante 120
aa4e3dbf: posts the ante 120
Hero: posts the ante 120
bd8abd3: posts the ante 120
Hero: posts small blind 400
3a31f62d: posts big blind 800
*** HOLE CARDS ***
Dealt to a0d81f3c 
Dealt to 4250e296 
Dealt to aa4e3dbf 
Dealt to a5661ff2 
Dealt to Hero [6s Kh]
Dealt to 3a31f62d 
Dealt to bd8abd3 
Dealt to 3ed018f9 
bd8abd3: folds
3ed018f9: raises 1,600 to 2,400
a0d81f3c: folds
4250e296: folds
aa4e3dbf: folds
a5661ff2: folds
Hero: folds
3a31f62d: calls 1,600
*** FLOP *** [4s Ad Jc]
3a31f62d: checks
3ed018f9: bets 3,080
3a31f62d: calls 3,080
*** TURN *** [4s Ad Jc] [5s]
3a31f62d: checks
3ed018f9: checks
*** RIVER *** [4s Ad Jc 5s] [9d]
3a31f62d: bets 9,240
3ed018f9: calls 9,240
3a31f62d: shows [Td Kc] (Ace-High)
3ed018f9: shows [Qh Qd] (Pair of Queens)
*** SHOWDOWN ***
3ed018f9 collected 30,800 from pot
*** SUMMARY ***
Total pot 30,800 | Rake 0 | Jackpot 0 | Bingo 0 | Fortune 0 | Tax 0
Board [4s Ad Jc 5s 9d]
Seat 1: a0d81f3c folded before Flop
Seat 2: 4250e296 folded before Flop
Seat 3: aa4e3dbf folded before Flop
Seat 4: a5661ff2 (button) folded before Flop
Seat 5: Hero (small blind) folded before Flop
Seat 6: 3a31f62d (big blind) showed [Td Kc] and lost with Ace-High
Seat 7: bd8abd3 folded before Flop
Seat 8: 3ed018f9 showed [Qh Qd] and won (30,800) with Pair of Queens


Poker Hand #TM3449966266: Tournament #149964808, Bounty Hunters Special $1.08 Hold'em No Limit - Level12(400/800) - 2024/07/03 22:41:08
Table '8' 8-max Seat #3 is the button
Seat 1: a0d81f3c (23,400 in chips)
Seat 2: 4250e296 (45,401 in chips)
Seat 3: aa4e3dbf (24,884 in chips)
Seat 4: a5661ff2 (8,355 in chips)
Seat 5: Hero (51,818 in chips)
Seat 6: 3a31f62d (10,000 in chips)
Seat 7: bd8abd3 (63,421 in chips)
Seat 8: 3ed018f9 (174,706 in chips)
3a31f62d: posts the ante 120
a5661ff2: posts the ante 120
4250e296: posts the ante 120
a0d81f3c: posts the ante 120
3ed018f9: posts the ante 120
aa4e3dbf: posts the ante 120
Hero: posts the ante 120
bd8abd3: posts the ante 120
a5661ff2: posts small blind 400
Hero: posts big blind 800
*** HOLE CARDS ***
Dealt to a0d81f3c 
Dealt to 4250e296 
Dealt to aa4e3dbf 
Dealt to a5661ff2 
Dealt to Hero [8d 8s]
Dealt to 3a31f62d 
Dealt to bd8abd3 
Dealt to 3ed018f9 
3a31f62d: raises 1,600 to 2,400
bd8abd3: folds
3ed018f9: calls 2,400
a0d81f3c: folds
4250e296: calls 2,400
aa4e3dbf: folds
a5661ff2: folds
Hero: raises 49,298 to 51,698 and is all-in
3a31f62d: calls 7,480 and is all-in
3ed018f9: folds
4250e296: folds
Uncalled bet (41,818) returned to Hero
Hero: shows [8d 8s]
3a31f62d: shows [Qs Ah]
*** FLOP *** [Td 6c 5c]
*** TURN *** [Td 6c 5c] [Ad]
*** RIVER *** [Td 6c 5c Ad] [Qd]
*** SHOWDOWN ***
3a31f62d collected 25,920 from pot
*** SUMMARY ***
Total pot 25,920 | Rake 0 | Jackpot 0 | Bingo 0 | Fortune 0 | Tax 0
Board [Td 6c 5c Ad Qd]
Seat 1: a0d81f3c folded before Flop
Seat 2: 4250e296 folded before Flop
Seat 3: aa4e3dbf (button) folded before Flop
Seat 4: a5661ff2 (small blind) folded before Flop
Seat 5: Hero (big blind) showed [8d 8s] and lost with Pair of Eights
Seat 6: 3a31f62d showed [Qs Ah] and won (25,920) with Pair of Aces and Pair of Queens
Seat 7: bd8abd3 folded before Flop
Seat 8: 3ed018f9 folded before Flop


Poker Hand #TM3449966226: Tournament #149964808, Bounty Hunters Special $1.08 Hold'em No Limit - Level12(400/800) - 2024/07/03 22:40:18
Table '8' 8-max Seat #2 is the button
Seat 1: a0d81f3c (10,000 in chips)
Seat 2: 4250e296 (55,401 in chips)
Seat 3: aa4e3dbf (25,404 in chips)
Seat 4: a5661ff2 (9,275 in chips)
Seat 5: Hero (51,938 in chips)
Seat 7: bd8abd3 (63,541 in chips)
Seat 8: 3ed018f9 (176,426 in chips)
a5661ff2: posts the ante 120
4250e296: posts the ante 120
a0d81f3c: posts the ante 120
3ed018f9: posts the ante 120
aa4e3dbf: posts the ante 120
Hero: posts the ante 120
bd8abd3: posts the ante 120
aa4e3dbf: posts small blind 400
a5661ff2: posts big blind 800
*** HOLE CARDS ***
Dealt to a0d81f3c 
Dealt to 4250e296 
Dealt to aa4e3dbf 
Dealt to a5661ff2 
Dealt to Hero [Tc 6h]
Dealt to bd8abd3 
Dealt to 3ed018f9 
Hero: folds
bd8abd3: folds
3ed018f9: raises 800 to 1,600
a0d81f3c: calls 1,600
4250e296: raises 53,681 to 55,281 and is all-in
aa4e3dbf: folds
a5661ff2: folds
3ed018f9: folds
a0d81f3c: calls 8,280 and is all-in
Uncalled bet (45,401) returned to 4250e296
4250e296: shows [Kd As]
a0d81f3c: shows [8d 7c]
*** FLOP *** [3h 7h 2h]
*** TURN *** [3h 7h 2h] [7d]
*** RIVER *** [3h 7h 2h 7d] [9d]
*** SHOWDOWN ***
a0d81f3c collected 23,400 from pot
*** SUMMARY ***
Total pot 23,400 | Rake 0 | Jackpot 0 | Bingo 0 | Fortune 0 | Tax 0
Board [3h 7h 2h 7d 9d]
Seat 1: a0d81f3c showed [8d 7c] and won (23,400) with Three Sevens
Seat 2: 4250e296 (button) showed [Kd As] and lost with Pair of Sevens
Seat 3: aa4e3dbf (small blind) folded before Flop
Seat 4: a5661ff2 (big blind) folded before Flop
Seat 5: Hero folded before Flop
Seat 7: bd8abd3 folded before Flop
Seat 8: 3ed018f9 folded before Flop


Poker Hand #TM3449966173: Tournament #149964808, Bounty Hunters Special $1.08 Hold'em No Limit - Level12(400/800) - 2024/07/03 22:39:08
Table '8' 8-max Seat #8 is the button
Seat 2: 4250e296 (55,921 in chips)
Seat 3: aa4e3dbf (31,823 in chips)
Seat 4: a5661ff2 (9,395 in chips)
Seat 5: Hero (52,058 in chips)
Seat 6: 11fc0ba8 (71,817 in chips)
Seat 7: bd8abd3 (63,661 in chips)
Seat 8: 3ed018f9 (97,310 in chips)
a5661ff2: posts the ante 120
4250e296: posts the ante 120
11fc0ba8: posts the ante 120
3ed018f9: posts the ante 120
aa4e3dbf: posts the ante 120
Hero: posts the ante 120
bd8abd3: posts the ante 120
4250e296: posts small blind 400
aa4e3dbf: posts big blind 800
*** HOLE CARDS ***
Dealt to 4250e296 
Dealt to aa4e3dbf 
Dealt to a5661ff2 
Dealt to Hero [4c Qd]
Dealt to 11fc0ba8 
Dealt to bd8abd3 
Dealt to 3ed018f9 
a5661ff2: folds
Hero: folds
11fc0ba8: raises 1,039 to 1,839
bd8abd3: folds
3ed018f9: calls 1,839
4250e296: folds
aa4e3dbf: calls 1,039
*** FLOP *** [9h 7h Ah]
aa4e3dbf: bets 2,230
11fc0ba8: raises 2,230 to 4,460
3ed018f9: calls 4,460
aa4e3dbf: calls 2,230
*** TURN *** [9h 7h Ah] [2h]
aa4e3dbf: checks
11fc0ba8: checks
3ed018f9: bets 20,137
aa4e3dbf: folds
11fc0ba8: raises 45,261 to 65,398 and is all-in
3ed018f9: calls 45,261
11fc0ba8: shows [8h 5h] (Ace High Flush)
3ed018f9: shows [4h Kh] (Ace High Flush)
*** RIVER *** [9h 7h Ah 2h] [3s]
*** SHOWDOWN ***
3ed018f9 collected 150,933 from pot
*** SUMMARY ***
Total pot 150,933 | Rake 0 | Jackpot 0 | Bingo 0 | Fortune 0 | Tax 0
Board [9h 7h Ah 2h 3s]
Seat 2: 4250e296 (small blind) folded before Flop
Seat 3: aa4e3dbf (big blind) folded on the Turn
Seat 4: a5661ff2 folded before Flop
Seat 5: Hero folded before Flop
Seat 6: 11fc0ba8 showed [8h 5h] and lost with Ace High Flush
Seat 7: bd8abd3 folded before Flop
Seat 8: 3ed018f9 (button) showed [4h Kh] and won (150,933) with Ace High Flush


Poker Hand #TM3449966122: Tournament #149964808, Bounty Hunters Special $1.08 Hold'em No Limit - Level12(400/800) - 2024/07/03 22:37:54
Table '8' 8-max Seat #7 is the button
Seat 2: 4250e296 (56,841 in chips)
Seat 3: aa4e3dbf (33,945 in chips)
Seat 4: a5661ff2 (9,515 in chips)
Seat 5: Hero (52,178 in chips)
Seat 6: 11fc0ba8 (94,431 in chips)
Seat 7: bd8abd3 (63,781 in chips)
Seat 8: 3ed018f9 (71,294 in chips)
a5661ff2: posts the ante 120
4250e296: posts the ante 120
11fc0ba8: posts the ante 120
3ed018f9: posts the ante 120
aa4e3dbf: posts the ante 120
Hero: posts the ante 120
bd8abd3: posts the ante 120
3ed018f9: posts small blind 400
4250e296: posts big blind 800
*** HOLE CARDS ***
Dealt to 4250e296 
Dealt to aa4e3dbf 
Dealt to a5661ff2 
Dealt to Hero [Ac 6s]
Dealt to 11fc0ba8 
Dealt to bd8abd3 
Dealt to 3ed018f9 
aa4e3dbf: calls 800
a5661ff2: folds
Hero: folds
11fc0ba8: raises 1,202 to 2,002
bd8abd3: folds
3ed018f9: calls 1,602
4250e296: folds
aa4e3dbf: calls 1,202
*** FLOP *** [3s 5d As]
3ed018f9: checks
aa4e3dbf: checks
11fc0ba8: bets 4,282
3ed018f9: calls 4,282
aa4e3dbf: folds
*** TURN *** [3s 5d As] [9c]
3ed018f9: checks
11fc0ba8: checks
*** RIVER *** [3s 5d As 9c] [Qs]
3ed018f9: bets 16,210
11fc0ba8: calls 16,210
3ed018f9: shows [Js 8s] (Ace High Flush)
11fc0ba8: shows [Ah 2c] (Pair of Aces)
*** SHOWDOWN ***
3ed018f9 collected 48,630 from pot
*** SUMMARY ***
Total pot 48,630 | Rake 0 | Jackpot 0 | Bingo 0 | Fortune 0 | Tax 0
Board [3s 5d As 9c Qs]
Seat 2: 4250e296 (big blind) folded before Flop
Seat 3: aa4e3dbf folded on the Flop
Seat 4: a5661ff2 folded before Flop
Seat 5: Hero folded before Flop
Seat 6: 11fc0ba8 showed [Ah 2c] and lost with Pair of Aces
Seat 7: bd8abd3 (button) folded before Flop
Seat 8: 3ed018f9 (small blind) showed [Js 8s] and won (48,630) with Ace High Flush


Poker Hand #TM3449966085: Tournament #149964808, Bounty Hunters Special $1.08 Hold'em No Limit - Level12(400/800) - 2024/07/03 22:37:03
Table '8' 8-max Seat #6 is the button
Seat 1: 4cb377d5 (6,951 in chips)
Seat 2: 4250e296 (47,970 in chips)
Seat 3: aa4e3dbf (34,065 in chips)
Seat 4: a5661ff2 (9,635 in chips)
Seat 5: Hero (52,298 in chips)
Seat 6: 11fc0ba8 (94,551 in chips)
Seat 7: bd8abd3 (64,301 in chips)
Seat 8: 3ed018f9 (72,214 in chips)
4cb377d5: posts the ante 120
a5661ff2: posts the ante 120
4250e296: posts the ante 120
11fc0ba8: posts the ante 120
3ed018f9: posts the ante 120
aa4e3dbf: posts the ante 120
Hero: posts the ante 120
bd8abd3: posts the ante 120
bd8abd3: posts small blind 400
3ed018f9: posts big blind 800
*** HOLE CARDS ***
Dealt to 4cb377d5 
Dealt to 4250e296 
Dealt to aa4e3dbf 
Dealt to a5661ff2 
Dealt to Hero [4s 8d]
Dealt to 11fc0ba8 
Dealt to bd8abd3 
Dealt to 3ed018f9 
4cb377d5: raises 6,031 to 6,831 and is all-in
4250e296: calls 6,831
aa4e3dbf: folds
a5661ff2: folds
Hero: folds
11fc0ba8: folds
bd8abd3: folds
3ed018f9: folds
4cb377d5: shows [9d 9h]
4250e296: shows [Qh Jh]
*** FLOP *** [9c Qs Th]
*** TURN *** [9c Qs Th] [6c]
*** RIVER *** [9c Qs Th 6c] [Kc]
*** SHOWDOWN ***
4250e296 collected 15,822 from pot
*** SUMMARY ***
Total pot 15,822 | Rake 0 | Jackpot 0 | Bingo 0 | Fortune 0 | Tax 0
Board [9c Qs Th 6c Kc]
Seat 1: 4cb377d5 showed [9d 9h] and lost with Three Nines
Seat 2: 4250e296 showed [Qh Jh] and won (15,822) with Kings-High Straight
Seat 3: aa4e3dbf folded before Flop
Seat 4: a5661ff2 folded before Flop
Seat 5: Hero folded before Flop
Seat 6: 11fc0ba8 (button) folded before Flop
Seat 7: bd8abd3 (small blind) folded before Flop
Seat 8: 3ed018f9 (big blind) folded before Flop


Poker Hand #TM3449966057: Tournament #149964808, Bounty Hunters Special $1.08 Hold'em No Limit - Level12(400/800) - 2024/07/03 22:36:23
Table '8' 8-max Seat #5 is the button
Seat 1: 4cb377d5 (7,071 in chips)
Seat 2: 4250e296 (48,090 in chips)
Seat 4: a5661ff2 (9,755 in chips)
Seat 5: Hero (54,018 in chips)
Seat 6: 11fc0ba8 (95,071 in chips)
Seat 7: bd8abd3 (65,221 in chips)
Seat 8: 3ed018f9 (68,694 in chips)
4cb377d5: posts the ante 120
a5661ff2: posts the ante 120
4250e296: posts the ante 120
11fc0ba8: posts the ante 120
3ed018f9: posts the ante 120
Hero: posts the ante 120
bd8abd3: posts the ante 120
11fc0ba8: posts small blind 400
bd8abd3: posts big blind 800
*** HOLE CARDS ***
Dealt to 4cb377d5 
Dealt to 4250e296 
Dealt to a5661ff2 
Dealt to Hero [As Js]
Dealt to 11fc0ba8 
Dealt to bd8abd3 
Dealt to 3ed018f9 
3ed018f9: raises 800 to 1,600
4cb377d5: folds
4250e296: folds
a5661ff2: folds
Hero: calls 1,600
11fc0ba8: folds
bd8abd3: folds
*** FLOP *** [7d 8s 6c]
3ed018f9: checks
Hero: checks
*** TURN *** [7d 8s 6c] [Kc]
3ed018f9: checks
Hero: checks
*** RIVER *** [7d 8s 6c Kc] [4c]
3ed018f9: checks
Hero: checks
3ed018f9: shows [2c 2s] (Pair of Twos)
Hero: shows [As Js] (Ace-High)
*** SHOWDOWN ***
3ed018f9 collected 5,240 from pot
*** SUMMARY ***
Total pot 5,240 | Rake 0 | Jackpot 0 | Bingo 0 | Fortune 0 | Tax 0
Board [7d 8s 6c Kc 4c]
Seat 1: 4cb377d5 folded before Flop
Seat 2: 4250e296 folded before Flop
Seat 4: a5661ff2 folded before Flop
Seat 5: Hero (button) showed [As Js] and lost with Ace-High
Seat 6: 11fc0ba8 (small blind) folded before Flop
Seat 7: bd8abd3 (big blind) folded before Flop
Seat 8: 3ed018f9 showed [2c 2s] and won (5,240) with Pair of Twos


Poker Hand #TM3449966008: Tournament #149964808, Bounty Hunters Special $1.08 Hold'em No Limit - Level12(400/800) - 2024/07/03 22:35:09
Table '8' 8-max Seat #4 is the button
Seat 1: 4cb377d5 (7,191 in chips)
Seat 2: 4250e296 (48,210 in chips)
Seat 3: 82b58c39 (40,526 in chips)
Seat 4: a5661ff2 (9,875 in chips)
Seat 5: Hero (54,938 in chips)
Seat 6: 11fc0ba8 (90,111 in chips)
Seat 7: bd8abd3 (65,341 in chips)
Seat 8: 3ed018f9 (72,134 in chips)
4cb377d5: posts the ante 120
a5661ff2: posts the ante 120
82b58c39: posts the ante 120
4250e296: posts the ante 120
11fc0ba8: posts the ante 120
3ed018f9: posts the ante 120
Hero: posts the ante 120
bd8abd3: posts the ante 120
Hero: posts small blind 400
11fc0ba8: posts big blind 800
*** HOLE CARDS ***
Dealt to 4cb377d5 
Dealt to 4250e296 
Dealt to 82b58c39 
Dealt to a5661ff2 
Dealt to Hero [9h Ts]
Dealt to 11fc0ba8 
Dealt to bd8abd3 
Dealt to 3ed018f9 
bd8abd3: folds
3ed018f9: calls 800
4cb377d5: folds
4250e296: folds
82b58c39: folds
a5661ff2: folds
Hero: calls 400
11fc0ba8: checks
*** FLOP *** [Js 6d 5h]
Hero: checks
11fc0ba8: checks
3ed018f9: bets 2,520
Hero: folds
11fc0ba8: calls 2,520
*** TURN *** [Js 6d 5h] [Kh]
11fc0ba8: checks
3ed018f9: checks
*** RIVER *** [Js 6d 5h Kh] [Qs]
11fc0ba8: bets 11,340
3ed018f9: folds
Uncalled bet (11,340) returned to 11fc0ba8
*** SHOWDOWN ***
11fc0ba8 collected 8,400 from pot
*** SUMMARY ***
Total pot 8,400 | Rake 0 | Jackpot 0 | Bingo 0 | Fortune 0 | Tax 0
Board [Js 6d 5h Kh Qs]
Seat 1: 4cb377d5 folded before Flop
Seat 2: 4250e296 folded before Flop
Seat 3: 82b58c39 folded before Flop
Seat 4: a5661ff2 (button) folded before Flop
Seat 5: Hero (small blind) folded on the Flop
Seat 6: 11fc0ba8 (big blind) won (8,400)
Seat 7: bd8abd3 folded before Flop
Seat 8: 3ed018f9 folded on the River


Poker Hand #TM3449965966: Tournament #149964808, Bounty Hunters Special $1.08 Hold'em No Limit - Level11(350/700) - 2024/07/03 22:34:05
Table '8' 8-max Seat #3 is the button
Seat 1: 4cb377d5 (7,291 in chips)
Seat 2: 4250e296 (48,310 in chips)
Seat 3: 82b58c39 (40,626 in chips)
Seat 4: a5661ff2 (10,325 in chips)
Seat 5: Hero (58,089 in chips)
Seat 6: 11fc0ba8 (86,010 in chips)
Seat 7: bd8abd3 (65,441 in chips)
Seat 8: 3ed018f9 (72,234 in chips)
4cb377d5: posts the ante 100
a5661ff2: posts the ante 100
82b58c39: posts the ante 100
4250e296: posts the ante 100
11fc0ba8: posts the ante 100
3ed018f9: posts the ante 100
Hero: posts the ante 100
bd8abd3: posts the ante 100
a5661ff2: posts small blind 350
Hero: posts big blind 700
*** HOLE CARDS ***
Dealt to 4cb377d5 
Dealt to 4250e296 
Dealt to 82b58c39 
Dealt to a5661ff2 
Dealt to Hero [7s 8h]
Dealt to 11fc0ba8 
Dealt to bd8abd3 
Dealt to 3ed018f9 
11fc0ba8: raises 909 to 1,609
bd8abd3: folds
3ed018f9: folds
4cb377d5: folds
4250e296: folds
82b58c39: folds
a5661ff2: folds
Hero: calls 909
*** FLOP *** [7h Ac 3h]
Hero: bets 1,442
11fc0ba8: calls 1,442
*** TURN *** [7h Ac 3h] [9c]
Hero: checks
11fc0ba8: bets 9,791
Hero: folds
Uncalled bet (9,791) returned to 11fc0ba8
*** SHOWDOWN ***
11fc0ba8 collected 7,252 from pot
*** SUMMARY ***
Total pot 7,252 | Rake 0 | Jackpot 0 | Bingo 0 | Fortune 0 | Tax 0
Board [7h Ac 3h 9c]
Seat 1: 4cb377d5 folded before Flop
Seat 2: 4250e296 folded before Flop
Seat 3: 82b58c39 (button) folded before Flop
Seat 4: a5661ff2 (small blind) folded before Flop
Seat 5: Hero (big blind) folded on the Turn
Seat 6: 11fc0ba8 won (7,252)
Seat 7: bd8abd3 folded before Flop
Seat 8: 3ed018f9 folded before Flop


Poker Hand #TM3449965926: Tournament #149964808, Bounty Hunters Special $1.08 Hold'em No Limit - Level11(350/700) - 2024/07/03 22:33:16
Table '8' 8-max Seat #2 is the button
Seat 1: 4cb377d5 (7,391 in chips)
Seat 2: 4250e296 (50,510 in chips)
Seat 3: 82b58c39 (35,026 in chips)
Seat 4: a5661ff2 (11,125 in chips)
Seat 5: Hero (58,189 in chips)
Seat 6: 11fc0ba8 (86,110 in chips)
Seat 7: bd8abd3 (65,541 in chips)
Seat 8: 3ed018f9 (74,434 in chips)
4cb377d5: posts the ante 100
a5661ff2: posts the ante 100
4250e296: posts the ante 100
82b58c39: posts the ante 100
11fc0ba8: posts the ante 100
3ed018f9: posts the ante 100
Hero: posts the ante 100
bd8abd3: posts the ante 100
82b58c39: posts small blind 350
a5661ff2: posts big blind 700
*** HOLE CARDS ***
Dealt to 4cb377d5 
Dealt to 4250e296 
Dealt to 82b58c39 
Dealt to a5661ff2 
Dealt to Hero [3h Qc]
Dealt to 11fc0ba8 
Dealt to bd8abd3 
Dealt to 3ed018f9 
Hero: folds
11fc0ba8: folds
bd8abd3: folds
3ed018f9: raises 1,400 to 2,100
4cb377d5: folds
4250e296: calls 2,100
82b58c39: raises 32,826 to 34,926 and is all-in
a5661ff2: folds
3ed018f9: folds
4250e296: folds
Uncalled bet (32,826) returned to 82b58c39
*** SHOWDOWN ***
82b58c39 collected 7,800 from pot
*** SUMMARY ***
Total pot 7,800 | Rake 0 | Jackpot 0 | Bingo 0 | Fortune 0 | Tax 0
Seat 1: 4cb377d5 folded before Flop
Seat 2: 4250e296 (button) folded before Flop
Seat 3: 82b58c39 (small blind) collected (7,800)
Seat 4: a5661ff2 (big blind) folded before Flop
Seat 5: Hero folded before Flop
Seat 6: 11fc0ba8 folded before Flop
Seat 7: bd8abd3 folded before Flop
Seat 8: 3ed018f9 folded before Flop


Poker Hand #TM3449965902: Tournament #149964808, Bounty Hunters Special $1.08 Hold'em No Limit - Level11(350/700) - 2024/07/03 22:32:44
Table '8' 8-max Seat #1 is the button
Seat 1: 4cb377d5 (7,491 in chips)
Seat 2: 4250e296 (50,960 in chips)
Seat 3: 82b58c39 (35,826 in chips)
Seat 4: a5661ff2 (11,225 in chips)
Seat 5: Hero (58,289 in chips)
Seat 6: 11fc0ba8 (84,360 in chips)
Seat 7: bd8abd3 (65,641 in chips)
Seat 8: 3ed018f9 (74,534 in chips)
4cb377d5: posts the ante 100
a5661ff2: posts the ante 100
82b58c39: posts the ante 100
4250e296: posts the ante 100
11fc0ba8: posts the ante 100
3ed018f9: posts the ante 100
Hero: posts the ante 100
bd8abd3: posts the ante 100
4250e296: posts small blind 350
82b58c39: posts big blind 700
*** HOLE CARDS ***
Dealt to 4cb377d5 
Dealt to 4250e296 
Dealt to 82b58c39 
Dealt to a5661ff2 
Dealt to Hero [4d Jh]
Dealt to 11fc0ba8 
Dealt to bd8abd3 
Dealt to 3ed018f9 
a5661ff2: folds
Hero: folds
11fc0ba8: raises 909 to 1,609
bd8abd3: folds
3ed018f9: folds
4cb377d5: folds
4250e296: folds
82b58c39: folds
Uncalled bet (909) returned to 11fc0ba8
*** SHOWDOWN ***
11fc0ba8 collected 2,550 from pot
*** SUMMARY ***
Total pot 2,550 | Rake 0 | Jackpot 0 | Bingo 0 | Fortune 0 | Tax 0
Seat 1: 4cb377d5 (button) folded before Flop
Seat 2: 4250e296 (small blind) folded before Flop
Seat 3: 82b58c39 (big blind) folded before Flop
Seat 4: a5661ff2 folded before Flop
Seat 5: Hero folded before Flop
Seat 6: 11fc0ba8 collected (2,550)
Seat 7: bd8abd3 folded before Flop
Seat 8: 3ed018f9 folded before Flop


Poker Hand #TM3449965865: Tournament #149964808, Bounty Hunters Special $1.08 Hold'em No Limit - Level11(350/700) - 2024/07/03 22:32:00
Table '8' 8-max Seat #8 is the button
Seat 1: 4cb377d5 (9,200 in chips)
Seat 2: 4250e296 (51,760 in chips)
Seat 3: 82b58c39 (35,926 in chips)
Seat 4: a5661ff2 (11,325 in chips)
Seat 5: Hero (58,389 in chips)
Seat 6: 11fc0ba8 (86,069 in chips)
Seat 7: bd8abd3 (65,741 in chips)
Seat 8: 3ed018f9 (69,916 in chips)
4cb377d5: posts the ante 100
a5661ff2: posts the ante 100
82b58c39: posts the ante 100
4250e296: posts the ante 100
11fc0ba8: posts the ante 100
3ed018f9: posts the ante 100
Hero: posts the ante 100
bd8abd3: posts the ante 100
4cb377d5: posts small blind 350
4250e296: posts big blind 700
*** HOLE CARDS ***
Dealt to 4cb377d5 
Dealt to 4250e296 
Dealt to 82b58c39 
Dealt to a5661ff2 
Dealt to Hero [5s 8h]
Dealt to 11fc0ba8 
Dealt to bd8abd3 
Dealt to 3ed018f9 
82b58c39: folds
a5661ff2: folds
Hero: folds
11fc0ba8: raises 909 to 1,609
bd8abd3: folds
3ed018f9: calls 1,609
4cb377d5: calls 1,259
4250e296: folds
*** FLOP *** [As Qs 8d]
4cb377d5: checks
11fc0ba8: checks
3ed018f9: bets 3,164
4cb377d5: folds
11fc0ba8: folds
Uncalled bet (3,164) returned to 3ed018f9
*** SHOWDOWN ***
3ed018f9 collected 6,327 from pot
*** SUMMARY ***
Total pot 6,327 | Rake 0 | Jackpot 0 | Bingo 0 | Fortune 0 | Tax 0
Board [As Qs 8d]
Seat 1: 4cb377d5 (small blind) folded on the Flop
Seat 2: 4250e296 (big blind) folded before Flop
Seat 3: 82b58c39 folded before Flop
Seat 4: a5661ff2 folded before Flop
Seat 5: Hero folded before Flop
Seat 6: 11fc0ba8 folded on the Flop
Seat 7: bd8abd3 folded before Flop
Seat 8: 3ed018f9 (button) won (6,327)


Poker Hand #TM3449965840: Tournament #149964808, Bounty Hunters Special $1.08 Hold'em No Limit - Level11(350/700) - 2024/07/03 22:31:25
Table '8' 8-max Seat #7 is the button
Seat 1: 4cb377d5 (10,000 in chips)
Seat 2: 4250e296 (53,260 in chips)
Seat 3: 82b58c39 (32,776 in chips)
Seat 4: a5661ff2 (11,425 in chips)
Seat 5: Hero (58,489 in chips)
Seat 6: 11fc0ba8 (86,169 in chips)
Seat 7: bd8abd3 (65,841 in chips)
Seat 8: 3ed018f9 (70,366 in chips)
4cb377d5: posts the ante 100
a5661ff2: posts the ante 100
82b58c39: posts the ante 100
4250e296: posts the ante 100
11fc0ba8: posts the ante 100
3ed018f9: posts the ante 100
Hero: posts the ante 100
bd8abd3: posts the ante 100
3ed018f9: posts small blind 350
4cb377d5: posts big blind 700
*** HOLE CARDS ***
Dealt to 4cb377d5 
Dealt to 4250e296 
Dealt to 82b58c39 
Dealt to a5661ff2 
Dealt to Hero [5c 2d]
Dealt to 11fc0ba8 
Dealt to bd8abd3 
Dealt to 3ed018f9 
4250e296: raises 700 to 1,400
82b58c39: raises 31,276 to 32,676 and is all-in
a5661ff2: folds
Hero: folds
11fc0ba8: folds
bd8abd3: folds
3ed018f9: folds
4cb377d5: folds
4250e296: folds
Uncalled bet (31,276) returned to 82b58c39
*** SHOWDOWN ***
82b58c39 collected 4,650 from pot
*** SUMMARY ***
Total pot 4,650 | Rake 0 | Jackpot 0 | Bingo 0 | Fortune 0 | Tax 0
Seat 1: 4cb377d5 (big blind) folded before Flop
Seat 2: 4250e296 folded before Flop
Seat 3: 82b58c39 collected (4,650)
Seat 4: a5661ff2 folded before Flop
Seat 5: Hero folded before Flop
Seat 6: 11fc0ba8 folded before Flop
Seat 7: bd8abd3 (button) folded before Flop
Seat 8: 3ed018f9 (small blind) folded before Flop


Poker Hand #TM3449965794: Tournament #149964808, Bounty Hunters Special $1.08 Hold'em No Limit - Level11(350/700) - 2024/07/03 22:30:28
Table '8' 8-max Seat #6 is the button
Seat 2: 4250e296 (53,360 in chips)
Seat 3: 82b58c39 (31,126 in chips)
Seat 4: a5661ff2 (11,525 in chips)
Seat 5: Hero (58,589 in chips)
Seat 6: 11fc0ba8 (86,269 in chips)
Seat 7: bd8abd3 (66,291 in chips)
Seat 8: 3ed018f9 (71,166 in chips)
a5661ff2: posts the ante 100
82b58c39: posts the ante 100
4250e296: posts the ante 100
11fc0ba8: posts the ante 100
3ed018f9: posts the ante 100
Hero: posts the ante 100
bd8abd3: posts the ante 100
bd8abd3: posts small blind 350
3ed018f9: posts big blind 700
*** HOLE CARDS ***
Dealt to 4250e296 
Dealt to 82b58c39 
Dealt to a5661ff2 
Dealt to Hero [3c Qc]
Dealt to 11fc0ba8 
Dealt to bd8abd3 
Dealt to 3ed018f9 
4250e296: folds
82b58c39: calls 700
a5661ff2: folds
Hero: folds
11fc0ba8: folds
bd8abd3: folds
3ed018f9: checks
*** FLOP *** [Kc 8h Th]
3ed018f9: checks
82b58c39: checks
*** TURN *** [Kc 8h Th] [Td]
3ed018f9: checks
82b58c39: checks
*** RIVER *** [Kc 8h Th Td] [Jc]
3ed018f9: checks
82b58c39: bets 1,225
3ed018f9: folds
Uncalled bet (1,225) returned to 82b58c39
*** SHOWDOWN ***
82b58c39 collected 2,450 from pot
*** SUMMARY ***
Total pot 2,450 | Rake 0 | Jackpot 0 | Bingo 0 | Fortune 0 | Tax 0
Board [Kc 8h Th Td Jc]
Seat 2: 4250e296 folded before Flop
Seat 3: 82b58c39 won (2,450)
Seat 4: a5661ff2 folded before Flop
Seat 5: Hero folded before Flop
Seat 6: 11fc0ba8 (button) folded before Flop
Seat 7: bd8abd3 (small blind) folded before Flop
Seat 8: 3ed018f9 (big blind) folded on the River


Poker Hand #TM3449965741: Tournament #149964808, Bounty Hunters Special $1.08 Hold'em No Limit - Level11(350/700) - 2024/07/03 22:29:22
Table '8' 8-max Seat #5 is the button
Seat 1: 8611d93a (88,368 in chips)
Seat 2: 4250e296 (53,460 in chips)
Seat 3: 82b58c39 (31,226 in chips)
Seat 4: a5661ff2 (11,625 in chips)
Seat 5: Hero (54,389 in chips)
Seat 6: 11fc0ba8 (87,769 in chips)
Seat 7: bd8abd3 (67,091 in chips)
Seat 8: 3ed018f9 (72,666 in chips)
a5661ff2: posts the ante 100
82b58c39: posts the ante 100
4250e296: posts the ante 100
11fc0ba8: posts the ante 100
3ed018f9: posts the ante 100
8611d93a: posts the ante 100
Hero: posts the ante 100
bd8abd3: posts the ante 100
11fc0ba8: posts small blind 350
bd8abd3: posts big blind 700
*** HOLE CARDS ***
Dealt to 8611d93a 
Dealt to 4250e296 
Dealt to 82b58c39 
Dealt to a5661ff2 
Dealt to Hero [Ah Jc]
Dealt to 11fc0ba8 
Dealt to bd8abd3 
Dealt to 3ed018f9 
3ed018f9: raises 700 to 1,400
8611d93a: folds
4250e296: folds
82b58c39: folds
a5661ff2: folds
Hero: calls 1,400
11fc0ba8: calls 1,050
bd8abd3: folds
*** FLOP *** [5d 5h 7s]
11fc0ba8: checks
3ed018f9: checks
Hero: checks
*** TURN *** [5d 5h 7s] [4c]
11fc0ba8: checks
3ed018f9: checks
Hero: bets 1,881
11fc0ba8: folds
3ed018f9: folds
Uncalled bet (1,881) returned to Hero
*** SHOWDOWN ***
Hero collected 5,700 from pot
*** SUMMARY ***
Total pot 5,700 | Rake 0 | Jackpot 0 | Bingo 0 | Fortune 0 | Tax 0
Board [5d 5h 7s 4c]
Seat 1: 8611d93a folded before Flop
Seat 2: 4250e296 folded before Flop
Seat 3: 82b58c39 folded before Flop
Seat 4: a5661ff2 folded before Flop
Seat 5: Hero (button) won (5,700)
Seat 6: 11fc0ba8 (small blind) folded on the Turn
Seat 7: bd8abd3 (big blind) folded before Flop
Seat 8: 3ed018f9 folded on the Turn


Poker Hand #TM3449965668: Tournament #149964808, Bounty Hunters Special $1.08 Hold'em No Limit - Level11(350/700) - 2024/07/03 22:27:47
Table '8' 8-max Seat #4 is the button
Seat 1: 8611d93a (88,468 in chips)
Seat 2: 4250e296 (53,560 in chips)
Seat 3: 82b58c39 (21,221 in chips)
Seat 4: a5661ff2 (11,725 in chips)
Seat 5: Hero (55,189 in chips)
Seat 6: 11fc0ba8 (96,474 in chips)
Seat 7: bd8abd3 (67,191 in chips)
Seat 8: 3ed018f9 (72,766 in chips)
a5661ff2: posts the ante 100
82b58c39: posts the ante 100
4250e296: posts the ante 100
11fc0ba8: posts the ante 100
3ed018f9: posts the ante 100
8611d93a: posts the ante 100
Hero: posts the ante 100
bd8abd3: posts the ante 100
Hero: posts small blind 350
11fc0ba8: posts big blind 700
*** HOLE CARDS ***
Dealt to 8611d93a 
Dealt to 4250e296 
Dealt to 82b58c39 
Dealt to a5661ff2 
Dealt to Hero [Ks 9d]
Dealt to 11fc0ba8 
Dealt to bd8abd3 
Dealt to 3ed018f9 
bd8abd3: folds
3ed018f9: folds
8611d93a: folds
4250e296: folds
82b58c39: calls 700
a5661ff2: folds
Hero: calls 350
11fc0ba8: checks
*** FLOP *** [4h 5s 5c]
Hero: checks
11fc0ba8: checks
82b58c39: checks
*** TURN *** [4h 5s 5c] [7s]
Hero: checks
11fc0ba8: bets 2,233
82b58c39: calls 2,233
Hero: folds
*** RIVER *** [4h 5s 5c 7s] [9h]
11fc0ba8: bets 5,672
82b58c39: calls 5,672
11fc0ba8: shows [8d 4c] (Pair of Fives and Pair of Fours)
82b58c39: shows [7h 8h] (Pair of Sevens and Pair of Fives)
*** SHOWDOWN ***
82b58c39 collected 18,710 from pot
*** SUMMARY ***
Total pot 18,710 | Rake 0 | Jackpot 0 | Bingo 0 | Fortune 0 | Tax 0
Board [4h 5s 5c 7s 9h]
Seat 1: 8611d93a folded before Flop
Seat 2: 4250e296 folded before Flop
Seat 3: 82b58c39 showed [7h 8h] and won (18,710) with Pair of Sevens and Pair of Fives
Seat 4: a5661ff2 (button) folded before Flop
Seat 5: Hero (small blind) folded on the Turn
Seat 6: 11fc0ba8 (big blind) showed [8d 4c] and lost with Pair of Fives and Pair of Fours
Seat 7: bd8abd3 folded before Flop
Seat 8: 3ed018f9 folded before Flop


Poker Hand #TM3449965634: Tournament #149964808, Bounty Hunters Special $1.08 Hold'em No Limit - Level11(350/700) - 2024/07/03 22:26:57
Table '8' 8-max Seat #3 is the button
Seat 2: 4250e296 (53,660 in chips)
Seat 3: 82b58c39 (21,321 in chips)
Seat 4: a5661ff2 (12,175 in chips)
Seat 5: Hero (55,989 in chips)
Seat 6: 11fc0ba8 (114,329 in chips)
Seat 7: bd8abd3 (67,291 in chips)
Seat 8: 3ed018f9 (53,361 in chips)
a5661ff2: posts the ante 100
82b58c39: posts the ante 100
4250e296: posts the ante 100
11fc0ba8: posts the ante 100
3ed018f9: posts the ante 100
Hero: posts the ante 100
bd8abd3: posts the ante 100
a5661ff2: posts small blind 350
Hero: posts big blind 700
*** HOLE CARDS ***
Dealt to 4250e296 
Dealt to 82b58c39 
Dealt to a5661ff2 
Dealt to Hero [As 8d]
Dealt to 11fc0ba8 
Dealt to bd8abd3 
Dealt to 3ed018f9 
11fc0ba8: raises 909 to 1,609
bd8abd3: folds
3ed018f9: raises 4,968 to 6,577
4250e296: folds
82b58c39: folds
a5661ff2: folds
Hero: folds
11fc0ba8: calls 4,968
*** FLOP *** [8c Kd Ac]
11fc0ba8: checks
3ed018f9: bets 11,178
11fc0ba8: calls 11,178
*** TURN *** [8c Kd Ac] [7s]
11fc0ba8: checks
3ed018f9: bets 35,506 and is all-in
11fc0ba8: folds
Uncalled bet (35,506) returned to 3ed018f9
*** SHOWDOWN ***
3ed018f9 collected 37,260 from pot
*** SUMMARY ***
Total pot 37,260 | Rake 0 | Jackpot 0 | Bingo 0 | Fortune 0 | Tax 0
Board [8c Kd Ac 7s]
Seat 2: 4250e296 folded before Flop
Seat 3: 82b58c39 (button) folded before Flop
Seat 4: a5661ff2 (small blind) folded before Flop
Seat 5: Hero (big blind) folded before Flop
Seat 6: 11fc0ba8 folded on the Turn
Seat 7: bd8abd3 folded before Flop
Seat 8: 3ed018f9 won (37,260)


Poker Hand #TM3449965579: Tournament #149964808, Bounty Hunters Special $1.08 Hold'em No Limit - Level11(350/700) - 2024/07/03 22:25:42
Table '8' 8-max Seat #2 is the button
Seat 1: 9a9fdc6d (10,000 in chips)
Seat 2: 4250e296 (53,760 in chips)
Seat 3: 82b58c39 (21,771 in chips)
Seat 4: a5661ff2 (12,975 in chips)
Seat 5: Hero (44,339 in chips)
Seat 6: 11fc0ba8 (114,429 in chips)
Seat 7: bd8abd3 (67,391 in chips)
Seat 8: 3ed018f9 (53,461 in chips)
a5661ff2: posts the ante 100
4250e296: posts the ante 100
82b58c39: posts the ante 100
11fc0ba8: posts the ante 100
3ed018f9: posts the ante 100
9a9fdc6d: posts the ante 100
Hero: posts the ante 100
bd8abd3: posts the ante 100
82b58c39: posts small blind 350
a5661ff2: posts big blind 700
*** HOLE CARDS ***
Dealt to 9a9fdc6d 
Dealt to 4250e296 
Dealt to 82b58c39 
Dealt to a5661ff2 
Dealt to Hero [Jd 9d]
Dealt to 11fc0ba8 
Dealt to bd8abd3 
Dealt to 3ed018f9 
Hero: raises 700 to 1,400
11fc0ba8: folds
bd8abd3: folds
3ed018f9: folds
9a9fdc6d: raises 8,500 to 9,900 and is all-in
4250e296: folds
82b58c39: folds
a5661ff2: folds
Hero: calls 8,500
9a9fdc6d: shows [Kh Qc]
Hero: shows [Jd 9d]
*** FLOP *** [Ac Ah 9s]
*** TURN *** [Ac Ah 9s] [7d]
*** RIVER *** [Ac Ah 9s 7d] [Js]
*** SHOWDOWN ***
Hero collected 21,650 from pot
*** SUMMARY ***
Total pot 21,650 | Rake 0 | Jackpot 0 | Bingo 0 | Fortune 0 | Tax 0
Board [Ac Ah 9s 7d Js]
Seat 1: 9a9fdc6d showed [Kh Qc] and lost with Pair of Aces
Seat 2: 4250e296 (button) folded before Flop
Seat 3: 82b58c39 (small blind) folded before Flop
Seat 4: a5661ff2 (big blind) folded before Flop
Seat 5: Hero showed [Jd 9d] and won (21,650) with Pair of Aces and Pair of Jacks
Seat 6: 11fc0ba8 folded before Flop
Seat 7: bd8abd3 folded before Flop
Seat 8: 3ed018f9 folded before Flop


Poker Hand #TM3449965541: Tournament #149964808, Bounty Hunters Special $1.08 Hold'em No Limit - Level11(350/700) - 2024/07/03 22:24:50
Table '8' 8-max Seat #8 is the button
Seat 2: 4250e296 (55,960 in chips)
Seat 3: 82b58c39 (16,971 in chips)
Seat 4: a5661ff2 (13,075 in chips)
Seat 5: Hero (44,439 in chips)
Seat 6: 11fc0ba8 (114,529 in chips)
Seat 7: bd8abd3 (67,491 in chips)
Seat 8: 3ed018f9 (55,661 in chips)
a5661ff2: posts the ante 100
82b58c39: posts the ante 100
4250e296: posts the ante 100
11fc0ba8: posts the ante 100
3ed018f9: posts the ante 100
Hero: posts the ante 100
bd8abd3: posts the ante 100
4250e296: posts small blind 350
82b58c39: posts big blind 700
*** HOLE CARDS ***
Dealt to 4250e296 
Dealt to 82b58c39 
Dealt to a5661ff2 
Dealt to Hero [3d 6h]
Dealt to 11fc0ba8 
Dealt to bd8abd3 
Dealt to 3ed018f9 
a5661ff2: folds
Hero: folds
11fc0ba8: folds
bd8abd3: folds
3ed018f9: calls 700
4250e296: calls 350
82b58c39: raises 1,400 to 2,100
3ed018f9: calls 1,400
4250e296: calls 1,400
*** FLOP *** [4d Kh Ks]
4250e296: checks
82b58c39: bets 2,310
3ed018f9: folds
4250e296: folds
Uncalled bet (2,310) returned to 82b58c39
*** SHOWDOWN ***
82b58c39 collected 7,000 from pot
*** SUMMARY ***
Total pot 7,000 | Rake 0 | Jackpot 0 | Bingo 0 | Fortune 0 | Tax 0
Board [4d Kh Ks]
Seat 2: 4250e296 (small blind) folded on the Flop
Seat 3: 82b58c39 (big blind) won (7,000)
Seat 4: a5661ff2 folded before Flop
Seat 5: Hero folded before Flop
Seat 6: 11fc0ba8 folded before Flop
Seat 7: bd8abd3 folded before Flop
Seat 8: 3ed018f9 (button) folded on the Flop


Poker Hand #TM3449965484: Tournament #149964808, Bounty Hunters Special $1.08 Hold'em No Limit - Level10(300/600) - 2024/07/03 22:23:33
Table '8' 8-max Seat #7 is the button
Seat 2: 4250e296 (36,027 in chips)
Seat 3: 82b58c39 (17,061 in chips)
Seat 4: a5661ff2 (13,165 in chips)
Seat 5: Hero (44,529 in chips)
Seat 6: 11fc0ba8 (133,712 in chips)
Seat 7: bd8abd3 (67,581 in chips)
Seat 8: 3ed018f9 (56,051 in chips)
a5661ff2: posts the ante 90
82b58c39: posts the ante 90
4250e296: posts the ante 90
11fc0ba8: posts the ante 90
3ed018f9: posts the ante 90
Hero: posts the ante 90
bd8abd3: posts the ante 90
3ed018f9: posts small blind 300
4250e296: posts big blind 600
*** HOLE CARDS ***
Dealt to 4250e296 
Dealt to 82b58c39 
Dealt to a5661ff2 
Dealt to Hero [Jh 5s]
Dealt to 11fc0ba8 
Dealt to bd8abd3 
Dealt to 3ed018f9 
82b58c39: folds
a5661ff2: folds
Hero: folds
11fc0ba8: raises 780 to 1,380
bd8abd3: folds
3ed018f9: folds
4250e296: calls 780
*** FLOP *** [5h 4h 7h]
4250e296: checks
11fc0ba8: checks
*** TURN *** [5h 4h 7h] [8s]
4250e296: bets 1,845
11fc0ba8: calls 1,845
*** RIVER *** [5h 4h 7h 8s] [4c]
4250e296: bets 5,535
11fc0ba8: raises 10,333 to 15,868
4250e296: calls 10,333
11fc0ba8: shows [9s Js] (Pair of Fours)
4250e296: shows [8c 9c] (Pair of Eights and Pair of Fours)
*** SHOWDOWN ***
4250e296 collected 39,116 from pot
*** SUMMARY ***
Total pot 39,116 | Rake 0 | Jackpot 0 | Bingo 0 | Fortune 0 | Tax 0
Board [5h 4h 7h 8s 4c]
Seat 2: 4250e296 (big blind) showed [8c 9c] and won (39,116) with Pair of Eights and Pair of Fours
Seat 3: 82b58c39 folded before Flop
Seat 4: a5661ff2 folded before Flop
Seat 5: Hero folded before Flop
Seat 6: 11fc0ba8 showed [9s Js] and lost with Pair of Fours
Seat 7: bd8abd3 (button) folded before Flop
Seat 8: 3ed018f9 (small blind) folded before Flop


Poker Hand #TM3449965456: Tournament #149964808, Bounty Hunters Special $1.08 Hold'em No Limit - Level10(300/600) - 2024/07/03 22:22:53
Table '8' 8-max Seat #6 is the button
Seat 1: 1926f18 (10,000 in chips)
Seat 2: 4250e296 (36,117 in chips)
Seat 3: 82b58c39 (17,151 in chips)
Seat 4: a5661ff2 (13,255 in chips)
Seat 5: Hero (44,619 in chips)
Seat 6: 11fc0ba8 (122,272 in chips)
Seat 7: bd8abd3 (67,971 in chips)
Seat 8: 3ed018f9 (56,741 in chips)
1926f18: posts the ante 90
a5661ff2: posts the ante 90
82b58c39: posts the ante 90
4250e296: posts the ante 90
11fc0ba8: posts the ante 90
3ed018f9: posts the ante 90
Hero: posts the ante 90
bd8abd3: posts the ante 90
bd8abd3: posts small blind 300
3ed018f9: posts big blind 600
*** HOLE CARDS ***
Dealt to 1926f18 
Dealt to 4250e296 
Dealt to 82b58c39 
Dealt to a5661ff2 
Dealt to Hero [3s Jc]
Dealt to 11fc0ba8 
Dealt to bd8abd3 
Dealt to 3ed018f9 
1926f18: raises 9,310 to 9,910 and is all-in
4250e296: folds
82b58c39: folds
a5661ff2: folds
Hero: folds
11fc0ba8: calls 9,910
bd8abd3: folds
3ed018f9: folds
1926f18: shows [Qh Ac]
11fc0ba8: shows [Jd Ad]
*** FLOP *** [8s 8d Td]
*** TURN *** [8s 8d Td] [6h]
*** RIVER *** [8s 8d Td 6h] [Jh]
*** SHOWDOWN ***
11fc0ba8 collected 21,440 from pot
*** SUMMARY ***
Total pot 21,440 | Rake 0 | Jackpot 0 | Bingo 0 | Fortune 0 | Tax 0
Board [8s 8d Td 6h Jh]
Seat 1: 1926f18 showed [Qh Ac] and lost with Pair of Eights
Seat 2: 4250e296 folded before Flop
Seat 3: 82b58c39 folded before Flop
Seat 4: a5661ff2 folded before Flop
Seat 5: Hero folded before Flop
Seat 6: 11fc0ba8 (button) showed [Jd Ad] and won (21,440) with Pair of Jacks and Pair of Eights
Seat 7: bd8abd3 (small blind) folded before Flop
Seat 8: 3ed018f9 (big blind) folded before Flop


Poker Hand #TM3449965398: Tournament #149964808, Bounty Hunters Special $1.08 Hold'em No Limit - Level10(300/600) - 2024/07/03 22:21:40
Table '8' 8-max Seat #5 is the button
Seat 2: 4250e296 (36,207 in chips)
Seat 3: 82b58c39 (17,841 in chips)
Seat 4: a5661ff2 (15,760 in chips)
Seat 5: Hero (44,709 in chips)
Seat 6: 11fc0ba8 (122,962 in chips)
Seat 7: bd8abd3 (68,661 in chips)
Seat 8: 3ed018f9 (51,986 in chips)
a5661ff2: posts the ante 90
82b58c39: posts the ante 90
4250e296: posts the ante 90
11fc0ba8: posts the ante 90
3ed018f9: posts the ante 90
Hero: posts the ante 90
bd8abd3: posts the ante 90
11fc0ba8: posts small blind 300
bd8abd3: posts big blind 600
*** HOLE CARDS ***
Dealt to 4250e296 
Dealt to 82b58c39 
Dealt to a5661ff2 
Dealt to Hero [3h 9c]
Dealt to 11fc0ba8 
Dealt to bd8abd3 
Dealt to 3ed018f9 
3ed018f9: calls 600
4250e296: folds
82b58c39: calls 600
a5661ff2: calls 600
Hero: folds
11fc0ba8: calls 300
bd8abd3: checks
*** FLOP *** [Jd 2d 5h]
11fc0ba8: checks
bd8abd3: checks
3ed018f9: bets 1,815
82b58c39: folds
a5661ff2: calls 1,815
11fc0ba8: folds
bd8abd3: folds
*** TURN *** [Jd 2d 5h] [Qd]
3ed018f9: checks
a5661ff2: checks
*** RIVER *** [Jd 2d 5h Qd] [Tc]
3ed018f9: checks
a5661ff2: checks
3ed018f9: shows [6c Jc] (Pair of Jacks)
a5661ff2: shows [6d 6s] (Pair of Sixes)
*** SHOWDOWN ***
3ed018f9 collected 7,260 from pot
*** SUMMARY ***
Total pot 7,260 | Rake 0 | Jackpot 0 | Bingo 0 | Fortune 0 | Tax 0
Board [Jd 2d 5h Qd Tc]
Seat 2: 4250e296 folded before Flop
Seat 3: 82b58c39 folded on the Flop
Seat 4: a5661ff2 showed [6d 6s] and lost with Pair of Sixes
Seat 5: Hero (button) folded before Flop
Seat 6: 11fc0ba8 (small blind) folded on the Flop
Seat 7: bd8abd3 (big blind) folded on the Flop
Seat 8: 3ed018f9 showed [6c Jc] and won (7,260) with Pair of Jacks


Poker Hand #TM3449965355: Tournament #149964808, Bounty Hunters Special $1.08 Hold'em No Limit - Level10(300/600) - 2024/07/03 22:20:45
Table '8' 8-max Seat #4 is the button
Seat 1: 37771df5 (8,432 in chips)
Seat 2: 4250e296 (36,297 in chips)
Seat 3: 82b58c39 (17,931 in chips)
Seat 4: a5661ff2 (7,640 in chips)
Seat 5: Hero (70,066 in chips)
Seat 6: 11fc0ba8 (123,652 in chips)
Seat 7: bd8abd3 (68,751 in chips)
Seat 8: 3ed018f9 (25,357 in chips)
37771df5: posts the ante 90
a5661ff2: posts the ante 90
82b58c39: posts the ante 90
4250e296: posts the ante 90
11fc0ba8: posts the ante 90
3ed018f9: posts the ante 90
Hero: posts the ante 90
bd8abd3: posts the ante 90
Hero: posts small blind 300
11fc0ba8: posts big blind 600
*** HOLE CARDS ***
Dealt to 37771df5 
Dealt to 4250e296 
Dealt to 82b58c39 
Dealt to a5661ff2 
Dealt to Hero [Ts As]
Dealt to 11fc0ba8 
Dealt to bd8abd3 
Dealt to 3ed018f9 
bd8abd3: folds
3ed018f9: raises 1,200 to 1,800
37771df5: raises 1,200 to 3,000
4250e296: folds
82b58c39: folds
a5661ff2: raises 4,550 to 7,550 and is all-in
Hero: raises 4,550 to 12,100
11fc0ba8: folds
3ed018f9: raises 13,167 to 25,267 and is all-in
37771df5: calls 5,342 and is all-in
Hero: calls 13,167
3ed018f9: shows [Qs Ac]
37771df5: shows [Kd Kc]
a5661ff2: shows [Ad Qd]
Hero: shows [Ts As]
*** FLOP *** [Jc 5d 4h]
*** TURN *** [Jc 5d 4h] [Ah]
*** RIVER *** [Jc 5d 4h Ah] [6h]
*** SHOWDOWN ***
3ed018f9 collected 15,760 from pot
a5661ff2 collected 15,760 from pot
3ed018f9 collected 2,376 from pot
3ed018f9 collected 33,850 from pot
*** SUMMARY ***
Total pot 67,746 | Rake 0 | Jackpot 0 | Bingo 0 | Fortune 0 | Tax 0
Board [Jc 5d 4h Ah 6h]
Seat 1: 37771df5 showed [Kd Kc] and lost with Pair of Kings
Seat 2: 4250e296 folded before Flop
Seat 3: 82b58c39 folded before Flop
Seat 4: a5661ff2 (button) showed [Ad Qd] and won (15,760) with Pair of Aces
Seat 5: Hero (small blind) showed [Ts As] and lost with Pair of Aces
Seat 6: 11fc0ba8 (big blind) folded before Flop
Seat 7: bd8abd3 folded before Flop
Seat 8: 3ed018f9 showed [Qs Ac] and won (51,986) with Pair of Aces


Poker Hand #TM3449965344: Tournament #149964808, Bounty Hunters Special $1.08 Hold'em No Limit - Level10(300/600) - 2024/07/03 22:20:30
Table '8' 8-max Seat #3 is the button
Seat 1: 37771df5 (8,522 in chips)
Seat 2: 4250e296 (36,387 in chips)
Seat 3: 82b58c39 (18,021 in chips)
Seat 4: a5661ff2 (8,030 in chips)
Seat 5: Hero (70,756 in chips)
Seat 6: 11fc0ba8 (123,742 in chips)
Seat 7: bd8abd3 (68,841 in chips)
Seat 8: 3ed018f9 (23,827 in chips)
37771df5: posts the ante 90
a5661ff2: posts the ante 90
82b58c39: posts the ante 90
4250e296: posts the ante 90
11fc0ba8: posts the ante 90
3ed018f9: posts the ante 90
Hero: posts the ante 90
bd8abd3: posts the ante 90
a5661ff2: posts small blind 300
Hero: posts big blind 600
*** HOLE CARDS ***
Dealt to 37771df5 
Dealt to 4250e296 
Dealt to 82b58c39 
Dealt to a5661ff2 
Dealt to Hero [5h 3c]
Dealt to 11fc0ba8 
Dealt to bd8abd3 
Dealt to 3ed018f9 
11fc0ba8: folds
bd8abd3: folds
3ed018f9: raises 600 to 1,200
37771df5: folds
4250e296: folds
82b58c39: folds
a5661ff2: folds
Hero: folds
Uncalled bet (600) returned to 3ed018f9
*** SHOWDOWN ***
3ed018f9 collected 2,220 from pot
*** SUMMARY ***
Total pot 2,220 | Rake 0 | Jackpot 0 | Bingo 0 | Fortune 0 | Tax 0
Seat 1: 37771df5 folded before Flop
Seat 2: 4250e296 folded before Flop
Seat 3: 82b58c39 (button) folded before Flop
Seat 4: a5661ff2 (small blind) folded before Flop
Seat 5: Hero (big blind) folded before Flop
Seat 6: 11fc0ba8 folded before Flop
Seat 7: bd8abd3 folded before Flop
Seat 8: 3ed018f9 collected (2,220)


Poker Hand #TM3449965321: Tournament #149964808, Bounty Hunters Special $1.08 Hold'em No Limit - Level10(300/600) - 2024/07/03 22:20:02
Table '8' 8-max Seat #2 is the button
Seat 1: 37771df5 (9,812 in chips)
Seat 2: 4250e296 (36,477 in chips)
Seat 3: 82b58c39 (13,791 in chips)
Seat 4: a5661ff2 (8,720 in chips)
Seat 5: Hero (71,446 in chips)
Seat 6: 11fc0ba8 (123,832 in chips)
Seat 7: bd8abd3 (68,931 in chips)
Seat 8: 3ed018f9 (25,117 in chips)
37771df5: posts the ante 90
a5661ff2: posts the ante 90
4250e296: posts the ante 90
82b58c39: posts the ante 90
11fc0ba8: posts the ante 90
3ed018f9: posts the ante 90
Hero: posts the ante 90
bd8abd3: posts the ante 90
82b58c39: posts small blind 300
a5661ff2: posts big blind 600
*** HOLE CARDS ***
Dealt to 37771df5 
Dealt to 4250e296 
Dealt to 82b58c39 
Dealt to a5661ff2 
Dealt to Hero [4h 5h]
Dealt to 11fc0ba8 
Dealt to bd8abd3 
Dealt to 3ed018f9 
Hero: calls 600
11fc0ba8: folds
bd8abd3: folds
3ed018f9: raises 600 to 1,200
37771df5: calls 1,200
4250e296: folds
82b58c39: raises 12,501 to 13,701 and is all-in
a5661ff2: folds
Hero: folds
3ed018f9: folds
37771df5: folds
Uncalled bet (12,501) returned to 82b58c39
*** SHOWDOWN ***
82b58c39 collected 5,520 from pot
*** SUMMARY ***
Total pot 5,520 | Rake 0 | Jackpot 0 | Bingo 0 | Fortune 0 | Tax 0
Seat 1: 37771df5 folded before Flop
Seat 2: 4250e296 (button) folded before Flop
Seat 3: 82b58c39 (small blind) collected (5,520)
Seat 4: a5661ff2 (big blind) folded before Flop
Seat 5: Hero folded before Flop
Seat 6: 11fc0ba8 folded before Flop
Seat 7: bd8abd3 folded before Flop
Seat 8: 3ed018f9 folded before Flop


Poker Hand #TM3449965289: Tournament #149964808, Bounty Hunters Special $1.08 Hold'em No Limit - Level10(300/600) - 2024/07/03 22:19:34
Table '8' 8-max Seat #1 is the button
Seat 1: 37771df5 (11,102 in chips)
Seat 2: 4250e296 (36,867 in chips)
Seat 3: 82b58c39 (11,661 in chips)
Seat 4: a5661ff2 (8,810 in chips)
Seat 5: Hero (71,536 in chips)
Seat 6: 11fc0ba8 (123,922 in chips)
Seat 7: bd8abd3 (69,021 in chips)
Seat 8: 3ed018f9 (25,207 in chips)
37771df5: posts the ante 90
a5661ff2: posts the ante 90
82b58c39: posts the ante 90
4250e296: posts the ante 90
11fc0ba8: posts the ante 90
3ed018f9: posts the ante 90
Hero: posts the ante 90
bd8abd3: posts the ante 90
4250e296: posts small blind 300
82b58c39: posts big blind 600
*** HOLE CARDS ***
Dealt to 37771df5 
Dealt to 4250e296 
Dealt to 82b58c39 
Dealt to a5661ff2 
Dealt to Hero [Th 5h]
Dealt to 11fc0ba8 
Dealt to bd8abd3 
Dealt to 3ed018f9 
a5661ff2: folds
Hero: folds
11fc0ba8: folds
bd8abd3: folds
3ed018f9: folds
37771df5: raises 600 to 1,200
4250e296: folds
82b58c39: raises 10,371 to 11,571 and is all-in
37771df5: folds
Uncalled bet (10,371) returned to 82b58c39
*** SHOWDOWN ***
82b58c39 collected 3,420 from pot
*** SUMMARY ***
Total pot 3,420 | Rake 0 | Jackpot 0 | Bingo 0 | Fortune 0 | Tax 0
Seat 1: 37771df5 (button) folded before Flop
Seat 2: 4250e296 (small blind) folded before Flop
Seat 3: 82b58c39 (big blind) collected (3,420)
Seat 4: a5661ff2 folded before Flop
Seat 5: Hero folded before Flop
Seat 6: 11fc0ba8 folded before Flop
Seat 7: bd8abd3 folded before Flop
Seat 8: 3ed018f9 folded before Flop


Poker Hand #TM3449965262: Tournament #149964808, Bounty Hunters Special $1.08 Hold'em No Limit - Level10(300/600) - 2024/07/03 22:18:59
Table '8' 8-max Seat #8 is the button
Seat 1: 37771df5 (11,492 in chips)
Seat 2: 4250e296 (38,337 in chips)
Seat 3: 82b58c39 (11,751 in chips)
Seat 4: a5661ff2 (8,900 in chips)
Seat 5: Hero (71,626 in chips)
Seat 6: 11fc0ba8 (121,612 in chips)
Seat 7: bd8abd3 (69,111 in chips)
Seat 8: 3ed018f9 (25,297 in chips)
37771df5: posts the ante 90
a5661ff2: posts the ante 90
82b58c39: posts the ante 90
4250e296: posts the ante 90
11fc0ba8: posts the ante 90
3ed018f9: posts the ante 90
Hero: posts the ante 90
bd8abd3: posts the ante 90
37771df5: posts small blind 300
4250e296: posts big blind 600
*** HOLE CARDS ***
Dealt to 37771df5 
Dealt to 4250e296 
Dealt to 82b58c39 
Dealt to a5661ff2 
Dealt to Hero [Qs 5d]
Dealt to 11fc0ba8 
Dealt to bd8abd3 
Dealt to 3ed018f9 
82b58c39: folds
a5661ff2: folds
Hero: folds
11fc0ba8: raises 780 to 1,380
bd8abd3: folds
3ed018f9: folds
37771df5: folds
4250e296: calls 780
*** FLOP *** [6d Kd 5s]
4250e296: checks
11fc0ba8: bets 2,117
4250e296: folds
Uncalled bet (2,117) returned to 11fc0ba8
*** SHOWDOWN ***
11fc0ba8 collected 3,780 from pot
*** SUMMARY ***
Total pot 3,780 | Rake 0 | Jackpot 0 | Bingo 0 | Fortune 0 | Tax 0
Board [6d Kd 5s]
Seat 1: 37771df5 (small blind) folded before Flop
Seat 2: 4250e296 (big blind) folded on the Flop
Seat 3: 82b58c39 folded before Flop
Seat 4: a5661ff2 folded before Flop
Seat 5: Hero folded before Flop
Seat 6: 11fc0ba8 won (3,780)
Seat 7: bd8abd3 folded before Flop
Seat 8: 3ed018f9 (button) folded before Flop


Poker Hand #TM3449965211: Tournament #149964808, Bounty Hunters Special $1.08 Hold'em No Limit - Level10(300/600) - 2024/07/03 22:17:59
Table '8' 8-max Seat #7 is the button
Seat 1: 37771df5 (12,182 in chips)
Seat 2: 4250e296 (38,427 in chips)
Seat 3: 82b58c39 (12,441 in chips)
Seat 4: a5661ff2 (8,990 in chips)
Seat 5: Hero (71,716 in chips)
Seat 6: 11fc0ba8 (119,182 in chips)
Seat 7: bd8abd3 (69,201 in chips)
Seat 8: 3ed018f9 (25,987 in chips)
37771df5: posts the ante 90
a5661ff2: posts the ante 90
82b58c39: posts the ante 90
4250e296: posts the ante 90
11fc0ba8: posts the ante 90
3ed018f9: posts the ante 90
Hero: posts the ante 90
bd8abd3: posts the ante 90
3ed018f9: posts small blind 300
37771df5: posts big blind 600
*** HOLE CARDS ***
Dealt to 37771df5 
Dealt to 4250e296 
Dealt to 82b58c39 
Dealt to a5661ff2 
Dealt to Hero [3h 7d]
Dealt to 11fc0ba8 
Dealt to bd8abd3 
Dealt to 3ed018f9 
4250e296: folds
82b58c39: calls 600
a5661ff2: folds
Hero: folds
11fc0ba8: calls 600
bd8abd3: folds
3ed018f9: calls 300
37771df5: checks
*** FLOP *** [Tc 4d Qc]
3ed018f9: checks
37771df5: checks
82b58c39: checks
11fc0ba8: checks
*** TURN *** [Tc 4d Qc] [9h]
3ed018f9: checks
37771df5: checks
82b58c39: checks
11fc0ba8: checks
*** RIVER *** [Tc 4d Qc 9h] [2d]
3ed018f9: checks
37771df5: checks
82b58c39: checks
11fc0ba8: checks
3ed018f9: shows [3c 8d] (Queen-High)
37771df5: shows [3s 4c] (Pair of Fours)
82b58c39: shows [6d Ah] (Ace-High)
11fc0ba8: shows [3d 9d] (Pair of Nines)
*** SHOWDOWN ***
11fc0ba8 collected 3,120 from pot
*** SUMMARY ***
Total pot 3,120 | Rake 0 | Jackpot 0 | Bingo 0 | Fortune 0 | Tax 0
Board [Tc 4d Qc 9h 2d]
Seat 1: 37771df5 (big blind) showed [3s 4c] and lost with Pair of Fours
Seat 2: 4250e296 folded before Flop
Seat 3: 82b58c39 showed [6d Ah] and lost with Ace-High
Seat 4: a5661ff2 folded before Flop
Seat 5: Hero folded before Flop
Seat 6: 11fc0ba8 showed [3d 9d] and won (3,120) with Pair of Nines
Seat 7: bd8abd3 (button) folded before Flop
Seat 8: 3ed018f9 (small blind) showed [3c 8d] and lost with Queen-High


Poker Hand #TM3449965166: Tournament #149964808, Bounty Hunters Special $1.08 Hold'em No Limit - Level10(300/600) - 2024/07/03 22:17:05
Table '8' 8-max Seat #6 is the button
Seat 1: 37771df5 (12,272 in chips)
Seat 2: 4250e296 (38,517 in chips)
Seat 3: 82b58c39 (12,531 in chips)
Seat 4: a5661ff2 (9,080 in chips)
Seat 5: Hero (77,970 in chips)
Seat 6: 11fc0ba8 (119,272 in chips)
Seat 7: bd8abd3 (69,591 in chips)
Seat 8: 3ed018f9 (18,893 in chips)
37771df5: posts the ante 90
a5661ff2: posts the ante 90
82b58c39: posts the ante 90
4250e296: posts the ante 90
11fc0ba8: posts the ante 90
3ed018f9: posts the ante 90
Hero: posts the ante 90
bd8abd3: posts the ante 90
bd8abd3: posts small blind 300
3ed018f9: posts big blind 600
*** HOLE CARDS ***
Dealt to 37771df5 
Dealt to 4250e296 
Dealt to 82b58c39 
Dealt to a5661ff2 
Dealt to Hero [Kd Jh]
Dealt to 11fc0ba8 
Dealt to bd8abd3 
Dealt to 3ed018f9 
37771df5: folds
4250e296: folds
82b58c39: folds
a5661ff2: folds
Hero: raises 900 to 1,500
11fc0ba8: folds
bd8abd3: folds
3ed018f9: calls 900
*** FLOP *** [Js Qd 4c]
3ed018f9: checks
Hero: bets 1,327
3ed018f9: calls 1,327
*** TURN *** [Js Qd 4c] [Ts]
3ed018f9: checks
Hero: checks
*** RIVER *** [Js Qd 4c Ts] [8d]
3ed018f9: bets 3,337
Hero: calls 3,337
3ed018f9: shows [6s Qs] (Pair of Queens)
Hero: shows [Kd Jh] (Pair of Jacks)
*** SHOWDOWN ***
3ed018f9 collected 13,348 from pot
*** SUMMARY ***
Total pot 13,348 | Rake 0 | Jackpot 0 | Bingo 0 | Fortune 0 | Tax 0
Board [Js Qd 4c Ts 8d]
Seat 1: 37771df5 folded before Flop
Seat 2: 4250e296 folded before Flop
Seat 3: 82b58c39 folded before Flop
Seat 4: a5661ff2 folded before Flop
Seat 5: Hero showed [Kd Jh] and lost with Pair of Jacks
Seat 6: 11fc0ba8 (button) folded before Flop
Seat 7: bd8abd3 (small blind) folded before Flop
Seat 8: 3ed018f9 (big blind) showed [6s Qs] and won (13,348) with Pair of Queens


Poker Hand #TM3449965146: Tournament #149964808, Bounty Hunters Special $1.08 Hold'em No Limit - Level10(300/600) - 2024/07/03 22:16:41
Table '8' 8-max Seat #5 is the button
Seat 1: 37771df5 (12,362 in chips)
Seat 2: 4250e296 (38,607 in chips)
Seat 3: 82b58c39 (12,621 in chips)
Seat 4: a5661ff2 (7,550 in chips)
Seat 5: Hero (78,060 in chips)
Seat 6: 11fc0ba8 (119,662 in chips)
Seat 7: bd8abd3 (70,281 in chips)
Seat 8: 3ed018f9 (18,983 in chips)
37771df5: posts the ante 90
a5661ff2: posts the ante 90
82b58c39: posts the ante 90
4250e296: posts the ante 90
11fc0ba8: posts the ante 90
3ed018f9: posts the ante 90
Hero: posts the ante 90
bd8abd3: posts the ante 90
11fc0ba8: posts small blind 300
bd8abd3: posts big blind 600
*** HOLE CARDS ***
Dealt to 37771df5 
Dealt to 4250e296 
Dealt to 82b58c39 
Dealt to a5661ff2 
Dealt to Hero [Td 2h]
Dealt to 11fc0ba8 
Dealt to bd8abd3 
Dealt to 3ed018f9 
3ed018f9: folds
37771df5: folds
4250e296: folds
82b58c39: folds
a5661ff2: raises 6,600 to 7,200
Hero: folds
11fc0ba8: folds
bd8abd3: folds
Uncalled bet (6,600) returned to a5661ff2
*** SHOWDOWN ***
a5661ff2 collected 2,220 from pot
*** SUMMARY ***
Total pot 2,220 | Rake 0 | Jackpot 0 | Bingo 0 | Fortune 0 | Tax 0
Seat 1: 37771df5 folded before Flop
Seat 2: 4250e296 folded before Flop
Seat 3: 82b58c39 folded before Flop
Seat 4: a5661ff2 collected (2,220)
Seat 5: Hero (button) folded before Flop
Seat 6: 11fc0ba8 (small blind) folded before Flop
Seat 7: bd8abd3 (big blind) folded before Flop
Seat 8: 3ed018f9 folded before Flop


Poker Hand #TM3449965099: Tournament #149964808, Bounty Hunters Special $1.08 Hold'em No Limit - Level10(300/600) - 2024/07/03 22:15:52
Table '8' 8-max Seat #4 is the button
Seat 1: 37771df5 (13,652 in chips)
Seat 2: 4250e296 (38,697 in chips)
Seat 3: 82b58c39 (13,911 in chips)
Seat 4: a5661ff2 (7,640 in chips)
Seat 5: Hero (73,830 in chips)
Seat 6: 11fc0ba8 (120,952 in chips)
Seat 7: bd8abd3 (70,371 in chips)
Seat 8: 3ed018f9 (19,073 in chips)
37771df5: posts the ante 90
a5661ff2: posts the ante 90
82b58c39: posts the ante 90
4250e296: posts the ante 90
11fc0ba8: posts the ante 90
3ed018f9: posts the ante 90
Hero: posts the ante 90
bd8abd3: posts the ante 90
Hero: posts small blind 300
11fc0ba8: posts big blind 600
*** HOLE CARDS ***
Dealt to 37771df5 
Dealt to 4250e296 
Dealt to 82b58c39 
Dealt to a5661ff2 
Dealt to Hero [8s 7d]
Dealt to 11fc0ba8 
Dealt to bd8abd3 
Dealt to 3ed018f9 
bd8abd3: folds
3ed018f9: folds
37771df5: raises 600 to 1,200
4250e296: folds
82b58c39: calls 1,200
a5661ff2: folds
Hero: calls 900
11fc0ba8: calls 600
*** FLOP *** [6h Ac 8h]
Hero: bets 1,200
11fc0ba8: folds
37771df5: folds
82b58c39: folds
Uncalled bet (1,200) returned to Hero
*** SHOWDOWN ***
Hero collected 5,520 from pot
*** SUMMARY ***
Total pot 5,520 | Rake 0 | Jackpot 0 | Bingo 0 | Fortune 0 | Tax 0
Board [6h Ac 8h]
Seat 1: 37771df5 folded on the Flop
Seat 2: 4250e296 folded before Flop
Seat 3: 82b58c39 folded on the Flop
Seat 4: a5661ff2 (button) folded before Flop
Seat 5: Hero (small blind) won (5,520)
Seat 6: 11fc0ba8 (big blind) folded on the Flop
Seat 7: bd8abd3 folded before Flop
Seat 8: 3ed018f9 folded before Flop


Poker Hand #TM3449965071: Tournament #149964808, Bounty Hunters Special $1.08 Hold'em No Limit - Level10(300/600) - 2024/07/03 22:15:17
Table '8' 8-max Seat #3 is the button
Seat 1: 37771df5 (13,742 in chips)
Seat 2: 4250e296 (38,787 in chips)
Seat 3: 82b58c39 (14,001 in chips)
Seat 4: a5661ff2 (8,030 in chips)
Seat 5: Hero (74,520 in chips)
Seat 6: 11fc0ba8 (119,422 in chips)
Seat 7: bd8abd3 (70,461 in chips)
Seat 8: 3ed018f9 (19,163 in chips)
37771df5: posts the ante 90
a5661ff2: posts the ante 90
82b58c39: posts the ante 90
4250e296: posts the ante 90
11fc0ba8: posts the ante 90
3ed018f9: posts the ante 90
Hero: posts the ante 90
bd8abd3: posts the ante 90
a5661ff2: posts small blind 300
Hero: posts big blind 600
*** HOLE CARDS ***
Dealt to 37771df5 
Dealt to 4250e296 
Dealt to 82b58c39 
Dealt to a5661ff2 
Dealt to Hero [4d Kc]
Dealt to 11fc0ba8 
Dealt to bd8abd3 
Dealt to 3ed018f9 
11fc0ba8: raises 780 to 1,380
bd8abd3: folds
3ed018f9: folds
37771df5: folds
4250e296: folds
82b58c39: folds
a5661ff2: folds
Hero: folds
Uncalled bet (780) returned to 11fc0ba8
*** SHOWDOWN ***
11fc0ba8 collected 2,220 from pot
*** SUMMARY ***
Total pot 2,220 | Rake 0 | Jackpot 0 | Bingo 0 | Fortune 0 | Tax 0
Seat 1: 37771df5 folded before Flop
Seat 2: 4250e296 folded before Flop
Seat 3: 82b58c39 (button) folded before Flop
Seat 4: a5661ff2 (small blind) folded before Flop
Seat 5: Hero (big blind) folded before Flop
Seat 6: 11fc0ba8 collected (2,220)
Seat 7: bd8abd3 folded before Flop
Seat 8: 3ed018f9 folded before Flop


Poker Hand #TM3449965042: Tournament #149964808, Bounty Hunters Special $1.08 Hold'em No Limit - Level9(250/500) - 2024/07/03 22:14:41
Table '8' 8-max Seat #2 is the button
Seat 1: 37771df5 (13,817 in chips)
Seat 2: 4250e296 (38,862 in chips)
Seat 3: 82b58c39 (11,976 in chips)
Seat 4: a5661ff2 (8,605 in chips)
Seat 5: Hero (74,595 in chips)
Seat 6: 11fc0ba8 (119,497 in chips)
Seat 7: bd8abd3 (70,536 in chips)
Seat 8: 3ed018f9 (20,238 in chips)
37771df5: posts the ante 75
a5661ff2: posts the ante 75
4250e296: posts the ante 75
82b58c39: posts the ante 75
11fc0ba8: posts the ante 75
3ed018f9: posts the ante 75
Hero: posts the ante 75
bd8abd3: posts the ante 75
82b58c39: posts small blind 250
a5661ff2: posts big blind 500
*** HOLE CARDS ***
Dealt to 37771df5 
Dealt to 4250e296 
Dealt to 82b58c39 
Dealt to a5661ff2 
Dealt to Hero [5s Qc]
Dealt to 11fc0ba8 
Dealt to bd8abd3 
Dealt to 3ed018f9 
Hero: folds
11fc0ba8: folds
bd8abd3: folds
3ed018f9: raises 500 to 1,000
37771df5: folds
4250e296: folds
82b58c39: raises 10,901 to 11,901 and is all-in
a5661ff2: folds
3ed018f9: folds
Uncalled bet (10,901) returned to 82b58c39
*** SHOWDOWN ***
82b58c39 collected 3,100 from pot
*** SUMMARY ***
Total pot 3,100 | Rake 0 | Jackpot 0 | Bingo 0 | Fortune 0 | Tax 0
Seat 1: 37771df5 folded before Flop
Seat 2: 4250e296 (button) folded before Flop
Seat 3: 82b58c39 (small blind) collected (3,100)
Seat 4: a5661ff2 (big blind) folded before Flop
Seat 5: Hero folded before Flop
Seat 6: 11fc0ba8 folded before Flop
Seat 7: bd8abd3 folded before Flop
Seat 8: 3ed018f9 folded before Flop


Poker Hand #TM3449965010: Tournament #149964808, Bounty Hunters Special $1.08 Hold'em No Limit - Level9(250/500) - 2024/07/03 22:14:08
Table '8' 8-max Seat #1 is the button
Seat 1: 37771df5 (13,892 in chips)
Seat 2: 4250e296 (39,187 in chips)
Seat 3: 82b58c39 (12,551 in chips)
Seat 4: a5661ff2 (8,680 in chips)
Seat 5: Hero (70,145 in chips)
Seat 6: 11fc0ba8 (119,572 in chips)
Seat 7: bd8abd3 (70,611 in chips)
Seat 8: 3ed018f9 (23,488 in chips)
37771df5: posts the ante 75
a5661ff2: posts the ante 75
82b58c39: posts the ante 75
4250e296: posts the ante 75
11fc0ba8: posts the ante 75
3ed018f9: posts the ante 75
Hero: posts the ante 75
bd8abd3: posts the ante 75
4250e296: posts small blind 250
82b58c39: posts big blind 500
*** HOLE CARDS ***
Dealt to 37771df5 
Dealt to 4250e296 
Dealt to 82b58c39 
Dealt to a5661ff2 
Dealt to Hero [Js Ks]
Dealt to 11fc0ba8 
Dealt to bd8abd3 
Dealt to 3ed018f9 
a5661ff2: folds
Hero: raises 750 to 1,250
11fc0ba8: folds
bd8abd3: folds
3ed018f9: raises 1,925 to 3,175
37771df5: folds
4250e296: folds
82b58c39: folds
Hero: calls 1,925
*** FLOP *** [Qd 6h 8d]
Hero: checks
3ed018f9: checks
*** TURN *** [Qd 6h 8d] [4c]
Hero: bets 2,541
3ed018f9: folds
Uncalled bet (2,541) returned to Hero
*** SHOWDOWN ***
Hero collected 7,700 from pot
*** SUMMARY ***
Total pot 7,700 | Rake 0 | Jackpot 0 | Bingo 0 | Fortune 0 | Tax 0
Board [Qd 6h 8d 4c]
Seat 1: 37771df5 (button) folded before Flop
Seat 2: 4250e296 (small blind) folded before Flop
Seat 3: 82b58c39 (big blind) folded before Flop
Seat 4: a5661ff2 folded before Flop
Seat 5: Hero won (7,700)
Seat 6: 11fc0ba8 folded before Flop
Seat 7: bd8abd3 folded before Flop
Seat 8: 3ed018f9 folded on the Turn


Poker Hand #TM3449964979: Tournament #149964808, Bounty Hunters Special $1.08 Hold'em No Limit - Level9(250/500) - 2024/07/03 22:13:31
Table '8' 8-max Seat #8 is the button
Seat 1: 37771df5 (14,467 in chips)
Seat 2: 4250e296 (38,162 in chips)
Seat 3: 82b58c39 (12,626 in chips)
Seat 4: a5661ff2 (8,755 in chips)
Seat 5: Hero (70,220 in chips)
Seat 6: 11fc0ba8 (119,647 in chips)
Seat 7: bd8abd3 (70,686 in chips)
Seat 8: 3ed018f9 (23,563 in chips)
37771df5: posts the ante 75
a5661ff2: posts the ante 75
82b58c39: posts the ante 75
4250e296: posts the ante 75
11fc0ba8: posts the ante 75
3ed018f9: posts the ante 75
Hero: posts the ante 75
bd8abd3: posts the ante 75
37771df5: posts small blind 250
4250e296: posts big blind 500
*** HOLE CARDS ***
Dealt to 37771df5 
Dealt to 4250e296 
Dealt to 82b58c39 
Dealt to a5661ff2 
Dealt to Hero [8c Jh]
Dealt to 11fc0ba8 
Dealt to bd8abd3 
Dealt to 3ed018f9 
82b58c39: folds
a5661ff2: folds
Hero: folds
11fc0ba8: folds
bd8abd3: folds
3ed018f9: folds
37771df5: calls 250
4250e296: checks
*** FLOP *** [5d Kh 2d]
37771df5: checks
4250e296: checks
*** TURN *** [5d Kh 2d] [4c]
37771df5: checks
4250e296: bets 1,500
37771df5: folds
Uncalled bet (1,500) returned to 4250e296
*** SHOWDOWN ***
4250e296 collected 1,600 from pot
*** SUMMARY ***
Total pot 1,600 | Rake 0 | Jackpot 0 | Bingo 0 | Fortune 0 | Tax 0
Board [5d Kh 2d 4c]
Seat 1: 37771df5 (small blind) folded on the Turn
Seat 2: 4250e296 (big blind) won (1,600)
Seat 3: 82b58c39 folded before Flop
Seat 4: a5661ff2 folded before Flop
Seat 5: Hero folded before Flop
Seat 6: 11fc0ba8 folded before Flop
Seat 7: bd8abd3 folded before Flop
Seat 8: 3ed018f9 (button) folded before Flop


Poker Hand #TM3449964961: Tournament #149964808, Bounty Hunters Special $1.08 Hold'em No Limit - Level9(250/500) - 2024/07/03 22:13:10
Table '8' 8-max Seat #7 is the button
Seat 1: 37771df5 (15,042 in chips)
Seat 2: 4250e296 (38,237 in chips)
Seat 3: 82b58c39 (12,701 in chips)
Seat 4: a5661ff2 (8,830 in chips)
Seat 5: Hero (70,295 in chips)
Seat 6: 11fc0ba8 (118,372 in chips)
Seat 7: bd8abd3 (70,761 in chips)
Seat 8: 3ed018f9 (23,888 in chips)
37771df5: posts the ante 75
a5661ff2: posts the ante 75
82b58c39: posts the ante 75
4250e296: posts the ante 75
11fc0ba8: posts the ante 75
3ed018f9: posts the ante 75
Hero: posts the ante 75
bd8abd3: posts the ante 75
3ed018f9: posts small blind 250
37771df5: posts big blind 500
*** HOLE CARDS ***
Dealt to 37771df5 
Dealt to 4250e296 
Dealt to 82b58c39 
Dealt to a5661ff2 
Dealt to Hero [2d 3s]
Dealt to 11fc0ba8 
Dealt to bd8abd3 
Dealt to 3ed018f9 
4250e296: folds
82b58c39: folds
a5661ff2: folds
Hero: folds
11fc0ba8: raises 650 to 1,150
bd8abd3: folds
3ed018f9: folds
37771df5: folds
Uncalled bet (650) returned to 11fc0ba8
*** SHOWDOWN ***
11fc0ba8 collected 1,850 from pot
*** SUMMARY ***
Total pot 1,850 | Rake 0 | Jackpot 0 | Bingo 0 | Fortune 0 | Tax 0
Seat 1: 37771df5 (big blind) folded before Flop
Seat 2: 4250e296 folded before Flop
Seat 3: 82b58c39 folded before Flop
Seat 4: a5661ff2 folded before Flop
Seat 5: Hero folded before Flop
Seat 6: 11fc0ba8 collected (1,850)
Seat 7: bd8abd3 (button) folded before Flop
Seat 8: 3ed018f9 (small blind) folded before Flop


Poker Hand #TM3449964918: Tournament #149964808, Bounty Hunters Special $1.08 Hold'em No Limit - Level9(250/500) - 2024/07/03 22:12:16
Table '8' 8-max Seat #6 is the button
Seat 1: 37771df5 (15,117 in chips)
Seat 2: 4250e296 (38,312 in chips)
Seat 3: 82b58c39 (12,776 in chips)
Seat 4: a5661ff2 (8,905 in chips)
Seat 5: Hero (70,370 in chips)
Seat 6: 11fc0ba8 (115,407 in chips)
Seat 7: bd8abd3 (71,086 in chips)
Seat 8: 3ed018f9 (26,153 in chips)
37771df5: posts the ante 75
a5661ff2: posts the ante 75
82b58c39: posts the ante 75
4250e296: posts the ante 75
11fc0ba8: posts the ante 75
3ed018f9: posts the ante 75
Hero: posts the ante 75
bd8abd3: posts the ante 75
bd8abd3: posts small blind 250
3ed018f9: posts big blind 500
*** HOLE CARDS ***
Dealt to 37771df5 
Dealt to 4250e296 
Dealt to 82b58c39 
Dealt to a5661ff2 
Dealt to Hero [7c 6h]
Dealt to 11fc0ba8 
Dealt to bd8abd3 
Dealt to 3ed018f9 
37771df5: folds
4250e296: folds
82b58c39: folds
a5661ff2: folds
Hero: folds
11fc0ba8: raises 650 to 1,150
bd8abd3: folds
3ed018f9: calls 650
*** FLOP *** [Kh Kc 7h]
3ed018f9: checks
11fc0ba8: checks
*** TURN *** [Kh Kc 7h] [Qs]
3ed018f9: checks
11fc0ba8: bets 1,040
3ed018f9: calls 1,040
*** RIVER *** [Kh Kc 7h Qs] [9c]
3ed018f9: checks
11fc0ba8: checks
3ed018f9: shows [2d 2c] (Pair of Kings and Pair of Twos)
11fc0ba8: shows [As 7s] (Pair of Kings and Pair of Sevens)
*** SHOWDOWN ***
11fc0ba8 collected 5,230 from pot
*** SUMMARY ***
Total pot 5,230 | Rake 0 | Jackpot 0 | Bingo 0 | Fortune 0 | Tax 0
Board [Kh Kc 7h Qs 9c]
Seat 1: 37771df5 folded before Flop
Seat 2: 4250e296 folded before Flop
Seat 3: 82b58c39 folded before Flop
Seat 4: a5661ff2 folded before Flop
Seat 5: Hero folded before Flop
Seat 6: 11fc0ba8 (button) showed [As 7s] and won (5,230) with Pair of Kings and Pair of Sevens
Seat 7: bd8abd3 (small blind) folded before Flop
Seat 8: 3ed018f9 (big blind) showed [2d 2c] and lost with Pair of Kings and Pair of Twos


Poker Hand #TM3449964881: Tournament #149964808, Bounty Hunters Special $1.08 Hold'em No Limit - Level9(250/500) - 2024/07/03 22:11:35
Table '8' 8-max Seat #5 is the button
Seat 1: 37771df5 (11,667 in chips)
Seat 2: 4250e296 (38,387 in chips)
Seat 3: 82b58c39 (12,851 in chips)
Seat 4: a5661ff2 (8,980 in chips)
Seat 5: Hero (70,445 in chips)
Seat 6: 11fc0ba8 (115,732 in chips)
Seat 7: bd8abd3 (71,661 in chips)
Seat 8: 3ed018f9 (28,403 in chips)
37771df5: posts the ante 75
a5661ff2: posts the ante 75
82b58c39: posts the ante 75
4250e296: posts the ante 75
11fc0ba8: posts the ante 75
3ed018f9: posts the ante 75
Hero: posts the ante 75
bd8abd3: posts the ante 75
11fc0ba8: posts small blind 250
bd8abd3: posts big blind 500
*** HOLE CARDS ***
Dealt to 37771df5 
Dealt to 4250e296 
Dealt to 82b58c39 
Dealt to a5661ff2 
Dealt to Hero [Ad 9c]
Dealt to 11fc0ba8 
Dealt to bd8abd3 
Dealt to 3ed018f9 
3ed018f9: calls 500
37771df5: raises 1,675 to 2,175
4250e296: folds
82b58c39: folds
a5661ff2: folds
Hero: folds
11fc0ba8: folds
bd8abd3: folds
3ed018f9: calls 1,675
*** FLOP *** [8h 2d 3c]
3ed018f9: checks
37771df5: bets 4,275
3ed018f9: folds
Uncalled bet (4,275) returned to 37771df5
*** SHOWDOWN ***
37771df5 collected 5,700 from pot
*** SUMMARY ***
Total pot 5,700 | Rake 0 | Jackpot 0 | Bingo 0 | Fortune 0 | Tax 0
Board [8h 2d 3c]
Seat 1: 37771df5 won (5,700)
Seat 2: 4250e296 folded before Flop
Seat 3: 82b58c39 folded before Flop
Seat 4: a5661ff2 folded before Flop
Seat 5: Hero (button) folded before Flop
Seat 6: 11fc0ba8 (small blind) folded before Flop
Seat 7: bd8abd3 (big blind) folded before Flop
Seat 8: 3ed018f9 folded on the Flop


Poker Hand #TM3449964820: Tournament #149964808, Bounty Hunters Special $1.08 Hold'em No Limit - Level9(250/500) - 2024/07/03 22:10:30
Table '8' 8-max Seat #4 is the button
Seat 1: 37771df5 (12,742 in chips)
Seat 2: 4250e296 (44,135 in chips)
Seat 3: 82b58c39 (12,926 in chips)
Seat 4: a5661ff2 (9,055 in chips)
Seat 5: Hero (62,747 in chips)
Seat 6: 11fc0ba8 (116,307 in chips)
Seat 7: bd8abd3 (71,736 in chips)
Seat 8: 3ed018f9 (28,478 in chips)
37771df5: posts the ante 75
a5661ff2: posts the ante 75
82b58c39: posts the ante 75
4250e296: posts the ante 75
11fc0ba8: posts the ante 75
3ed018f9: posts the ante 75
Hero: posts the ante 75
bd8abd3: posts the ante 75
Hero: posts small blind 250
11fc0ba8: posts big blind 500
*** HOLE CARDS ***
Dealt to 37771df5 
Dealt to 4250e296 
Dealt to 82b58c39 
Dealt to a5661ff2 
Dealt to Hero [Qc Qs]
Dealt to 11fc0ba8 
Dealt to bd8abd3 
Dealt to 3ed018f9 
bd8abd3: folds
3ed018f9: folds
37771df5: raises 500 to 1,000
4250e296: raises 2,000 to 3,000
82b58c39: folds
a5661ff2: folds
Hero: calls 2,750
11fc0ba8: folds
37771df5: folds
*** FLOP *** [6c 5s 6h]
Hero: checks
4250e296: bets 2,673
Hero: calls 2,673
*** TURN *** [6c 5s 6h] [9h]
Hero: bets 6,723
4250e296: folds
Uncalled bet (6,723) returned to Hero
*** SHOWDOWN ***
Hero collected 13,446 from pot
*** SUMMARY ***
Total pot 13,446 | Rake 0 | Jackpot 0 | Bingo 0 | Fortune 0 | Tax 0
Board [6c 5s 6h 9h]
Seat 1: 37771df5 folded before Flop
Seat 2: 4250e296 folded on the Turn
Seat 3: 82b58c39 folded before Flop
Seat 4: a5661ff2 (button) folded before Flop
Seat 5: Hero (small blind) won (13,446)
Seat 6: 11fc0ba8 (big blind) folded before Flop
Seat 7: bd8abd3 folded before Flop
Seat 8: 3ed018f9 folded before Flop


Poker Hand #TM3449964765: Tournament #149964808, Bounty Hunters Special $1.08 Hold'em No Limit - Level9(250/500) - 2024/07/03 22:09:27
Table '8' 8-max Seat #3 is the button
Seat 1: 37771df5 (17,580 in chips)
Seat 2: 4250e296 (44,210 in chips)
Seat 3: 82b58c39 (13,001 in chips)
Seat 4: a5661ff2 (9,380 in chips)
Seat 5: Hero (63,322 in chips)
Seat 6: 11fc0ba8 (116,382 in chips)
Seat 7: bd8abd3 (71,811 in chips)
Seat 8: 3ed018f9 (22,440 in chips)
37771df5: posts the ante 75
a5661ff2: posts the ante 75
82b58c39: posts the ante 75
4250e296: posts the ante 75
11fc0ba8: posts the ante 75
3ed018f9: posts the ante 75
Hero: posts the ante 75
bd8abd3: posts the ante 75
a5661ff2: posts small blind 250
Hero: posts big blind 500
*** HOLE CARDS ***
Dealt to 37771df5 
Dealt to 4250e296 
Dealt to 82b58c39 
Dealt to a5661ff2 
Dealt to Hero [7h 3h]
Dealt to 11fc0ba8 
Dealt to bd8abd3 
Dealt to 3ed018f9 
11fc0ba8: folds
bd8abd3: folds
3ed018f9: raises 1,000 to 1,500
37771df5: calls 1,500
4250e296: folds
82b58c39: folds
a5661ff2: folds
Hero: folds
*** FLOP *** [8c 2c 8s]
3ed018f9: checks
37771df5: checks
*** TURN *** [8c 2c 8s] [Tc]
3ed018f9: bets 3,263
37771df5: calls 3,263
*** RIVER *** [8c 2c 8s Tc] [2d]
3ed018f9: checks
37771df5: checks
3ed018f9: shows [Jc Kc] (King High Flush)
37771df5: shows [Ts Ks] (Pair of Tens and Pair of Eights)
*** SHOWDOWN ***
3ed018f9 collected 10,876 from pot
*** SUMMARY ***
Total pot 10,876 | Rake 0 | Jackpot 0 | Bingo 0 | Fortune 0 | Tax 0
Board [8c 2c 8s Tc 2d]
Seat 1: 37771df5 showed [Ts Ks] and lost with Pair of Tens and Pair of Eights
Seat 2: 4250e296 folded before Flop
Seat 3: 82b58c39 (button) folded before Flop
Seat 4: a5661ff2 (small blind) folded before Flop
Seat 5: Hero (big blind) folded before Flop
Seat 6: 11fc0ba8 folded before Flop
Seat 7: bd8abd3 folded before Flop
Seat 8: 3ed018f9 showed [Jc Kc] and won (10,876) with King High Flush


Poker Hand #TM3449964746: Tournament #149964808, Bounty Hunters Special $1.08 Hold'em No Limit - Level9(250/500) - 2024/07/03 22:09:09
Table '8' 8-max Seat #1 is the button
Seat 1: 37771df5 (17,655 in chips)
Seat 3: 82b58c39 (13,326 in chips)
Seat 4: a5661ff2 (8,680 in chips)
Seat 5: Hero (63,397 in chips)
Seat 6: 11fc0ba8 (116,457 in chips)
Seat 7: bd8abd3 (71,886 in chips)
Seat 8: 3ed018f9 (22,515 in chips)
37771df5: posts the ante 75
a5661ff2: posts the ante 75
82b58c39: posts the ante 75
11fc0ba8: posts the ante 75
3ed018f9: posts the ante 75
Hero: posts the ante 75
bd8abd3: posts the ante 75
82b58c39: posts small blind 250
a5661ff2: posts big blind 500
*** HOLE CARDS ***
Dealt to 37771df5 
Dealt to 82b58c39 
Dealt to a5661ff2 
Dealt to Hero [8c 9d]
Dealt to 11fc0ba8 
Dealt to bd8abd3 
Dealt to 3ed018f9 
Hero: folds
11fc0ba8: folds
bd8abd3: folds
3ed018f9: folds
37771df5: folds
82b58c39: folds
Uncalled bet (250) returned to a5661ff2
*** SHOWDOWN ***
a5661ff2 collected 1,025 from pot
*** SUMMARY ***
Total pot 1,025 | Rake 0 | Jackpot 0 | Bingo 0 | Fortune 0 | Tax 0
Seat 1: 37771df5 (button) folded before Flop
Seat 3: 82b58c39 (small blind) folded before Flop
Seat 4: a5661ff2 (big blind) collected (1,025)
Seat 5: Hero folded before Flop
Seat 6: 11fc0ba8 folded before Flop
Seat 7: bd8abd3 folded before Flop
Seat 8: 3ed018f9 folded before Flop


Poker Hand #TM3449964685: Tournament #149964808, Bounty Hunters Special $1.08 Hold'em No Limit - Level9(250/500) - 2024/07/03 22:08:05
Table '8' 8-max Seat #8 is the button
Seat 1: 37771df5 (22,237 in chips)
Seat 3: 82b58c39 (13,901 in chips)
Seat 4: a5661ff2 (8,755 in chips)
Seat 5: Hero (63,472 in chips)
Seat 6: 11fc0ba8 (109,850 in chips)
Seat 7: bd8abd3 (71,961 in chips)
Seat 8: 3ed018f9 (23,740 in chips)
37771df5: posts the ante 75
a5661ff2: posts the ante 75
82b58c39: posts the ante 75
11fc0ba8: posts the ante 75
3ed018f9: posts the ante 75
Hero: posts the ante 75
bd8abd3: posts the ante 75
37771df5: posts small blind 250
82b58c39: posts big blind 500
*** HOLE CARDS ***
Dealt to 37771df5 
Dealt to 82b58c39 
Dealt to a5661ff2 
Dealt to Hero [4s 2s]
Dealt to 11fc0ba8 
Dealt to bd8abd3 
Dealt to 3ed018f9 
a5661ff2: folds
Hero: folds
11fc0ba8: raises 650 to 1,150
bd8abd3: folds
3ed018f9: calls 1,150
37771df5: raises 3,357 to 4,507
82b58c39: folds
11fc0ba8: calls 3,357
3ed018f9: folds
*** FLOP *** [Kc 4h Qs]
37771df5: checks
11fc0ba8: checks
*** TURN *** [Kc 4h Qs] [As]
37771df5: checks
11fc0ba8: checks
*** RIVER *** [Kc 4h Qs As] [2d]
37771df5: checks
11fc0ba8: checks
37771df5: shows [Jh Js] (Pair of Jacks)
11fc0ba8: shows [Ad 7d] (Pair of Aces)
*** SHOWDOWN ***
11fc0ba8 collected 11,189 from pot
*** SUMMARY ***
Total pot 11,189 | Rake 0 | Jackpot 0 | Bingo 0 | Fortune 0 | Tax 0
Board [Kc 4h Qs As 2d]
Seat 1: 37771df5 (small blind) showed [Jh Js] and lost with Pair of Jacks
Seat 3: 82b58c39 (big blind) folded before Flop
Seat 4: a5661ff2 folded before Flop
Seat 5: Hero folded before Flop
Seat 6: 11fc0ba8 showed [Ad 7d] and won (11,189) with Pair of Aces
Seat 7: bd8abd3 folded before Flop
Seat 8: 3ed018f9 (button) folded before Flop


Poker Hand #TM3449964639: Tournament #149964808, Bounty Hunters Special $1.08 Hold'em No Limit - Level9(250/500) - 2024/07/03 22:07:15
Table '8' 8-max Seat #7 is the button
Seat 1: 37771df5 (22,812 in chips)
Seat 3: 82b58c39 (13,976 in chips)
Seat 4: a5661ff2 (8,830 in chips)
Seat 5: Hero (61,353 in chips)
Seat 6: 11fc0ba8 (109,925 in chips)
Seat 7: bd8abd3 (72,036 in chips)
Seat 8: 3ed018f9 (24,984 in chips)
37771df5: posts the ante 75
a5661ff2: posts the ante 75
82b58c39: posts the ante 75
11fc0ba8: posts the ante 75
3ed018f9: posts the ante 75
Hero: posts the ante 75
bd8abd3: posts the ante 75
3ed018f9: posts small blind 250
37771df5: posts big blind 500
*** HOLE CARDS ***
Dealt to 37771df5 
Dealt to 82b58c39 
Dealt to a5661ff2 
Dealt to Hero [2s 2c]
Dealt to 11fc0ba8 
Dealt to bd8abd3 
Dealt to 3ed018f9 
82b58c39: folds
a5661ff2: folds
Hero: calls 500
11fc0ba8: folds
bd8abd3: folds
3ed018f9: calls 250
37771df5: checks
*** FLOP *** [Jd 4d 2d]
3ed018f9: checks
37771df5: checks
Hero: checks
*** TURN *** [Jd 4d 2d] [5s]
3ed018f9: bets 669
37771df5: folds
Hero: calls 669
*** RIVER *** [Jd 4d 2d 5s] [7h]
3ed018f9: checks
Hero: bets 3,363
3ed018f9: folds
Uncalled bet (3,363) returned to Hero
*** SHOWDOWN ***
Hero collected 3,363 from pot
*** SUMMARY ***
Total pot 3,363 | Rake 0 | Jackpot 0 | Bingo 0 | Fortune 0 | Tax 0
Board [Jd 4d 2d 5s 7h]
Seat 1: 37771df5 (big blind) folded on the Turn
Seat 3: 82b58c39 folded before Flop
Seat 4: a5661ff2 folded before Flop
Seat 5: Hero won (3,363)
Seat 6: 11fc0ba8 folded before Flop
Seat 7: bd8abd3 (button) folded before Flop
Seat 8: 3ed018f9 (small blind) folded on the River


Poker Hand #TM3449964588: Tournament #149964808, Bounty Hunters Special $1.08 Hold'em No Limit - Level9(250/500) - 2024/07/03 22:06:14
Table '8' 8-max Seat #6 is the button
Seat 1: 37771df5 (22,887 in chips)
Seat 2: 2be0d2c1 (17,815 in chips)
Seat 3: ebdfe31a (10,000 in chips)
Seat 4: a5661ff2 (8,905 in chips)
Seat 5: Hero (32,413 in chips)
Seat 6: 11fc0ba8 (110,000 in chips)
Seat 7: bd8abd3 (72,361 in chips)
Seat 8: 3ed018f9 (25,559 in chips)
37771df5: posts the ante 75
a5661ff2: posts the ante 75
ebdfe31a: posts the ante 75
11fc0ba8: posts the ante 75
3ed018f9: posts the ante 75
Hero: posts the ante 75
2be0d2c1: posts the ante 75
bd8abd3: posts the ante 75
bd8abd3: posts small blind 250
3ed018f9: posts big blind 500
*** HOLE CARDS ***
Dealt to 37771df5 
Dealt to 2be0d2c1 
Dealt to ebdfe31a 
Dealt to a5661ff2 
Dealt to Hero [Ts Tc]
Dealt to 11fc0ba8 
Dealt to bd8abd3 
Dealt to 3ed018f9 
37771df5: folds
2be0d2c1: calls 500
ebdfe31a: calls 500
a5661ff2: folds
Hero: raises 2,000 to 2,500
11fc0ba8: folds
bd8abd3: folds
3ed018f9: folds
2be0d2c1: calls 2,000
ebdfe31a: calls 2,000
*** FLOP *** [Td Kd Kh]
2be0d2c1: checks
ebdfe31a: bets 7,425 and is all-in
Hero: calls 7,425
2be0d2c1: calls 7,425
*** TURN *** [Td Kd Kh] [6s]
2be0d2c1: bets 7,815 and is all-in
Hero: calls 7,815
2be0d2c1: shows [7d 6d] (Pair of Kings and Pair of Sixes)
ebdfe31a: shows [Ad 2d] (Pair of Kings)
Hero: shows [Ts Tc] (Tens Full over Kings)
*** RIVER *** [Td Kd Kh 6s] [Jc]
*** SHOWDOWN ***
Hero collected 31,125 from pot
Hero collected 15,630 from pot
*** SUMMARY ***
Total pot 46,755 | Rake 0 | Jackpot 0 | Bingo 0 | Fortune 0 | Tax 0
Board [Td Kd Kh 6s Jc]
Seat 1: 37771df5 folded before Flop
Seat 2: 2be0d2c1 showed [7d 6d] and lost with Pair of Kings and Pair of Sixes
Seat 3: ebdfe31a showed [Ad 2d] and lost with Pair of Kings
Seat 4: a5661ff2 folded before Flop
Seat 5: Hero showed [Ts Tc] and won (46,755) with Tens Full over Kings
Seat 6: 11fc0ba8 (button) folded before Flop
Seat 7: bd8abd3 (small blind) folded before Flop
Seat 8: 3ed018f9 (big blind) folded before Flop


Poker Hand #TM3449964518: Tournament #149964808, Bounty Hunters Special $1.08 Hold'em No Limit - Level9(250/500) - 2024/07/03 22:04:55
Table '8' 8-max Seat #5 is the button
Seat 1: 37771df5 (22,962 in chips)
Seat 2: 2be0d2c1 (17,890 in chips)
Seat 3: 1e4f14f4 (36,346 in chips)
Seat 4: a5661ff2 (8,980 in chips)
Seat 5: Hero (32,488 in chips)
Seat 6: 11fc0ba8 (66,435 in chips)
Seat 7: bd8abd3 (72,936 in chips)
Seat 8: 3ed018f9 (31,903 in chips)
37771df5: posts the ante 75
1e4f14f4: posts the ante 75
a5661ff2: posts the ante 75
11fc0ba8: posts the ante 75
3ed018f9: posts the ante 75
Hero: posts the ante 75
2be0d2c1: posts the ante 75
bd8abd3: posts the ante 75
11fc0ba8: posts small blind 250
bd8abd3: posts big blind 500
*** HOLE CARDS ***
Dealt to 37771df5 
Dealt to 2be0d2c1 
Dealt to 1e4f14f4 
Dealt to a5661ff2 
Dealt to Hero [6s 7c]
Dealt to 11fc0ba8 
Dealt to bd8abd3 
Dealt to 3ed018f9 
3ed018f9: calls 500
37771df5: folds
2be0d2c1: folds
1e4f14f4: raises 1,175 to 1,675
a5661ff2: folds
Hero: folds
11fc0ba8: calls 1,425
bd8abd3: folds
3ed018f9: calls 1,175
*** FLOP *** [2h 2d Ad]
11fc0ba8: checks
3ed018f9: checks
1e4f14f4: bets 4,594
11fc0ba8: calls 4,594
3ed018f9: calls 4,594
*** TURN *** [2h 2d Ad] [3h]
11fc0ba8: checks
3ed018f9: checks
1e4f14f4: bets 9,954
11fc0ba8: calls 9,954
3ed018f9: folds
*** RIVER *** [2h 2d Ad 3h] [6h]
11fc0ba8: checks
1e4f14f4: bets 13,139
11fc0ba8: raises 13,139 to 26,278
1e4f14f4: calls 6,909 and is all-in
Uncalled bet (6,230) returned to 11fc0ba8
11fc0ba8: shows [8c Ac] (Pair of Aces and Pair of Twos)
1e4f14f4: shows [Qs Qc] (Pair of Queens and Pair of Twos)
*** SHOWDOWN ***
11fc0ba8 collected 79,911 from pot
*** SUMMARY ***
Total pot 79,911 | Rake 0 | Jackpot 0 | Bingo 0 | Fortune 0 | Tax 0
Board [2h 2d Ad 3h 6h]
Seat 1: 37771df5 folded before Flop
Seat 2: 2be0d2c1 folded before Flop
Seat 3: 1e4f14f4 showed [Qs Qc] and lost with Pair of Queens and Pair of Twos
Seat 4: a5661ff2 folded before Flop
Seat 5: Hero (button) folded before Flop
Seat 6: 11fc0ba8 (small blind) showed [8c Ac] and won (79,911) with Pair of Aces and Pair of Twos
Seat 7: bd8abd3 (big blind) folded before Flop
Seat 8: 3ed018f9 folded on the Turn


Poker Hand #TM3449964448: Tournament #149964808, Bounty Hunters Special $1.08 Hold'em No Limit - Level8(200/400) - 2024/07/03 22:03:43
Table '8' 8-max Seat #4 is the button
Seat 1: 37771df5 (33,112 in chips)
Seat 2: 2be0d2c1 (19,490 in chips)
Seat 3: 1e4f14f4 (23,696 in chips)
Seat 4: a5661ff2 (9,040 in chips)
Seat 5: Hero (32,748 in chips)
Seat 6: 11fc0ba8 (66,895 in chips)
Seat 7: bd8abd3 (72,996 in chips)
Seat 8: 3ed018f9 (31,963 in chips)
37771df5: posts the ante 60
1e4f14f4: posts the ante 60
a5661ff2: posts the ante 60
11fc0ba8: posts the ante 60
3ed018f9: posts the ante 60
Hero: posts the ante 60
2be0d2c1: posts the ante 60
bd8abd3: posts the ante 60
Hero: posts small blind 200
11fc0ba8: posts big blind 400
*** HOLE CARDS ***
Dealt to 37771df5 
Dealt to 2be0d2c1 
Dealt to 1e4f14f4 
Dealt to a5661ff2 
Dealt to Hero [3d Ah]
Dealt to 11fc0ba8 
Dealt to bd8abd3 
Dealt to 3ed018f9 
bd8abd3: folds
3ed018f9: folds
37771df5: calls 400
2be0d2c1: calls 400
1e4f14f4: raises 1,140 to 1,540
a5661ff2: folds
Hero: folds
11fc0ba8: folds
37771df5: calls 1,140
2be0d2c1: calls 1,140
*** FLOP *** [3c 2h Qh]
37771df5: checks
2be0d2c1: checks
1e4f14f4: bets 2,850
37771df5: calls 2,850
2be0d2c1: folds
*** TURN *** [3c 2h Qh] [4c]
37771df5: checks
1e4f14f4: bets 5,700
37771df5: calls 5,700
*** RIVER *** [3c 2h Qh 4c] [As]
37771df5: checks
1e4f14f4: bets 13,546 and is all-in
37771df5: folds
Uncalled bet (13,546) returned to 1e4f14f4
*** SHOWDOWN ***
1e4f14f4 collected 22,800 from pot
*** SUMMARY ***
Total pot 22,800 | Rake 0 | Jackpot 0 | Bingo 0 | Fortune 0 | Tax 0
Board [3c 2h Qh 4c As]
Seat 1: 37771df5 folded on the River
Seat 2: 2be0d2c1 folded on the Flop
Seat 3: 1e4f14f4 won (22,800)
Seat 4: a5661ff2 (button) folded before Flop
Seat 5: Hero (small blind) folded before Flop
Seat 6: 11fc0ba8 (big blind) folded before Flop
Seat 7: bd8abd3 folded before Flop
Seat 8: 3ed018f9 folded before Flop


Poker Hand #TM3449964385: Tournament #149964808, Bounty Hunters Special $1.08 Hold'em No Limit - Level8(200/400) - 2024/07/03 22:02:35
Table '8' 8-max Seat #3 is the button
Seat 1: 37771df5 (33,172 in chips)
Seat 2: 2be0d2c1 (17,317 in chips)
Seat 3: 1e4f14f4 (23,756 in chips)
Seat 4: a5661ff2 (9,300 in chips)
Seat 5: Hero (34,361 in chips)
Seat 6: 11fc0ba8 (66,955 in chips)
Seat 7: bd8abd3 (73,056 in chips)
Seat 8: 3ed018f9 (32,023 in chips)
37771df5: posts the ante 60
1e4f14f4: posts the ante 60
a5661ff2: posts the ante 60
11fc0ba8: posts the ante 60
3ed018f9: posts the ante 60
Hero: posts the ante 60
2be0d2c1: posts the ante 60
bd8abd3: posts the ante 60
a5661ff2: posts small blind 200
Hero: posts big blind 400
*** HOLE CARDS ***
Dealt to 37771df5 
Dealt to 2be0d2c1 
Dealt to 1e4f14f4 
Dealt to a5661ff2 
Dealt to Hero [6d Kd]
Dealt to 11fc0ba8 
Dealt to bd8abd3 
Dealt to 3ed018f9 
11fc0ba8: folds
bd8abd3: folds
3ed018f9: folds
37771df5: folds
2be0d2c1: raises 400 to 800
1e4f14f4: folds
a5661ff2: folds
Hero: calls 400
*** FLOP *** [4s Jc 3s]
Hero: checks
2be0d2c1: checks
*** TURN *** [4s Jc 3s] [5s]
Hero: bets 753
2be0d2c1: calls 753
*** RIVER *** [4s Jc 3s 5s] [Ac]
Hero: checks
2be0d2c1: bets 1,250
Hero: folds
Uncalled bet (1,250) returned to 2be0d2c1
*** SHOWDOWN ***
2be0d2c1 collected 3,786 from pot
*** SUMMARY ***
Total pot 3,786 | Rake 0 | Jackpot 0 | Bingo 0 | Fortune 0 | Tax 0
Board [4s Jc 3s 5s Ac]
Seat 1: 37771df5 folded before Flop
Seat 2: 2be0d2c1 won (3,786)
Seat 3: 1e4f14f4 (button) folded before Flop
Seat 4: a5661ff2 (small blind) folded before Flop
Seat 5: Hero (big blind) folded on the River
Seat 6: 11fc0ba8 folded before Flop
Seat 7: bd8abd3 folded before Flop
Seat 8: 3ed018f9 folded before Flop


Poker Hand #TM3449964323: Tournament #149964808, Bounty Hunters Special $1.08 Hold'em No Limit - Level8(200/400) - 2024/07/03 21:54:42
Table '8' 8-max Seat #2 is the button
Seat 1: 37771df5 (34,151 in chips)
Seat 2: 2be0d2c1 (18,296 in chips)
Seat 3: 1e4f14f4 (20,482 in chips)
Seat 4: a5661ff2 (9,760 in chips)
Seat 5: Hero (34,421 in chips)
Seat 6: 11fc0ba8 (70,045 in chips)
Seat 7: bd8abd3 (69,783 in chips)
Seat 8: 3ed018f9 (33,002 in chips)
37771df5: posts the ante 60
1e4f14f4: posts the ante 60
a5661ff2: posts the ante 60
11fc0ba8: posts the ante 60
3ed018f9: posts the ante 60
Hero: posts the ante 60
2be0d2c1: posts the ante 60
bd8abd3: posts the ante 60
1e4f14f4: posts small blind 200
a5661ff2: posts big blind 400
*** HOLE CARDS ***
Dealt to 37771df5 
Dealt to 2be0d2c1 
Dealt to 1e4f14f4 
Dealt to a5661ff2 
Dealt to Hero [8d 2h]
Dealt to 11fc0ba8 
Dealt to bd8abd3 
Dealt to 3ed018f9 
Hero: folds
11fc0ba8: raises 519 to 919
bd8abd3: calls 919
3ed018f9: calls 919
37771df5: calls 919
2be0d2c1: calls 919
1e4f14f4: calls 719
a5661ff2: folds
*** FLOP *** [6d 5d 3h]
1e4f14f4: bets 2,111
11fc0ba8: calls 2,111
bd8abd3: raises 66,693 to 68,804 and is all-in
3ed018f9: folds
37771df5: folds
2be0d2c1: folds
1e4f14f4: calls 17,392 and is all-in
11fc0ba8: folds
Uncalled bet (49,301) returned to bd8abd3
bd8abd3: shows [8s 7c] (Eight-High)
1e4f14f4: shows [7s 8h] (Eight-High)
*** TURN *** [6d 5d 3h] [Ts]
*** RIVER *** [6d 5d 3h Ts] [9d]
*** SHOWDOWN ***
bd8abd3 collected 23,755 from pot
1e4f14f4 collected 23,756 from pot
*** SUMMARY ***
Total pot 47,511 | Rake 0 | Jackpot 0 | Bingo 0 | Fortune 0 | Tax 0
Board [6d 5d 3h Ts 9d]
Seat 1: 37771df5 folded on the Flop
Seat 2: 2be0d2c1 (button) folded on the Flop
Seat 3: 1e4f14f4 (small blind) showed [7s 8h] and won (23,756) with Tens-High Straight
Seat 4: a5661ff2 (big blind) folded before Flop
Seat 5: Hero folded before Flop
Seat 6: 11fc0ba8 folded on the Flop
Seat 7: bd8abd3 showed [8s 7c] and won (23,755) with Tens-High Straight
Seat 8: 3ed018f9 folded on the Flop


Poker Hand #TM3449964254: Tournament #149964808, Bounty Hunters Special $1.08 Hold'em No Limit - Level8(200/400) - 2024/07/03 21:53:24
Table '8' 8-max Seat #1 is the button
Seat 1: 37771df5 (26,169 in chips)
Seat 2: 2be0d2c1 (18,556 in chips)
Seat 3: 1e4f14f4 (21,342 in chips)
Seat 4: a5661ff2 (9,820 in chips)
Seat 5: Hero (37,762 in chips)
Seat 6: 11fc0ba8 (70,105 in chips)
Seat 7: bd8abd3 (73,124 in chips)
Seat 8: 3ed018f9 (33,062 in chips)
37771df5: posts the ante 60
1e4f14f4: posts the ante 60
a5661ff2: posts the ante 60
11fc0ba8: posts the ante 60
3ed018f9: posts the ante 60
Hero: posts the ante 60
bd8abd3: posts the ante 60
2be0d2c1: posts the ante 60
2be0d2c1: posts small blind 200
1e4f14f4: posts big blind 400
*** HOLE CARDS ***
Dealt to 37771df5 
Dealt to 2be0d2c1 
Dealt to 1e4f14f4 
Dealt to a5661ff2 
Dealt to Hero [Ts Qs]
Dealt to 11fc0ba8 
Dealt to bd8abd3 
Dealt to 3ed018f9 
a5661ff2: folds
Hero: raises 400 to 800
11fc0ba8: folds
bd8abd3: calls 800
3ed018f9: folds
37771df5: calls 800
2be0d2c1: folds
1e4f14f4: calls 400
*** FLOP *** [8c 6c 9h]
1e4f14f4: checks
Hero: checks
bd8abd3: bets 1,281
37771df5: calls 1,281
1e4f14f4: folds
Hero: calls 1,281
*** TURN *** [8c 6c 9h] [6d]
Hero: checks
bd8abd3: checks
37771df5: bets 1,200
Hero: calls 1,200
bd8abd3: calls 1,200
*** RIVER *** [8c 6c 9h 6d] [9d]
Hero: checks
bd8abd3: checks
37771df5: checks
Hero: shows [Ts Qs] (Pair of Nines and Pair of Sixes)
bd8abd3: shows [Ac 7s] (Pair of Nines and Pair of Sixes)
37771df5: shows [8h Ad] (Pair of Nines and Pair of Eights)
*** SHOWDOWN ***
37771df5 collected 11,323 from pot
*** SUMMARY ***
Total pot 11,323 | Rake 0 | Jackpot 0 | Bingo 0 | Fortune 0 | Tax 0
Board [8c 6c 9h 6d 9d]
Seat 1: 37771df5 (button) showed [8h Ad] and won (11,323) with Pair of Nines and Pair of Eights
Seat 2: 2be0d2c1 (small blind) folded before Flop
Seat 3: 1e4f14f4 (big blind) folded on the Flop
Seat 4: a5661ff2 folded before Flop
Seat 5: Hero showed [Ts Qs] and lost with Pair of Nines and Pair of Sixes
Seat 6: 11fc0ba8 folded before Flop
Seat 7: bd8abd3 showed [Ac 7s] and lost with Pair of Nines and Pair of Sixes
Seat 8: 3ed018f9 folded before Flop


Poker Hand #TM3449964220: Tournament #149964808, Bounty Hunters Special $1.08 Hold'em No Limit - Level8(200/400) - 2024/07/03 21:52:43
Table '8' 8-max Seat #8 is the button
Seat 1: 37771df5 (26,429 in chips)
Seat 2: 2be0d2c1 (19,016 in chips)
Seat 3: 1e4f14f4 (21,402 in chips)
Seat 4: a5661ff2 (9,880 in chips)
Seat 5: Hero (37,822 in chips)
Seat 6: 11fc0ba8 (74,921 in chips)
Seat 7: bd8abd3 (77,940 in chips)
Seat 8: 3ed018f9 (22,530 in chips)
37771df5: posts the ante 60
1e4f14f4: posts the ante 60
a5661ff2: posts the ante 60
11fc0ba8: posts the ante 60
3ed018f9: posts the ante 60
Hero: posts the ante 60
bd8abd3: posts the ante 60
2be0d2c1: posts the ante 60
37771df5: posts small blind 200
2be0d2c1: posts big blind 400
*** HOLE CARDS ***
Dealt to 37771df5 
Dealt to 2be0d2c1 
Dealt to 1e4f14f4 
Dealt to a5661ff2 
Dealt to Hero [9h 4h]
Dealt to 11fc0ba8 
Dealt to bd8abd3 
Dealt to 3ed018f9 
1e4f14f4: folds
a5661ff2: folds
Hero: folds
11fc0ba8: raises 519 to 919
bd8abd3: calls 919
3ed018f9: raises 3,837 to 4,756
37771df5: folds
2be0d2c1: folds
11fc0ba8: calls 3,837
bd8abd3: calls 3,837
*** FLOP *** [2s 2c Kh]
11fc0ba8: checks
bd8abd3: checks
3ed018f9: bets 15,348
11fc0ba8: folds
bd8abd3: folds
Uncalled bet (15,348) returned to 3ed018f9
*** SHOWDOWN ***
3ed018f9 collected 15,348 from pot
*** SUMMARY ***
Total pot 15,348 | Rake 0 | Jackpot 0 | Bingo 0 | Fortune 0 | Tax 0
Board [2s 2c Kh]
Seat 1: 37771df5 (small blind) folded before Flop
Seat 2: 2be0d2c1 (big blind) folded before Flop
Seat 3: 1e4f14f4 folded before Flop
Seat 4: a5661ff2 folded before Flop
Seat 5: Hero folded before Flop
Seat 6: 11fc0ba8 folded on the Flop
Seat 7: bd8abd3 folded on the Flop
Seat 8: 3ed018f9 (button) won (15,348)


Poker Hand #TM3449964164: Tournament #149964808, Bounty Hunters Special $1.08 Hold'em No Limit - Level8(200/400) - 2024/07/03 21:51:43
Table '8' 8-max Seat #7 is the button
Seat 1: 37771df5 (20,399 in chips)
Seat 2: 2be0d2c1 (19,076 in chips)
Seat 3: 1e4f14f4 (21,462 in chips)
Seat 4: a5661ff2 (9,940 in chips)
Seat 5: Hero (38,682 in chips)
Seat 6: 11fc0ba8 (75,781 in chips)
Seat 7: bd8abd3 (81,810 in chips)
Seat 8: 3ed018f9 (22,790 in chips)
37771df5: posts the ante 60
1e4f14f4: posts the ante 60
a5661ff2: posts the ante 60
11fc0ba8: posts the ante 60
3ed018f9: posts the ante 60
Hero: posts the ante 60
bd8abd3: posts the ante 60
2be0d2c1: posts the ante 60
3ed018f9: posts small blind 200
37771df5: posts big blind 400
*** HOLE CARDS ***
Dealt to 37771df5 
Dealt to 2be0d2c1 
Dealt to 1e4f14f4 
Dealt to a5661ff2 
Dealt to Hero [Ks Jc]
Dealt to 11fc0ba8 
Dealt to bd8abd3 
Dealt to 3ed018f9 
2be0d2c1: folds
1e4f14f4: folds
a5661ff2: folds
Hero: raises 400 to 800
11fc0ba8: calls 800
bd8abd3: raises 3,010 to 3,810
3ed018f9: folds
37771df5: raises 16,529 to 20,339 and is all-in
Hero: folds
11fc0ba8: folds
bd8abd3: folds
Uncalled bet (16,529) returned to 37771df5
*** SHOWDOWN ***
37771df5 collected 9,900 from pot
*** SUMMARY ***
Total pot 9,900 | Rake 0 | Jackpot 0 | Bingo 0 | Fortune 0 | Tax 0
Seat 1: 37771df5 (big blind) collected (9,900)
Seat 2: 2be0d2c1 folded before Flop
Seat 3: 1e4f14f4 folded before Flop
Seat 4: a5661ff2 folded before Flop
Seat 5: Hero folded before Flop
Seat 6: 11fc0ba8 folded before Flop
Seat 7: bd8abd3 (button) folded before Flop
Seat 8: 3ed018f9 (small blind) folded before Flop


Poker Hand #TM3449964086: Tournament #149964808, Bounty Hunters Special $1.08 Hold'em No Limit - Level8(200/400) - 2024/07/03 21:50:17
Table '8' 8-max Seat #6 is the button
Seat 1: 37771df5 (17,979 in chips)
Seat 2: 2be0d2c1 (19,136 in chips)
Seat 3: 1e4f14f4 (21,522 in chips)
Seat 4: a5661ff2 (10,000 in chips)
Seat 5: Hero (38,742 in chips)
Seat 6: 11fc0ba8 (75,841 in chips)
Seat 7: bd8abd3 (83,070 in chips)
Seat 8: 3ed018f9 (23,650 in chips)
37771df5: posts the ante 60
1e4f14f4: posts the ante 60
a5661ff2: posts the ante 60
11fc0ba8: posts the ante 60
3ed018f9: posts the ante 60
Hero: posts the ante 60
2be0d2c1: posts the ante 60
bd8abd3: posts the ante 60
bd8abd3: posts small blind 200
3ed018f9: posts big blind 400
*** HOLE CARDS ***
Dealt to 37771df5 
Dealt to 2be0d2c1 
Dealt to 1e4f14f4 
Dealt to a5661ff2 
Dealt to Hero [Kh 6s]
Dealt to 11fc0ba8 
Dealt to bd8abd3 
Dealt to 3ed018f9 
37771df5: raises 400 to 800
2be0d2c1: folds
1e4f14f4: folds
a5661ff2: folds
Hero: folds
11fc0ba8: folds
bd8abd3: calls 600
3ed018f9: calls 400
*** FLOP *** [8c 8d 9h]
bd8abd3: checks
3ed018f9: checks
37771df5: checks
*** TURN *** [8c 8d 9h] [9c]
bd8abd3: bets 400
3ed018f9: folds
37771df5: calls 400
*** RIVER *** [8c 8d 9h 9c] [Ah]
bd8abd3: checks
37771df5: bets 5,560
bd8abd3: folds
Uncalled bet (5,560) returned to 37771df5
*** SHOWDOWN ***
37771df5 collected 3,680 from pot
*** SUMMARY ***
Total pot 3,680 | Rake 0 | Jackpot 0 | Bingo 0 | Fortune 0 | Tax 0
Board [8c 8d 9h 9c Ah]
Seat 1: 37771df5 won (3,680)
Seat 2: 2be0d2c1 folded before Flop
Seat 3: 1e4f14f4 folded before Flop
Seat 4: a5661ff2 folded before Flop
Seat 5: Hero folded before Flop
Seat 6: 11fc0ba8 (button) folded before Flop
Seat 7: bd8abd3 (small blind) folded on the River
Seat 8: 3ed018f9 (big blind) folded on the Turn


Poker Hand #TM3449963996: Tournament #149964808, Bounty Hunters Special $1.08 Hold'em No Limit - Level8(200/400) - 2024/07/03 21:48:29
Table '8' 8-max Seat #5 is the button
Seat 1: 37771df5 (18,039 in chips)
Seat 2: 2be0d2c1 (19,196 in chips)
Seat 3: 1e4f14f4 (21,582 in chips)
Seat 4: 4aee0069 (8,676 in chips)
Seat 5: Hero (38,802 in chips)
Seat 6: 11fc0ba8 (84,517 in chips)
Seat 7: bd8abd3 (64,618 in chips)
Seat 8: 3ed018f9 (24,510 in chips)
37771df5: posts the ante 60
4aee0069: posts the ante 60
1e4f14f4: posts the ante 60
11fc0ba8: posts the ante 60
3ed018f9: posts the ante 60
Hero: posts the ante 60
2be0d2c1: posts the ante 60
bd8abd3: posts the ante 60
11fc0ba8: posts small blind 200
bd8abd3: posts big blind 400
*** HOLE CARDS ***
Dealt to 37771df5 
Dealt to 2be0d2c1 
Dealt to 1e4f14f4 
Dealt to 4aee0069 
Dealt to Hero [5h Ts]
Dealt to 11fc0ba8 
Dealt to bd8abd3 
Dealt to 3ed018f9 
3ed018f9: calls 400
37771df5: folds
2be0d2c1: folds
1e4f14f4: folds
4aee0069: raises 400 to 800
Hero: folds
11fc0ba8: calls 600
bd8abd3: calls 400
3ed018f9: calls 400
*** FLOP *** [2h 8d 3h]
11fc0ba8: checks
bd8abd3: bets 2,760
3ed018f9: folds
4aee0069: calls 2,760
11fc0ba8: calls 2,760
*** TURN *** [2h 8d 3h] [Qs]
11fc0ba8: checks
bd8abd3: checks
4aee0069: bets 5,056 and is all-in
11fc0ba8: calls 5,056
bd8abd3: calls 5,056
*** RIVER *** [2h 8d 3h Qs] [6s]
11fc0ba8: checks
bd8abd3: checks
11fc0ba8: shows [Kh 3c] (Pair of Treys)
bd8abd3: shows [8c 3s] (Pair of Eights and Pair of Treys)
4aee0069: shows [Jh Ac] (Ace-High)
*** SHOWDOWN ***
bd8abd3 collected 27,128 from pot
*** SUMMARY ***
Total pot 27,128 | Rake 0 | Jackpot 0 | Bingo 0 | Fortune 0 | Tax 0
Board [2h 8d 3h Qs 6s]
Seat 1: 37771df5 folded before Flop
Seat 2: 2be0d2c1 folded before Flop
Seat 3: 1e4f14f4 folded before Flop
Seat 4: 4aee0069 showed [Jh Ac] and lost with Ace-High
Seat 5: Hero (button) folded before Flop
Seat 6: 11fc0ba8 (small blind) showed [Kh 3c] and lost with Pair of Treys
Seat 7: bd8abd3 (big blind) showed [8c 3s] and won (27,128) with Pair of Eights and Pair of Treys
Seat 8: 3ed018f9 folded on the Flop


Poker Hand #TM3449963963: Tournament #149964808, Bounty Hunters Special $1.08 Hold'em No Limit - Level8(200/400) - 2024/07/03 21:47:56
Table '8' 8-max Seat #4 is the button
Seat 1: 37771df5 (18,099 in chips)
Seat 2: 2be0d2c1 (19,256 in chips)
Seat 3: 1e4f14f4 (21,642 in chips)
Seat 4: 4aee0069 (8,736 in chips)
Seat 5: Hero (39,062 in chips)
Seat 6: 11fc0ba8 (83,097 in chips)
Seat 7: bd8abd3 (64,678 in chips)
Seat 8: 3ed018f9 (25,370 in chips)
37771df5: posts the ante 60
4aee0069: posts the ante 60
1e4f14f4: posts the ante 60
11fc0ba8: posts the ante 60
3ed018f9: posts the ante 60
Hero: posts the ante 60
2be0d2c1: posts the ante 60
bd8abd3: posts the ante 60
Hero: posts small blind 200
11fc0ba8: posts big blind 400
*** HOLE CARDS ***
Dealt to 37771df5 
Dealt to 2be0d2c1 
Dealt to 1e4f14f4 
Dealt to 4aee0069 
Dealt to Hero [8s 5h]
Dealt to 11fc0ba8 
Dealt to bd8abd3 
Dealt to 3ed018f9 
bd8abd3: folds
3ed018f9: raises 400 to 800
37771df5: folds
2be0d2c1: folds
1e4f14f4: folds
4aee0069: folds
Hero: folds
11fc0ba8: calls 400
*** FLOP *** [3s 5c Jh]
11fc0ba8: checks
3ed018f9: checks
*** TURN *** [3s 5c Jh] [Td]
11fc0ba8: checks
3ed018f9: checks
*** RIVER *** [3s 5c Jh Td] [9h]
11fc0ba8: checks
3ed018f9: checks
11fc0ba8: shows [4c 5d] (Pair of Fives)
3ed018f9: shows [2d Ad] (Ace-High)
*** SHOWDOWN ***
11fc0ba8 collected 2,280 from pot
*** SUMMARY ***
Total pot 2,280 | Rake 0 | Jackpot 0 | Bingo 0 | Fortune 0 | Tax 0
Board [3s 5c Jh Td 9h]
Seat 1: 37771df5 folded before Flop
Seat 2: 2be0d2c1 folded before Flop
Seat 3: 1e4f14f4 folded before Flop
Seat 4: 4aee0069 (button) folded before Flop
Seat 5: Hero (small blind) folded before Flop
Seat 6: 11fc0ba8 (big blind) showed [4c 5d] and won (2,280) with Pair of Fives
Seat 7: bd8abd3 folded before Flop
Seat 8: 3ed018f9 showed [2d Ad] and lost with Ace-High


Poker Hand #TM3449963930: Tournament #149964808, Bounty Hunters Special $1.08 Hold'em No Limit - Level8(200/400) - 2024/07/03 21:47:21
Table '8' 8-max Seat #3 is the button
Seat 1: 37771df5 (18,159 in chips)
Seat 2: 2be0d2c1 (17,317 in chips)
Seat 3: 1e4f14f4 (21,702 in chips)
Seat 4: 4aee0069 (8,996 in chips)
Seat 5: Hero (39,522 in chips)
Seat 6: 11fc0ba8 (84,076 in chips)
Seat 7: bd8abd3 (64,738 in chips)
Seat 8: 3ed018f9 (25,430 in chips)
37771df5: posts the ante 60
4aee0069: posts the ante 60
1e4f14f4: posts the ante 60
11fc0ba8: posts the ante 60
3ed018f9: posts the ante 60
Hero: posts the ante 60
2be0d2c1: posts the ante 60
bd8abd3: posts the ante 60
4aee0069: posts small blind 200
Hero: posts big blind 400
*** HOLE CARDS ***
Dealt to 37771df5 
Dealt to 2be0d2c1 
Dealt to 1e4f14f4 
Dealt to 4aee0069 
Dealt to Hero [3h 8s]
Dealt to 11fc0ba8 
Dealt to bd8abd3 
Dealt to 3ed018f9 
11fc0ba8: raises 519 to 919
bd8abd3: folds
3ed018f9: folds
37771df5: folds
2be0d2c1: raises 16,338 to 17,257 and is all-in
1e4f14f4: folds
4aee0069: folds
Hero: folds
11fc0ba8: folds
Uncalled bet (16,338) returned to 2be0d2c1
*** SHOWDOWN ***
2be0d2c1 collected 2,918 from pot
*** SUMMARY ***
Total pot 2,918 | Rake 0 | Jackpot 0 | Bingo 0 | Fortune 0 | Tax 0
Seat 1: 37771df5 folded before Flop
Seat 2: 2be0d2c1 collected (2,918)
Seat 3: 1e4f14f4 (button) folded before Flop
Seat 4: 4aee0069 (small blind) folded before Flop
Seat 5: Hero (big blind) folded before Flop
Seat 6: 11fc0ba8 folded before Flop
Seat 7: bd8abd3 folded before Flop
Seat 8: 3ed018f9 folded before Flop


Poker Hand #TM3449963848: Tournament #149964808, Bounty Hunters Special $1.08 Hold'em No Limit - Level7(175/350) - 2024/07/03 21:45:53
Table '8' 8-max Seat #2 is the button
Seat 1: 37771df5 (18,209 in chips)
Seat 2: 2be0d2c1 (17,367 in chips)
Seat 3: 1e4f14f4 (21,927 in chips)
Seat 4: 4aee0069 (9,850 in chips)
Seat 5: Hero (39,572 in chips)
Seat 6: 11fc0ba8 (96,580 in chips)
Seat 7: bd8abd3 (50,955 in chips)
Seat 8: 3ed018f9 (25,480 in chips)
37771df5: posts the ante 50
4aee0069: posts the ante 50
1e4f14f4: posts the ante 50
11fc0ba8: posts the ante 50
3ed018f9: posts the ante 50
Hero: posts the ante 50
2be0d2c1: posts the ante 50
bd8abd3: posts the ante 50
1e4f14f4: posts small blind 175
4aee0069: posts big blind 350
*** HOLE CARDS ***
Dealt to 37771df5 
Dealt to 2be0d2c1 
Dealt to 1e4f14f4 
Dealt to 4aee0069 
Dealt to Hero [Qc 7s]
Dealt to 11fc0ba8 
Dealt to bd8abd3 
Dealt to 3ed018f9 
Hero: folds
11fc0ba8: raises 454 to 804
bd8abd3: calls 804
3ed018f9: folds
37771df5: folds
2be0d2c1: folds
1e4f14f4: folds
4aee0069: calls 454
*** FLOP *** [7h 4h Td]
4aee0069: checks
11fc0ba8: bets 986
bd8abd3: raises 3,720 to 4,706
4aee0069: folds
11fc0ba8: calls 3,720
*** TURN *** [7h 4h Td] [5c]
11fc0ba8: checks
bd8abd3: checks
*** RIVER *** [7h 4h Td 5c] [Qs]
11fc0ba8: bets 6,944
bd8abd3: raises 19,716 to 26,660
11fc0ba8: folds
Uncalled bet (19,716) returned to bd8abd3
*** SHOWDOWN ***
bd8abd3 collected 26,287 from pot
*** SUMMARY ***
Total pot 26,287 | Rake 0 | Jackpot 0 | Bingo 0 | Fortune 0 | Tax 0
Board [7h 4h Td 5c Qs]
Seat 1: 37771df5 folded before Flop
Seat 2: 2be0d2c1 (button) folded before Flop
Seat 3: 1e4f14f4 (small blind) folded before Flop
Seat 4: 4aee0069 (big blind) folded on the Flop
Seat 5: Hero folded before Flop
Seat 6: 11fc0ba8 folded on the River
Seat 7: bd8abd3 won (26,287)
Seat 8: 3ed018f9 folded before Flop


Poker Hand #TM3450219245: Tournament #149964808, Bounty Hunters Special $1.08 Hold'em No Limit - Level7(175/350) - 2024/07/03 21:44:41
Table '121' 8-max Seat #4 is the button
Seat 1: b1ee83fd (41,554 in chips)
Seat 2: 94692891 (68,919 in chips)
Seat 3: a988446d (5,930 in chips)
Seat 4: 4d6d2da9 (7,225 in chips)
Seat 5: 6d9126ed (31,895 in chips)
Seat 6: Hero (39,972 in chips)
Seat 7: 20bf27c2 (25,163 in chips)
Seat 8: fbf32a16 (56,295 in chips)
94692891: posts the ante 50
b1ee83fd: posts the ante 50
6d9126ed: posts the ante 50
4d6d2da9: posts the ante 50
a988446d: posts the ante 50
20bf27c2: posts the ante 50
Hero: posts the ante 50
fbf32a16: posts the ante 50
6d9126ed: posts small blind 175
Hero: posts big blind 350
*** HOLE CARDS ***
Dealt to b1ee83fd 
Dealt to 94692891 
Dealt to a988446d 
Dealt to 4d6d2da9 
Dealt to 6d9126ed 
Dealt to Hero [3c 7d]
Dealt to 20bf27c2 
Dealt to fbf32a16 
20bf27c2: calls 350
fbf32a16: folds
b1ee83fd: folds
94692891: raises 700 to 1,050
a988446d: folds
4d6d2da9: calls 1,050
6d9126ed: folds
Hero: folds
20bf27c2: calls 700
*** FLOP *** [Jh 8c 2h]
20bf27c2: bets 700
94692891: raises 1,807 to 2,507
4d6d2da9: raises 3,618 to 6,125 and is all-in
20bf27c2: raises 17,938 to 24,063 and is all-in
94692891: calls 21,556
20bf27c2: shows [Qd Jc] (Pair of Jacks)
94692891: shows [Kh Ah] (Ace-High)
4d6d2da9: shows [Qs Js] (Pair of Jacks)
*** TURN *** [Jh 8c 2h] [5s]
*** RIVER *** [Jh 8c 2h 5s] [Th]
*** SHOWDOWN ***
94692891 collected 22,450 from pot
94692891 collected 35,876 from pot
*** SUMMARY ***
Total pot 58,326 | Rake 0 | Jackpot 0 | Bingo 0 | Fortune 0 | Tax 0
Board [Jh 8c 2h 5s Th]
Seat 1: b1ee83fd folded before Flop
Seat 2: 94692891 showed [Kh Ah] and won (58,326) with Ace High Flush
Seat 3: a988446d folded before Flop
Seat 4: 4d6d2da9 (button) showed [Qs Js] and lost with Pair of Jacks
Seat 5: 6d9126ed (small blind) folded before Flop
Seat 6: Hero (big blind) folded before Flop
Seat 7: 20bf27c2 showed [Qd Jc] and lost with Pair of Jacks
Seat 8: fbf32a16 folded before Flop


Poker Hand #TM3450219198: Tournament #149964808, Bounty Hunters Special $1.08 Hold'em No Limit - Level7(175/350) - 2024/07/03 21:43:55
Table '121' 8-max Seat #3 is the button
Seat 1: b1ee83fd (43,072 in chips)
Seat 2: 94692891 (70,437 in chips)
Seat 3: a988446d (5,980 in chips)
Seat 4: 4d6d2da9 (7,450 in chips)
Seat 5: 6d9126ed (27,734 in chips)
Seat 6: Hero (40,022 in chips)
Seat 7: 20bf27c2 (25,913 in chips)
Seat 8: fbf32a16 (56,345 in chips)
94692891: posts the ante 50
b1ee83fd: posts the ante 50
6d9126ed: posts the ante 50
4d6d2da9: posts the ante 50
a988446d: posts the ante 50
20bf27c2: posts the ante 50
Hero: posts the ante 50
fbf32a16: posts the ante 50
4d6d2da9: posts small blind 175
6d9126ed: posts big blind 350
*** HOLE CARDS ***
Dealt to b1ee83fd 
Dealt to 94692891 
Dealt to a988446d 
Dealt to 4d6d2da9 
Dealt to 6d9126ed 
Dealt to Hero [7d 3s]
Dealt to 20bf27c2 
Dealt to fbf32a16 
Hero: folds
20bf27c2: raises 350 to 700
fbf32a16: folds
b1ee83fd: raises 768 to 1,468
94692891: calls 1,468
a988446d: folds
4d6d2da9: folds
6d9126ed: raises 26,216 to 27,684 and is all-in
20bf27c2: folds
b1ee83fd: folds
94692891: folds
Uncalled bet (26,216) returned to 6d9126ed
*** SHOWDOWN ***
6d9126ed collected 5,679 from pot
*** SUMMARY ***
Total pot 5,679 | Rake 0 | Jackpot 0 | Bingo 0 | Fortune 0 | Tax 0
Seat 1: b1ee83fd folded before Flop
Seat 2: 94692891 folded before Flop
Seat 3: a988446d (button) folded before Flop
Seat 4: 4d6d2da9 (small blind) folded before Flop
Seat 5: 6d9126ed (big blind) collected (5,679)
Seat 6: Hero folded before Flop
Seat 7: 20bf27c2 folded before Flop
Seat 8: fbf32a16 folded before Flop


Poker Hand #TM3450219143: Tournament #149964808, Bounty Hunters Special $1.08 Hold'em No Limit - Level7(175/350) - 2024/07/03 21:42:54
Table '121' 8-max Seat #2 is the button
Seat 1: b1ee83fd (43,122 in chips)
Seat 2: 94692891 (71,187 in chips)
Seat 3: a988446d (4,580 in chips)
Seat 4: 4d6d2da9 (7,850 in chips)
Seat 5: 6d9126ed (27,784 in chips)
Seat 6: Hero (40,072 in chips)
Seat 7: 20bf27c2 (25,963 in chips)
Seat 8: fbf32a16 (56,395 in chips)
94692891: posts the ante 50
b1ee83fd: posts the ante 50
6d9126ed: posts the ante 50
4d6d2da9: posts the ante 50
a988446d: posts the ante 50
20bf27c2: posts the ante 50
Hero: posts the ante 50
fbf32a16: posts the ante 50
a988446d: posts small blind 175
4d6d2da9: posts big blind 350
*** HOLE CARDS ***
Dealt to b1ee83fd 
Dealt to 94692891 
Dealt to a988446d 
Dealt to 4d6d2da9 
Dealt to 6d9126ed 
Dealt to Hero [6c Ks]
Dealt to 20bf27c2 
Dealt to fbf32a16 
6d9126ed: folds
Hero: folds
20bf27c2: folds
fbf32a16: folds
b1ee83fd: folds
94692891: calls 350
a988446d: calls 175
4d6d2da9: checks
*** FLOP *** [9d Kc Qh]
a988446d: bets 350
4d6d2da9: folds
94692891: calls 350
*** TURN *** [9d Kc Qh] [5h]
a988446d: bets 350
94692891: folds
Uncalled bet (350) returned to a988446d
*** SHOWDOWN ***
a988446d collected 2,150 from pot
*** SUMMARY ***
Total pot 2,150 | Rake 0 | Jackpot 0 | Bingo 0 | Fortune 0 | Tax 0
Board [9d Kc Qh 5h]
Seat 1: b1ee83fd folded before Flop
Seat 2: 94692891 (button) folded on the Turn
Seat 3: a988446d (small blind) won (2,150)
Seat 4: 4d6d2da9 (big blind) folded on the Flop
Seat 5: 6d9126ed folded before Flop
Seat 6: Hero folded before Flop
Seat 7: 20bf27c2 folded before Flop
Seat 8: fbf32a16 folded before Flop


Poker Hand #TM3449639068: Tournament #149964808, Bounty Hunters Special $1.08 Hold'em No Limit - Level7(175/350) - 2024/07/03 21:41:34
Table '121' 8-max Seat #1 is the button
Seat 1: b1ee83fd (44,047 in chips)
Seat 2: 94692891 (73,862 in chips)
Seat 3: a988446d (4,980 in chips)
Seat 4: 4d6d2da9 (7,900 in chips)
Seat 5: 6d9126ed (30,459 in chips)
Seat 6: Hero (33,247 in chips)
Seat 7: 20bf27c2 (26,013 in chips)
Seat 8: fbf32a16 (56,445 in chips)
94692891: posts the ante 50
b1ee83fd: posts the ante 50
6d9126ed: posts the ante 50
4d6d2da9: posts the ante 50
a988446d: posts the ante 50
20bf27c2: posts the ante 50
Hero: posts the ante 50
fbf32a16: posts the ante 50
94692891: posts small blind 175
a988446d: posts big blind 350
*** HOLE CARDS ***
Dealt to b1ee83fd 
Dealt to 94692891 
Dealt to a988446d 
Dealt to 4d6d2da9 
Dealt to 6d9126ed 
Dealt to Hero [Ac Qd]
Dealt to 20bf27c2 
Dealt to fbf32a16 
4d6d2da9: folds
6d9126ed: raises 525 to 875
Hero: calls 875
20bf27c2: folds
fbf32a16: folds
b1ee83fd: calls 875
94692891: calls 700
a988446d: folds
*** FLOP *** [Ah 8h Ad]
94692891: checks
6d9126ed: checks
Hero: checks
b1ee83fd: checks
*** TURN *** [Ah 8h Ad] [8d]
94692891: checks
6d9126ed: checks
Hero: bets 700
b1ee83fd: folds
94692891: calls 700
6d9126ed: calls 700
*** RIVER *** [Ah 8h Ad 8d] [Th]
94692891: checks
6d9126ed: checks
Hero: bets 1,050
94692891: calls 1,050
6d9126ed: calls 1,050
Hero: shows [Ac Qd] (Aces Full over Eights)
94692891: shows [6h 2h] (Ace High Flush)
6d9126ed: shows [9d Kd] (Pair of Aces and Pair of Eights)
*** SHOWDOWN ***
Hero collected 9,500 from pot
*** SUMMARY ***
Total pot 9,500 | Rake 0 | Jackpot 0 | Bingo 0 | Fortune 0 | Tax 0
Board [Ah 8h Ad 8d Th]
Seat 1: b1ee83fd (button) folded on the Turn
Seat 2: 94692891 (small blind) showed [6h 2h] and lost with Ace High Flush
Seat 3: a988446d (big blind) folded before Flop
Seat 4: 4d6d2da9 folded before Flop
Seat 5: 6d9126ed showed [9d Kd] and lost with Pair of Aces and Pair of Eights
Seat 6: Hero showed [Ac Qd] and won (9,500) with Aces Full over Eights
Seat 7: 20bf27c2 folded before Flop
Seat 8: fbf32a16 folded before Flop


Poker Hand #TM3449639016: Tournament #149964808, Bounty Hunters Special $1.08 Hold'em No Limit - Level7(175/350) - 2024/07/03 21:40:37
Table '121' 8-max Seat #8 is the button
Seat 1: b1ee83fd (46,047 in chips)
Seat 2: 94692891 (69,612 in chips)
Seat 3: a988446d (5,030 in chips)
Seat 4: 4d6d2da9 (9,900 in chips)
Seat 5: 6d9126ed (30,509 in chips)
Seat 6: Hero (33,297 in chips)
Seat 7: 20bf27c2 (26,063 in chips)
Seat 8: fbf32a16 (56,495 in chips)
94692891: posts the ante 50
6d9126ed: posts the ante 50
b1ee83fd: posts the ante 50
4d6d2da9: posts the ante 50
a988446d: posts the ante 50
20bf27c2: posts the ante 50
Hero: posts the ante 50
fbf32a16: posts the ante 50
b1ee83fd: posts small blind 175
94692891: posts big blind 350
*** HOLE CARDS ***
Dealt to b1ee83fd 
Dealt to 94692891 
Dealt to a988446d 
Dealt to 4d6d2da9 
Dealt to 6d9126ed 
Dealt to Hero [5c Th]
Dealt to 20bf27c2 
Dealt to fbf32a16 
a988446d: folds
4d6d2da9: raises 350 to 700
6d9126ed: folds
Hero: folds
20bf27c2: folds
fbf32a16: folds
b1ee83fd: calls 525
94692891: calls 350
*** FLOP *** [2s Jh Kd]
b1ee83fd: checks
94692891: checks
4d6d2da9: checks
*** TURN *** [2s Jh Kd] [6c]
b1ee83fd: checks
94692891: bets 1,250
4d6d2da9: calls 1,250
b1ee83fd: calls 1,250
*** RIVER *** [2s Jh Kd 6c] [Qs]
b1ee83fd: checks
94692891: bets 3,125
4d6d2da9: folds
b1ee83fd: folds
Uncalled bet (3,125) returned to 94692891
*** SHOWDOWN ***
94692891 collected 6,250 from pot
*** SUMMARY ***
Total pot 6,250 | Rake 0 | Jackpot 0 | Bingo 0 | Fortune 0 | Tax 0
Board [2s Jh Kd 6c Qs]
Seat 1: b1ee83fd (small blind) folded on the River
Seat 2: 94692891 (big blind) won (6,250)
Seat 3: a988446d folded before Flop
Seat 4: 4d6d2da9 folded on the River
Seat 5: 6d9126ed folded before Flop
Seat 6: Hero folded before Flop
Seat 7: 20bf27c2 folded before Flop
Seat 8: fbf32a16 (button) folded before Flop


Poker Hand #TM3449638967: Tournament #149964808, Bounty Hunters Special $1.08 Hold'em No Limit - Level7(175/350) - 2024/07/03 21:39:46
Table '121' 8-max Seat #7 is the button
Seat 1: b1ee83fd (46,797 in chips)
Seat 2: 94692891 (71,062 in chips)
Seat 3: a988446d (5,080 in chips)
Seat 4: 4d6d2da9 (9,950 in chips)
Seat 5: 6d9126ed (30,559 in chips)
Seat 6: Hero (33,347 in chips)
Seat 7: 20bf27c2 (23,438 in chips)
Seat 8: fbf32a16 (56,720 in chips)
94692891: posts the ante 50
6d9126ed: posts the ante 50
b1ee83fd: posts the ante 50
4d6d2da9: posts the ante 50
a988446d: posts the ante 50
20bf27c2: posts the ante 50
Hero: posts the ante 50
fbf32a16: posts the ante 50
fbf32a16: posts small blind 175
b1ee83fd: posts big blind 350
*** HOLE CARDS ***
Dealt to b1ee83fd 
Dealt to 94692891 
Dealt to a988446d 
Dealt to 4d6d2da9 
Dealt to 6d9126ed 
Dealt to Hero [5s 9d]
Dealt to 20bf27c2 
Dealt to fbf32a16 
94692891: calls 350
a988446d: folds
4d6d2da9: folds
6d9126ed: folds
Hero: folds
20bf27c2: raises 350 to 700
fbf32a16: folds
b1ee83fd: calls 350
94692891: calls 350
*** FLOP *** [9c Ks Tc]
b1ee83fd: checks
94692891: checks
20bf27c2: bets 700
b1ee83fd: folds
94692891: calls 700
*** TURN *** [9c Ks Tc] [Th]
94692891: checks
20bf27c2: checks
*** RIVER *** [9c Ks Tc Th] [2h]
94692891: checks
20bf27c2: checks
94692891: shows [6c 4c] (Pair of Tens)
20bf27c2: shows [Ac 9h] (Pair of Tens and Pair of Nines)
*** SHOWDOWN ***
20bf27c2 collected 4,075 from pot
*** SUMMARY ***
Total pot 4,075 | Rake 0 | Jackpot 0 | Bingo 0 | Fortune 0 | Tax 0
Board [9c Ks Tc Th 2h]
Seat 1: b1ee83fd (big blind) folded on the Flop
Seat 2: 94692891 showed [6c 4c] and lost with Pair of Tens
Seat 3: a988446d folded before Flop
Seat 4: 4d6d2da9 folded before Flop
Seat 5: 6d9126ed folded before Flop
Seat 6: Hero folded before Flop
Seat 7: 20bf27c2 (button) showed [Ac 9h] and won (4,075) with Pair of Tens and Pair of Nines
Seat 8: fbf32a16 (small blind) folded before Flop


Poker Hand #TM3449638925: Tournament #149964808, Bounty Hunters Special $1.08 Hold'em No Limit - Level7(175/350) - 2024/07/03 21:38:52
Table '121' 8-max Seat #6 is the button
Seat 1: b1ee83fd (22,286 in chips)
Seat 2: 94692891 (72,512 in chips)
Seat 3: a988446d (5,130 in chips)
Seat 4: 4d6d2da9 (10,000 in chips)
Seat 5: 6d9126ed (52,845 in chips)
Seat 6: Hero (33,397 in chips)
Seat 7: 20bf27c2 (23,663 in chips)
Seat 8: fbf32a16 (57,120 in chips)
94692891: posts the ante 50
6d9126ed: posts the ante 50
b1ee83fd: posts the ante 50
4d6d2da9: posts the ante 50
a988446d: posts the ante 50
Hero: posts the ante 50
20bf27c2: posts the ante 50
fbf32a16: posts the ante 50
20bf27c2: posts small blind 175
fbf32a16: posts big blind 350
*** HOLE CARDS ***
Dealt to b1ee83fd 
Dealt to 94692891 
Dealt to a988446d 
Dealt to 4d6d2da9 
Dealt to 6d9126ed 
Dealt to Hero [6h Kd]
Dealt to 20bf27c2 
Dealt to fbf32a16 
b1ee83fd: raises 1,050 to 1,400
94692891: calls 1,400
a988446d: folds
4d6d2da9: folds
6d9126ed: calls 1,400
Hero: folds
20bf27c2: folds
fbf32a16: folds
*** FLOP *** [2h 2s 6d]
b1ee83fd: bets 5,125
94692891: folds
6d9126ed: raises 46,270 to 51,395 and is all-in
b1ee83fd: calls 15,711 and is all-in
Uncalled bet (30,559) returned to 6d9126ed
6d9126ed: shows [Kc As] (Pair of Twos)
b1ee83fd: shows [Ks Kh] (Pair of Kings and Pair of Twos)
*** TURN *** [2h 2s 6d] [Tc]
*** RIVER *** [2h 2s 6d Tc] [2c]
*** SHOWDOWN ***
b1ee83fd collected 46,797 from pot
*** SUMMARY ***
Total pot 46,797 | Rake 0 | Jackpot 0 | Bingo 0 | Fortune 0 | Tax 0
Board [2h 2s 6d Tc 2c]
Seat 1: b1ee83fd showed [Ks Kh] and won (46,797) with Twos Full over Kings
Seat 2: 94692891 folded on the Flop
Seat 3: a988446d folded before Flop
Seat 4: 4d6d2da9 folded before Flop
Seat 5: 6d9126ed showed [Kc As] and lost with Three Twos
Seat 6: Hero (button) folded before Flop
Seat 7: 20bf27c2 (small blind) folded before Flop
Seat 8: fbf32a16 (big blind) folded before Flop


Poker Hand #TM3449638877: Tournament #149964808, Bounty Hunters Special $1.08 Hold'em No Limit - Level7(175/350) - 2024/07/03 21:38:02
Table '121' 8-max Seat #5 is the button
Seat 1: b1ee83fd (22,336 in chips)
Seat 2: 94692891 (72,562 in chips)
Seat 3: a988446d (6,505 in chips)
Seat 5: 6d9126ed (54,220 in chips)
Seat 6: Hero (33,622 in chips)
Seat 7: 20bf27c2 (24,063 in chips)
Seat 8: fbf32a16 (53,645 in chips)
94692891: posts the ante 50
6d9126ed: posts the ante 50
b1ee83fd: posts the ante 50
a988446d: posts the ante 50
20bf27c2: posts the ante 50
Hero: posts the ante 50
fbf32a16: posts the ante 50
Hero: posts small blind 175
20bf27c2: posts big blind 350
*** HOLE CARDS ***
Dealt to b1ee83fd 
Dealt to 94692891 
Dealt to a988446d 
Dealt to 6d9126ed 
Dealt to Hero [4d Kc]
Dealt to 20bf27c2 
Dealt to fbf32a16 
fbf32a16: raises 350 to 700
b1ee83fd: folds
94692891: folds
a988446d: calls 700
6d9126ed: calls 700
Hero: folds
20bf27c2: folds
*** FLOP *** [5d Kd 4c]
fbf32a16: bets 625
a988446d: calls 625
6d9126ed: calls 625
*** TURN *** [5d Kd 4c] [3d]
fbf32a16: bets 1,019
a988446d: folds
6d9126ed: folds
Uncalled bet (1,019) returned to fbf32a16
Hero: shows [4d Kc] (Pair of Kings and Pair of Fours)
*** SHOWDOWN ***
fbf32a16 collected 4,850 from pot
*** SUMMARY ***
Total pot 4,850 | Rake 0 | Jackpot 0 | Bingo 0 | Fortune 0 | Tax 0
Board [5d Kd 4c 3d]
Seat 1: b1ee83fd folded before Flop
Seat 2: 94692891 folded before Flop
Seat 3: a988446d folded on the Turn
Seat 5: 6d9126ed (button) folded on the Turn
Seat 6: Hero (small blind) folded before Flop
Seat 7: 20bf27c2 (big blind) folded before Flop
Seat 8: fbf32a16 won (4,850)


Poker Hand #TM3449638816: Tournament #149964808, Bounty Hunters Special $1.08 Hold'em No Limit - Level6(150/300) - 2024/07/03 21:36:57
Table '121' 8-max Seat #3 is the button
Seat 1: b1ee83fd (22,381 in chips)
Seat 2: 94692891 (72,907 in chips)
Seat 3: a988446d (6,550 in chips)
Seat 4: 35a7cc5 (4,495 in chips)
Seat 5: 6d9126ed (63,339 in chips)
Seat 6: Hero (33,667 in chips)
Seat 7: 20bf27c2 (24,108 in chips)
Seat 8: fbf32a16 (39,506 in chips)
94692891: posts the ante 45
35a7cc5: posts the ante 45
b1ee83fd: posts the ante 45
6d9126ed: posts the ante 45
a988446d: posts the ante 45
20bf27c2: posts the ante 45
Hero: posts the ante 45
fbf32a16: posts the ante 45
35a7cc5: posts small blind 150
6d9126ed: posts big blind 300
*** HOLE CARDS ***
Dealt to b1ee83fd 
Dealt to 94692891 
Dealt to a988446d 
Dealt to 35a7cc5 
Dealt to 6d9126ed 
Dealt to Hero [Ad 3h]
Dealt to 20bf27c2 
Dealt to fbf32a16 
Hero: folds
20bf27c2: folds
fbf32a16: calls 300
b1ee83fd: folds
94692891: calls 300
a988446d: folds
35a7cc5: raises 4,150 to 4,450 and is all-in
6d9126ed: calls 4,150
fbf32a16: calls 4,150
94692891: folds
*** FLOP *** [2s Qh 8s]
6d9126ed: bets 4,624
fbf32a16: raises 23,258 to 27,882
6d9126ed: folds
Uncalled bet (23,258) returned to fbf32a16
fbf32a16: shows [Kh Qc] (Pair of Queens)
35a7cc5: shows [9d Kd] (King-High)
*** TURN *** [2s Qh 8s] [8c]
*** RIVER *** [2s Qh 8s 8c] [3c]
*** SHOWDOWN ***
fbf32a16 collected 14,010 from pot
fbf32a16 collected 9,248 from pot
*** SUMMARY ***
Total pot 23,258 | Rake 0 | Jackpot 0 | Bingo 0 | Fortune 0 | Tax 0
Board [2s Qh 8s 8c 3c]
Seat 1: b1ee83fd folded before Flop
Seat 2: 94692891 folded before Flop
Seat 3: a988446d (button) folded before Flop
Seat 4: 35a7cc5 (small blind) showed [9d Kd] and lost with Pair of Eights
Seat 5: 6d9126ed (big blind) folded on the Flop
Seat 6: Hero folded before Flop
Seat 7: 20bf27c2 folded before Flop
Seat 8: fbf32a16 showed [Kh Qc] and won (23,258) with Pair of Queens and Pair of Eights


Poker Hand #TM3449638759: Tournament #149964808, Bounty Hunters Special $1.08 Hold'em No Limit - Level6(150/300) - 2024/07/03 21:36:00
Table '121' 8-max Seat #2 is the button
Seat 1: b1ee83fd (25,036 in chips)
Seat 2: 94692891 (72,952 in chips)
Seat 3: a988446d (6,745 in chips)
Seat 4: 35a7cc5 (4,840 in chips)
Seat 5: 6d9126ed (63,384 in chips)
Seat 6: Hero (33,712 in chips)
Seat 7: 20bf27c2 (24,153 in chips)
Seat 8: fbf32a16 (36,131 in chips)
94692891: posts the ante 45
35a7cc5: posts the ante 45
b1ee83fd: posts the ante 45
6d9126ed: posts the ante 45
a988446d: posts the ante 45
20bf27c2: posts the ante 45
Hero: posts the ante 45
fbf32a16: posts the ante 45
a988446d: posts small blind 150
35a7cc5: posts big blind 300
*** HOLE CARDS ***
Dealt to b1ee83fd 
Dealt to 94692891 
Dealt to a988446d 
Dealt to 35a7cc5 
Dealt to 6d9126ed 
Dealt to Hero [Jc 3h]
Dealt to 20bf27c2 
Dealt to fbf32a16 
6d9126ed: folds
Hero: folds
20bf27c2: folds
fbf32a16: raises 300 to 600
b1ee83fd: raises 2,010 to 2,610
94692891: folds
a988446d: folds
35a7cc5: folds
fbf32a16: calls 2,010
*** FLOP *** [Jh 9s 2d]
fbf32a16: checks
b1ee83fd: checks
*** TURN *** [Jh 9s 2d] [8c]
fbf32a16: bets 4,523
b1ee83fd: folds
Uncalled bet (4,523) returned to fbf32a16
*** SHOWDOWN ***
fbf32a16 collected 6,030 from pot
*** SUMMARY ***
Total pot 6,030 | Rake 0 | Jackpot 0 | Bingo 0 | Fortune 0 | Tax 0
Board [Jh 9s 2d 8c]
Seat 1: b1ee83fd folded on the Turn
Seat 2: 94692891 (button) folded before Flop
Seat 3: a988446d (small blind) folded before Flop
Seat 4: 35a7cc5 (big blind) folded before Flop
Seat 5: 6d9126ed folded before Flop
Seat 6: Hero folded before Flop
Seat 7: 20bf27c2 folded before Flop
Seat 8: fbf32a16 won (6,030)


Poker Hand #TM3449638716: Tournament #149964808, Bounty Hunters Special $1.08 Hold'em No Limit - Level6(150/300) - 2024/07/03 21:35:09
Table '121' 8-max Seat #1 is the button
Seat 1: b1ee83fd (28,013 in chips)
Seat 2: 94692891 (73,147 in chips)
Seat 3: a988446d (7,090 in chips)
Seat 4: 35a7cc5 (4,885 in chips)
Seat 5: 6d9126ed (63,429 in chips)
Seat 6: Hero (30,015 in chips)
Seat 7: 20bf27c2 (24,198 in chips)
Seat 8: fbf32a16 (36,176 in chips)
94692891: posts the ante 45
35a7cc5: posts the ante 45
b1ee83fd: posts the ante 45
6d9126ed: posts the ante 45
a988446d: posts the ante 45
20bf27c2: posts the ante 45
Hero: posts the ante 45
fbf32a16: posts the ante 45
94692891: posts small blind 150
a988446d: posts big blind 300
*** HOLE CARDS ***
Dealt to b1ee83fd 
Dealt to 94692891 
Dealt to a988446d 
Dealt to 35a7cc5 
Dealt to 6d9126ed 
Dealt to Hero [9d Kh]
Dealt to 20bf27c2 
Dealt to fbf32a16 
35a7cc5: folds
6d9126ed: folds
Hero: raises 300 to 600
20bf27c2: folds
fbf32a16: folds
b1ee83fd: raises 1,005 to 1,605
94692891: folds
a988446d: folds
Hero: calls 1,005
*** FLOP *** [2d Kc Jd]
Hero: checks
b1ee83fd: bets 1,327
Hero: calls 1,327
*** TURN *** [2d Kc Jd] [3h]
Hero: checks
b1ee83fd: checks
*** RIVER *** [2d Kc Jd 3h] [7s]
Hero: bets 3,337
b1ee83fd: folds
Uncalled bet (3,337) returned to Hero
*** SHOWDOWN ***
Hero collected 6,674 from pot
*** SUMMARY ***
Total pot 6,674 | Rake 0 | Jackpot 0 | Bingo 0 | Fortune 0 | Tax 0
Board [2d Kc Jd 3h 7s]
Seat 1: b1ee83fd (button) folded on the River
Seat 2: 94692891 (small blind) folded before Flop
Seat 3: a988446d (big blind) folded before Flop
Seat 4: 35a7cc5 folded before Flop
Seat 5: 6d9126ed folded before Flop
Seat 6: Hero won (6,674)
Seat 7: 20bf27c2 folded before Flop
Seat 8: fbf32a16 folded before Flop


Poker Hand #TM3449638665: Tournament #149964808, Bounty Hunters Special $1.08 Hold'em No Limit - Level6(150/300) - 2024/07/03 21:34:16
Table '121' 8-max Seat #8 is the button
Seat 1: b1ee83fd (28,208 in chips)
Seat 2: 94692891 (70,882 in chips)
Seat 3: a988446d (8,035 in chips)
Seat 4: 35a7cc5 (5,830 in chips)
Seat 5: 6d9126ed (63,474 in chips)
Seat 6: Hero (30,060 in chips)
Seat 7: 20bf27c2 (24,243 in chips)
Seat 8: fbf32a16 (36,221 in chips)
94692891: posts the ante 45
35a7cc5: posts the ante 45
6d9126ed: posts the ante 45
b1ee83fd: posts the ante 45
a988446d: posts the ante 45
20bf27c2: posts the ante 45
Hero: posts the ante 45
fbf32a16: posts the ante 45
b1ee83fd: posts small blind 150
94692891: posts big blind 300
*** HOLE CARDS ***
Dealt to b1ee83fd 
Dealt to 94692891 
Dealt to a988446d 
Dealt to 35a7cc5 
Dealt to 6d9126ed 
Dealt to Hero [3d 5s]
Dealt to 20bf27c2 
Dealt to fbf32a16 
a988446d: calls 300
35a7cc5: calls 300
6d9126ed: folds
Hero: folds
20bf27c2: folds
fbf32a16: folds
b1ee83fd: folds
94692891: raises 600 to 900
a988446d: calls 600
35a7cc5: calls 600
*** FLOP *** [6s Qh 4h]
94692891: bets 1,060
a988446d: folds
35a7cc5: folds
Uncalled bet (1,060) returned to 94692891
*** SHOWDOWN ***
94692891 collected 3,210 from pot
*** SUMMARY ***
Total pot 3,210 | Rake 0 | Jackpot 0 | Bingo 0 | Fortune 0 | Tax 0
Board [6s Qh 4h]
Seat 1: b1ee83fd (small blind) folded before Flop
Seat 2: 94692891 (big blind) won (3,210)
Seat 3: a988446d folded on the Flop
Seat 4: 35a7cc5 folded on the Flop
Seat 5: 6d9126ed folded before Flop
Seat 6: Hero folded before Flop
Seat 7: 20bf27c2 folded before Flop
Seat 8: fbf32a16 (button) folded before Flop


Poker Hand #TM3449638615: Tournament #149964808, Bounty Hunters Special $1.08 Hold'em No Limit - Level6(150/300) - 2024/07/03 21:33:24
Table '121' 8-max Seat #7 is the button
Seat 1: b1ee83fd (28,853 in chips)
Seat 2: 94692891 (66,434 in chips)
Seat 3: a988446d (8,680 in chips)
Seat 4: 35a7cc5 (5,875 in chips)
Seat 5: 6d9126ed (63,519 in chips)
Seat 6: Hero (30,105 in chips)
Seat 7: 20bf27c2 (27,071 in chips)
Seat 8: fbf32a16 (36,416 in chips)
94692891: posts the ante 45
35a7cc5: posts the ante 45
6d9126ed: posts the ante 45
b1ee83fd: posts the ante 45
a988446d: posts the ante 45
20bf27c2: posts the ante 45
Hero: posts the ante 45
fbf32a16: posts the ante 45
fbf32a16: posts small blind 150
b1ee83fd: posts big blind 300
*** HOLE CARDS ***
Dealt to b1ee83fd 
Dealt to 94692891 
Dealt to a988446d 
Dealt to 35a7cc5 
Dealt to 6d9126ed 
Dealt to Hero [7h 8c]
Dealt to 20bf27c2 
Dealt to fbf32a16 
94692891: raises 300 to 600
a988446d: calls 600
35a7cc5: folds
6d9126ed: folds
Hero: folds
20bf27c2: calls 600
fbf32a16: folds
b1ee83fd: calls 300
*** FLOP *** [9c Js Ks]
b1ee83fd: checks
94692891: bets 2,183
a988446d: folds
20bf27c2: calls 2,183
b1ee83fd: folds
*** TURN *** [9c Js Ks] [3s]
94692891: checks
20bf27c2: checks
*** RIVER *** [9c Js Ks 3s] [As]
94692891: checks
20bf27c2: checks
94692891: shows [Jd Kc] (Pair of Kings and Pair of Jacks)
20bf27c2: shows [Kd Qh] (Pair of Kings)
*** SHOWDOWN ***
94692891 collected 7,276 from pot
*** SUMMARY ***
Total pot 7,276 | Rake 0 | Jackpot 0 | Bingo 0 | Fortune 0 | Tax 0
Board [9c Js Ks 3s As]
Seat 1: b1ee83fd (big blind) folded on the Flop
Seat 2: 94692891 showed [Jd Kc] and won (7,276) with Pair of Kings and Pair of Jacks
Seat 3: a988446d folded on the Flop
Seat 4: 35a7cc5 folded before Flop
Seat 5: 6d9126ed folded before Flop
Seat 6: Hero folded before Flop
Seat 7: 20bf27c2 (button) showed [Kd Qh] and lost with Pair of Kings
Seat 8: fbf32a16 (small blind) folded before Flop


Poker Hand #TM3449638541: Tournament #149964808, Bounty Hunters Special $1.08 Hold'em No Limit - Level6(150/300) - 2024/07/03 21:32:06
Table '121' 8-max Seat #6 is the button
Seat 1: b1ee83fd (29,498 in chips)
Seat 2: 94692891 (66,479 in chips)
Seat 3: a988446d (8,725 in chips)
Seat 4: 35a7cc5 (5,920 in chips)
Seat 5: 6d9126ed (64,164 in chips)
Seat 6: Hero (30,750 in chips)
Seat 7: 20bf27c2 (27,266 in chips)
Seat 8: fbf32a16 (34,151 in chips)
94692891: posts the ante 45
35a7cc5: posts the ante 45
6d9126ed: posts the ante 45
b1ee83fd: posts the ante 45
a988446d: posts the ante 45
Hero: posts the ante 45
20bf27c2: posts the ante 45
fbf32a16: posts the ante 45
20bf27c2: posts small blind 150
fbf32a16: posts big blind 300
*** HOLE CARDS ***
Dealt to b1ee83fd 
Dealt to 94692891 
Dealt to a988446d 
Dealt to 35a7cc5 
Dealt to 6d9126ed 
Dealt to Hero [5s 5c]
Dealt to 20bf27c2 
Dealt to fbf32a16 
b1ee83fd: raises 300 to 600
94692891: folds
a988446d: folds
35a7cc5: folds
6d9126ed: calls 600
Hero: calls 600
20bf27c2: folds
fbf32a16: calls 300
*** FLOP *** [6s 9h Qs]
fbf32a16: checks
b1ee83fd: checks
6d9126ed: checks
Hero: checks
*** TURN *** [6s 9h Qs] [Kc]
fbf32a16: bets 2,183
b1ee83fd: folds
6d9126ed: folds
Hero: folds
Uncalled bet (2,183) returned to fbf32a16
*** SHOWDOWN ***
fbf32a16 collected 2,910 from pot
*** SUMMARY ***
Total pot 2,910 | Rake 0 | Jackpot 0 | Bingo 0 | Fortune 0 | Tax 0
Board [6s 9h Qs Kc]
Seat 1: b1ee83fd folded on the Turn
Seat 2: 94692891 folded before Flop
Seat 3: a988446d folded before Flop
Seat 4: 35a7cc5 folded before Flop
Seat 5: 6d9126ed folded on the Turn
Seat 6: Hero (button) folded on the Turn
Seat 7: 20bf27c2 (small blind) folded before Flop
Seat 8: fbf32a16 (big blind) won (2,910)


Poker Hand #TM3449638470: Tournament #149964808, Bounty Hunters Special $1.08 Hold'em No Limit - Level6(150/300) - 2024/07/03 21:31:07
Table '121' 8-max Seat #4 is the button
Seat 1: b1ee83fd (28,328 in chips)
Seat 2: 94692891 (66,824 in chips)
Seat 3: a988446d (8,770 in chips)
Seat 4: 35a7cc5 (5,965 in chips)
Seat 6: Hero (31,095 in chips)
Seat 7: 20bf27c2 (27,611 in chips)
Seat 8: fbf32a16 (34,196 in chips)
94692891: posts the ante 45
35a7cc5: posts the ante 45
b1ee83fd: posts the ante 45
a988446d: posts the ante 45
20bf27c2: posts the ante 45
Hero: posts the ante 45
fbf32a16: posts the ante 45
Hero: posts small blind 150
20bf27c2: posts big blind 300
*** HOLE CARDS ***
Dealt to b1ee83fd 
Dealt to 94692891 
Dealt to a988446d 
Dealt to 35a7cc5 
Dealt to Hero [4s Ah]
Dealt to 20bf27c2 
Dealt to fbf32a16 
fbf32a16: folds
b1ee83fd: calls 300
94692891: calls 300
a988446d: folds
35a7cc5: folds
Hero: calls 150
20bf27c2: checks
*** FLOP *** [5s Ks 6c]
Hero: checks
20bf27c2: checks
b1ee83fd: checks
94692891: checks
*** TURN *** [5s Ks 6c] [Kh]
Hero: checks
20bf27c2: checks
b1ee83fd: bets 500
94692891: folds
Hero: folds
20bf27c2: folds
Uncalled bet (500) returned to b1ee83fd
*** SHOWDOWN ***
b1ee83fd collected 1,515 from pot
*** SUMMARY ***
Total pot 1,515 | Rake 0 | Jackpot 0 | Bingo 0 | Fortune 0 | Tax 0
Board [5s Ks 6c Kh]
Seat 1: b1ee83fd won (1,515)
Seat 2: 94692891 folded on the Turn
Seat 3: a988446d folded before Flop
Seat 4: 35a7cc5 (button) folded before Flop
Seat 6: Hero (small blind) folded on the Turn
Seat 7: 20bf27c2 (big blind) folded on the Turn
Seat 8: fbf32a16 folded before Flop


Poker Hand #TM3449638421: Tournament #149964808, Bounty Hunters Special $1.08 Hold'em No Limit - Level6(150/300) - 2024/07/03 21:30:23
Table '121' 8-max Seat #3 is the button
Seat 1: b1ee83fd (28,373 in chips)
Seat 2: 94692891 (66,869 in chips)
Seat 3: a988446d (9,415 in chips)
Seat 4: 35a7cc5 (6,610 in chips)
Seat 6: Hero (31,740 in chips)
Seat 7: 20bf27c2 (25,541 in chips)
Seat 8: fbf32a16 (34,241 in chips)
94692891: posts the ante 45
35a7cc5: posts the ante 45
b1ee83fd: posts the ante 45
a988446d: posts the ante 45
20bf27c2: posts the ante 45
Hero: posts the ante 45
fbf32a16: posts the ante 45
35a7cc5: posts small blind 150
Hero: posts big blind 300
*** HOLE CARDS ***
Dealt to b1ee83fd 
Dealt to 94692891 
Dealt to a988446d 
Dealt to 35a7cc5 
Dealt to Hero [8d Qh]
Dealt to 20bf27c2 
Dealt to fbf32a16 
20bf27c2: raises 300 to 600
fbf32a16: folds
b1ee83fd: folds
94692891: folds
a988446d: calls 600
35a7cc5: calls 450
Hero: calls 300
*** FLOP *** [3s Kh 5d]
35a7cc5: checks
Hero: checks
20bf27c2: bets 900
a988446d: folds
35a7cc5: folds
Hero: folds
Uncalled bet (900) returned to 20bf27c2
*** SHOWDOWN ***
20bf27c2 collected 2,715 from pot
*** SUMMARY ***
Total pot 2,715 | Rake 0 | Jackpot 0 | Bingo 0 | Fortune 0 | Tax 0
Board [3s Kh 5d]
Seat 1: b1ee83fd folded before Flop
Seat 2: 94692891 folded before Flop
Seat 3: a988446d (button) folded on the Flop
Seat 4: 35a7cc5 (small blind) folded on the Flop
Seat 6: Hero (big blind) folded on the Flop
Seat 7: 20bf27c2 won (2,715)
Seat 8: fbf32a16 folded before Flop


Poker Hand #TM3449638342: Tournament #149964808, Bounty Hunters Special $1.08 Hold'em No Limit - Level6(150/300) - 2024/07/03 21:29:13
Table '121' 8-max Seat #2 is the button
Seat 1: b1ee83fd (29,318 in chips)
Seat 2: 94692891 (66,914 in chips)
Seat 3: a988446d (9,610 in chips)
Seat 4: 35a7cc5 (6,955 in chips)
Seat 5: 2ae15006 (10,000 in chips)
Seat 6: Hero (31,785 in chips)
Seat 7: 20bf27c2 (25,586 in chips)
Seat 8: fbf32a16 (22,621 in chips)
94692891: posts the ante 45
2ae15006: posts the ante 45
35a7cc5: posts the ante 45
b1ee83fd: posts the ante 45
a988446d: posts the ante 45
20bf27c2: posts the ante 45
Hero: posts the ante 45
fbf32a16: posts the ante 45
a988446d: posts small blind 150
35a7cc5: posts big blind 300
*** HOLE CARDS ***
Dealt to b1ee83fd 
Dealt to 94692891 
Dealt to a988446d 
Dealt to 35a7cc5 
Dealt to 2ae15006 
Dealt to Hero [7c 6h]
Dealt to 20bf27c2 
Dealt to fbf32a16 
2ae15006: raises 300 to 600
Hero: folds
20bf27c2: folds
fbf32a16: raises 300 to 900
b1ee83fd: calls 900
94692891: folds
a988446d: folds
35a7cc5: folds
2ae15006: raises 1,800 to 2,700
fbf32a16: raises 19,876 to 22,576 and is all-in
b1ee83fd: folds
2ae15006: calls 7,255 and is all-in
Uncalled bet (12,621) returned to fbf32a16
fbf32a16: shows [Ad Kh]
2ae15006: shows [2c Ac]
*** FLOP *** [9d Kd Jc]
*** TURN *** [9d Kd Jc] [5c]
*** RIVER *** [9d Kd Jc 5c] [Ks]
*** SHOWDOWN ***
fbf32a16 collected 21,620 from pot
*** SUMMARY ***
Total pot 21,620 | Rake 0 | Jackpot 0 | Bingo 0 | Fortune 0 | Tax 0
Board [9d Kd Jc 5c Ks]
Seat 1: b1ee83fd folded before Flop
Seat 2: 94692891 (button) folded before Flop
Seat 3: a988446d (small blind) folded before Flop
Seat 4: 35a7cc5 (big blind) folded before Flop
Seat 5: 2ae15006 showed [2c Ac] and lost with Pair of Kings
Seat 6: Hero folded before Flop
Seat 7: 20bf27c2 folded before Flop
Seat 8: fbf32a16 showed [Ad Kh] and won (21,620) with Three Kings


Poker Hand #TM3449638299: Tournament #149964808, Bounty Hunters Special $1.08 Hold'em No Limit - Level6(150/300) - 2024/07/03 21:28:35
Table '121' 8-max Seat #1 is the button
Seat 1: b1ee83fd (29,963 in chips)
Seat 2: 94692891 (65,144 in chips)
Seat 3: a988446d (9,955 in chips)
Seat 4: 35a7cc5 (7,000 in chips)
Seat 6: Hero (31,830 in chips)
Seat 7: 20bf27c2 (26,231 in chips)
Seat 8: fbf32a16 (22,666 in chips)
94692891: posts the ante 45
35a7cc5: posts the ante 45
b1ee83fd: posts the ante 45
a988446d: posts the ante 45
20bf27c2: posts the ante 45
Hero: posts the ante 45
fbf32a16: posts the ante 45
94692891: posts small blind 150
a988446d: posts big blind 300
*** HOLE CARDS ***
Dealt to b1ee83fd 
Dealt to 94692891 
Dealt to a988446d 
Dealt to 35a7cc5 
Dealt to Hero [Jc 2c]
Dealt to 20bf27c2 
Dealt to fbf32a16 
35a7cc5: folds
Hero: folds
20bf27c2: raises 300 to 600
fbf32a16: folds
b1ee83fd: calls 600
94692891: calls 450
a988446d: folds
*** FLOP *** [4c 3s 4d]
94692891: bets 797
20bf27c2: folds
b1ee83fd: folds
Uncalled bet (797) returned to 94692891
*** SHOWDOWN ***
94692891 collected 2,415 from pot
*** SUMMARY ***
Total pot 2,415 | Rake 0 | Jackpot 0 | Bingo 0 | Fortune 0 | Tax 0
Board [4c 3s 4d]
Seat 1: b1ee83fd (button) folded on the Flop
Seat 2: 94692891 (small blind) won (2,415)
Seat 3: a988446d (big blind) folded before Flop
Seat 4: 35a7cc5 folded before Flop
Seat 6: Hero folded before Flop
Seat 7: 20bf27c2 folded on the Flop
Seat 8: fbf32a16 folded before Flop


Poker Hand #TM3449638222: Tournament #149964808, Bounty Hunters Special $1.08 Hold'em No Limit - Level6(150/300) - 2024/07/03 21:27:29
Table '121' 8-max Seat #8 is the button
Seat 1: b1ee83fd (31,468 in chips)
Seat 2: 94692891 (60,449 in chips)
Seat 3: a988446d (10,000 in chips)
Seat 4: 35a7cc5 (7,045 in chips)
Seat 5: d4ffb028 (1,505 in chips)
Seat 6: Hero (33,335 in chips)
Seat 7: 20bf27c2 (26,276 in chips)
Seat 8: fbf32a16 (22,711 in chips)
94692891: posts the ante 45
35a7cc5: posts the ante 45
b1ee83fd: posts the ante 45
d4ffb028: posts the ante 45
a988446d: posts the ante 45
20bf27c2: posts the ante 45
Hero: posts the ante 45
fbf32a16: posts the ante 45
b1ee83fd: posts small blind 150
94692891: posts big blind 300
*** HOLE CARDS ***
Dealt to b1ee83fd 
Dealt to 94692891 
Dealt to a988446d 
Dealt to 35a7cc5 
Dealt to d4ffb028 
Dealt to Hero [2s Ts]
Dealt to 20bf27c2 
Dealt to fbf32a16 
a988446d: folds
35a7cc5: folds
d4ffb028: raises 1,160 to 1,460 and is all-in
Hero: calls 1,460
20bf27c2: folds
fbf32a16: folds
b1ee83fd: calls 1,310
94692891: calls 1,160
*** FLOP *** [Jd 2d 3d]
b1ee83fd: checks
94692891: bets 6,200
Hero: folds
b1ee83fd: folds
Uncalled bet (6,200) returned to 94692891
94692891: shows [Td Jh] (Pair of Jacks)
d4ffb028: shows [Kd Qd] (King High Flush)
*** TURN *** [Jd 2d 3d] [3h]
*** RIVER *** [Jd 2d 3d 3h] [Jc]
*** SHOWDOWN ***
94692891 collected 6,200 from pot
*** SUMMARY ***
Total pot 6,200 | Rake 0 | Jackpot 0 | Bingo 0 | Fortune 0 | Tax 0
Board [Jd 2d 3d 3h Jc]
Seat 1: b1ee83fd (small blind) folded on the Flop
Seat 2: 94692891 (big blind) showed [Td Jh] and won (6,200) with Jacks Full over Treys
Seat 3: a988446d folded before Flop
Seat 4: 35a7cc5 folded before Flop
Seat 5: d4ffb028 showed [Kd Qd] and lost with King High Flush
Seat 6: Hero folded on the Flop
Seat 7: 20bf27c2 folded before Flop
Seat 8: fbf32a16 (button) folded before Flop


Poker Hand #TM3449638086: Tournament #149964808, Bounty Hunters Special $1.08 Hold'em No Limit - Level5(125/250) - 2024/07/03 21:25:35
Table '121' 8-max Seat #7 is the button
Seat 1: b1ee83fd (32,685 in chips)
Seat 2: 94692891 (61,666 in chips)
Seat 4: 35a7cc5 (9,762 in chips)
Seat 5: d4ffb028 (10,000 in chips)
Seat 6: Hero (33,870 in chips)
Seat 7: 20bf27c2 (26,311 in chips)
Seat 8: fbf32a16 (8,495 in chips)
94692891: posts the ante 35
35a7cc5: posts the ante 35
b1ee83fd: posts the ante 35
d4ffb028: posts the ante 35
20bf27c2: posts the ante 35
Hero: posts the ante 35
fbf32a16: posts the ante 35
fbf32a16: posts small blind 125
b1ee83fd: posts big blind 250
*** HOLE CARDS ***
Dealt to b1ee83fd 
Dealt to 94692891 
Dealt to 35a7cc5 
Dealt to d4ffb028 
Dealt to Hero [Ts Kc]
Dealt to 20bf27c2 
Dealt to fbf32a16 
94692891: raises 250 to 500
35a7cc5: calls 500
d4ffb028: calls 500
Hero: calls 500
20bf27c2: folds
fbf32a16: calls 375
b1ee83fd: calls 250
*** FLOP *** [7h 6c 5d]
fbf32a16: bets 682
b1ee83fd: calls 682
94692891: calls 682
35a7cc5: calls 682
d4ffb028: calls 682
Hero: folds
*** TURN *** [7h 6c 5d] [7c]
fbf32a16: checks
b1ee83fd: checks
94692891: checks
35a7cc5: bets 1,500
d4ffb028: calls 1,500
fbf32a16: raises 5,778 to 7,278 and is all-in
b1ee83fd: folds
94692891: folds
35a7cc5: folds
d4ffb028: calls 5,778
fbf32a16: shows [6s 6h] (Sixes Full over Sevens)
d4ffb028: shows [Jh 8c] (Pair of Sevens)
*** RIVER *** [7h 6c 5d 7c] [3h]
*** SHOWDOWN ***
fbf32a16 collected 22,711 from pot
*** SUMMARY ***
Total pot 22,711 | Rake 0 | Jackpot 0 | Bingo 0 | Fortune 0 | Tax 0
Board [7h 6c 5d 7c 3h]
Seat 1: b1ee83fd (big blind) folded on the Turn
Seat 2: 94692891 folded on the Turn
Seat 4: 35a7cc5 folded on the Turn
Seat 5: d4ffb028 showed [Jh 8c] and lost with Pair of Sevens
Seat 6: Hero folded on the Flop
Seat 7: 20bf27c2 (button) folded before Flop
Seat 8: fbf32a16 (small blind) showed [6s 6h] and won (22,711) with Sixes Full over Sevens


Poker Hand #TM3449638016: Tournament #149964808, Bounty Hunters Special $1.08 Hold'em No Limit - Level5(125/250) - 2024/07/03 21:24:42
Table '121' 8-max Seat #6 is the button
Seat 1: b1ee83fd (32,970 in chips)
Seat 2: 94692891 (61,951 in chips)
Seat 3: 70a28fa5 (3,396 in chips)
Seat 4: 35a7cc5 (9,797 in chips)
Seat 6: Hero (37,266 in chips)
Seat 7: 20bf27c2 (18,629 in chips)
Seat 8: fbf32a16 (8,780 in chips)
94692891: posts the ante 35
35a7cc5: posts the ante 35
b1ee83fd: posts the ante 35
Hero: posts the ante 35
70a28fa5: posts the ante 35
20bf27c2: posts the ante 35
fbf32a16: posts the ante 35
20bf27c2: posts small blind 125
fbf32a16: posts big blind 250
*** HOLE CARDS ***
Dealt to b1ee83fd 
Dealt to 94692891 
Dealt to 70a28fa5 
Dealt to 35a7cc5 
Dealt to Hero [Ks 6s]
Dealt to 20bf27c2 
Dealt to fbf32a16 
b1ee83fd: calls 250
94692891: calls 250
70a28fa5: raises 3,111 to 3,361 and is all-in
35a7cc5: folds
Hero: calls 3,361
20bf27c2: raises 15,233 to 18,594 and is all-in
fbf32a16: folds
b1ee83fd: folds
94692891: folds
Hero: folds
Uncalled bet (15,233) returned to 20bf27c2
20bf27c2: shows [9h 9d]
70a28fa5: shows [9c Ad]
*** FLOP *** [4s Js Kh]
*** TURN *** [4s Js Kh] [Kd]
*** RIVER *** [4s Js Kh Kd] [7d]
Hero: shows [Ks 6s] (Three Kings)
*** SHOWDOWN ***
20bf27c2 collected 11,078 from pot
*** SUMMARY ***
Total pot 11,078 | Rake 0 | Jackpot 0 | Bingo 0 | Fortune 0 | Tax 0
Board [4s Js Kh Kd 7d]
Seat 1: b1ee83fd folded before Flop
Seat 2: 94692891 folded before Flop
Seat 3: 70a28fa5 showed [9c Ad] and lost with Pair of Kings
Seat 4: 35a7cc5 folded before Flop
Seat 6: Hero (button) folded before Flop
Seat 7: 20bf27c2 (small blind) showed [9h 9d] and won (11,078) with Pair of Kings and Pair of Nines
Seat 8: fbf32a16 (big blind) folded before Flop


Poker Hand #TM3449637973: Tournament #149964808, Bounty Hunters Special $1.08 Hold'em No Limit - Level5(125/250) - 2024/07/03 21:24:12
Table '121' 8-max Seat #4 is the button
Seat 1: b1ee83fd (33,005 in chips)
Seat 2: 94692891 (62,236 in chips)
Seat 3: 70a28fa5 (3,431 in chips)
Seat 4: 35a7cc5 (8,962 in chips)
Seat 6: Hero (37,426 in chips)
Seat 7: 20bf27c2 (18,914 in chips)
Seat 8: fbf32a16 (8,815 in chips)
94692891: posts the ante 35
35a7cc5: posts the ante 35
b1ee83fd: posts the ante 35
70a28fa5: posts the ante 35
20bf27c2: posts the ante 35
Hero: posts the ante 35
fbf32a16: posts the ante 35
Hero: posts small blind 125
20bf27c2: posts big blind 250
*** HOLE CARDS ***
Dealt to b1ee83fd 
Dealt to 94692891 
Dealt to 70a28fa5 
Dealt to 35a7cc5 
Dealt to Hero [3s 2d]
Dealt to 20bf27c2 
Dealt to fbf32a16 
fbf32a16: folds
b1ee83fd: folds
94692891: calls 250
70a28fa5: folds
35a7cc5: raises 750 to 1,000
Hero: folds
20bf27c2: folds
94692891: folds
Uncalled bet (750) returned to 35a7cc5
*** SHOWDOWN ***
35a7cc5 collected 1,120 from pot
*** SUMMARY ***
Total pot 1,120 | Rake 0 | Jackpot 0 | Bingo 0 | Fortune 0 | Tax 0
Seat 1: b1ee83fd folded before Flop
Seat 2: 94692891 folded before Flop
Seat 3: 70a28fa5 folded before Flop
Seat 4: 35a7cc5 (button) collected (1,120)
Seat 6: Hero (small blind) folded before Flop
Seat 7: 20bf27c2 (big blind) folded before Flop
Seat 8: fbf32a16 folded before Flop


Poker Hand #TM3449637898: Tournament #149964808, Bounty Hunters Special $1.08 Hold'em No Limit - Level5(125/250) - 2024/07/03 21:23:05
Table '121' 8-max Seat #3 is the button
Seat 1: b1ee83fd (33,665 in chips)
Seat 2: 94692891 (46,510 in chips)
Seat 3: 70a28fa5 (3,466 in chips)
Seat 4: 35a7cc5 (9,122 in chips)
Seat 5: 773e2010 (13,516 in chips)
Seat 6: Hero (38,086 in chips)
Seat 7: 20bf27c2 (19,574 in chips)
Seat 8: fbf32a16 (8,850 in chips)
94692891: posts the ante 35
773e2010: posts the ante 35
35a7cc5: posts the ante 35
b1ee83fd: posts the ante 35
70a28fa5: posts the ante 35
20bf27c2: posts the ante 35
Hero: posts the ante 35
fbf32a16: posts the ante 35
35a7cc5: posts small blind 125
773e2010: posts big blind 250
*** HOLE CARDS ***
Dealt to b1ee83fd 
Dealt to 94692891 
Dealt to 70a28fa5 
Dealt to 35a7cc5 
Dealt to 773e2010 
Dealt to Hero [Ad Qd]
Dealt to 20bf27c2 
Dealt to fbf32a16 
Hero: raises 375 to 625
20bf27c2: calls 625
fbf32a16: folds
b1ee83fd: calls 625
94692891: calls 625
70a28fa5: folds
35a7cc5: folds
773e2010: calls 375
*** FLOP *** [5c 6c 2c]
773e2010: bets 1,165
Hero: folds
20bf27c2: folds
b1ee83fd: folds
94692891: raises 2,930 to 4,095
773e2010: calls 2,930
*** TURN *** [5c 6c 2c] [Jd]
773e2010: bets 8,761 and is all-in
94692891: calls 8,761
773e2010: shows [3s Qc] (Queen-High)
94692891: shows [7d Ac] (Ace-High)
*** RIVER *** [5c 6c 2c Jd] [9c]
*** SHOWDOWN ***
94692891 collected 29,242 from pot
*** SUMMARY ***
Total pot 29,242 | Rake 0 | Jackpot 0 | Bingo 0 | Fortune 0 | Tax 0
Board [5c 6c 2c Jd 9c]
Seat 1: b1ee83fd folded on the Flop
Seat 2: 94692891 showed [7d Ac] and won (29,242) with Ace High Flush
Seat 3: 70a28fa5 (button) folded before Flop
Seat 4: 35a7cc5 (small blind) folded before Flop
Seat 5: 773e2010 (big blind) showed [3s Qc] and lost with Queen High Flush
Seat 6: Hero folded on the Flop
Seat 7: 20bf27c2 folded on the Flop
Seat 8: fbf32a16 folded before Flop


Poker Hand #TM3449637825: Tournament #149964808, Bounty Hunters Special $1.08 Hold'em No Limit - Level5(125/250) - 2024/07/03 21:22:06
Table '121' 8-max Seat #2 is the button
Seat 1: b1ee83fd (34,325 in chips)
Seat 2: 94692891 (46,545 in chips)
Seat 3: 70a28fa5 (3,626 in chips)
Seat 4: 35a7cc5 (9,407 in chips)
Seat 5: 773e2010 (13,551 in chips)
Seat 6: Hero (40,826 in chips)
Seat 7: 20bf27c2 (15,624 in chips)
Seat 8: fbf32a16 (8,885 in chips)
94692891: posts the ante 35
773e2010: posts the ante 35
35a7cc5: posts the ante 35
b1ee83fd: posts the ante 35
20bf27c2: posts the ante 35
Hero: posts the ante 35
70a28fa5: posts the ante 35
fbf32a16: posts the ante 35
70a28fa5: posts small blind 125
35a7cc5: posts big blind 250
*** HOLE CARDS ***
Dealt to b1ee83fd 
Dealt to 94692891 
Dealt to 70a28fa5 
Dealt to 35a7cc5 
Dealt to 773e2010 
Dealt to Hero [Kd Ad]
Dealt to 20bf27c2 
Dealt to fbf32a16 
773e2010: folds
Hero: raises 375 to 625
20bf27c2: calls 625
fbf32a16: folds
b1ee83fd: calls 625
94692891: folds
70a28fa5: folds
35a7cc5: folds
*** FLOP *** [3d 3s 5c]
Hero: checks
20bf27c2: bets 750
b1ee83fd: folds
Hero: calls 750
*** TURN *** [3d 3s 5c] [Js]
Hero: checks
20bf27c2: checks
*** RIVER *** [3d 3s 5c Js] [7c]
Hero: bets 1,330
20bf27c2: raises 3,830 to 5,160
Hero: folds
Uncalled bet (3,830) returned to 20bf27c2
*** SHOWDOWN ***
20bf27c2 collected 6,690 from pot
*** SUMMARY ***
Total pot 6,690 | Rake 0 | Jackpot 0 | Bingo 0 | Fortune 0 | Tax 0
Board [3d 3s 5c Js 7c]
Seat 1: b1ee83fd folded on the Flop
Seat 2: 94692891 (button) folded before Flop
Seat 3: 70a28fa5 (small blind) folded before Flop
Seat 4: 35a7cc5 (big blind) folded before Flop
Seat 5: 773e2010 folded before Flop
Seat 6: Hero folded on the River
Seat 7: 20bf27c2 won (6,690)
Seat 8: fbf32a16 folded before Flop


Poker Hand #TM3449637788: Tournament #149964808, Bounty Hunters Special $1.08 Hold'em No Limit - Level5(125/250) - 2024/07/03 21:21:33
Table '121' 8-max Seat #1 is the button
Seat 1: b1ee83fd (33,205 in chips)
Seat 2: 94692891 (46,705 in chips)
Seat 3: 70a28fa5 (3,911 in chips)
Seat 4: 35a7cc5 (9,442 in chips)
Seat 5: 773e2010 (13,586 in chips)
Seat 6: Hero (40,861 in chips)
Seat 7: 20bf27c2 (15,659 in chips)
Seat 8: fbf32a16 (9,420 in chips)
94692891: posts the ante 35
773e2010: posts the ante 35
35a7cc5: posts the ante 35
b1ee83fd: posts the ante 35
20bf27c2: posts the ante 35
Hero: posts the ante 35
70a28fa5: posts the ante 35
fbf32a16: posts the ante 35
94692891: posts small blind 125
70a28fa5: posts big blind 250
*** HOLE CARDS ***
Dealt to b1ee83fd 
Dealt to 94692891 
Dealt to 70a28fa5 
Dealt to 35a7cc5 
Dealt to 773e2010 
Dealt to Hero [3c Kc]
Dealt to 20bf27c2 
Dealt to fbf32a16 
35a7cc5: folds
773e2010: folds
Hero: folds
20bf27c2: folds
fbf32a16: raises 250 to 500
b1ee83fd: raises 9,500 to 10,000
94692891: folds
70a28fa5: folds
fbf32a16: folds
Uncalled bet (9,500) returned to b1ee83fd
*** SHOWDOWN ***
b1ee83fd collected 1,655 from pot
*** SUMMARY ***
Total pot 1,655 | Rake 0 | Jackpot 0 | Bingo 0 | Fortune 0 | Tax 0
Seat 1: b1ee83fd (button) collected (1,655)
Seat 2: 94692891 (small blind) folded before Flop
Seat 3: 70a28fa5 (big blind) folded before Flop
Seat 4: 35a7cc5 folded before Flop
Seat 5: 773e2010 folded before Flop
Seat 6: Hero folded before Flop
Seat 7: 20bf27c2 folded before Flop
Seat 8: fbf32a16 folded before Flop


Poker Hand #TM3449637719: Tournament #149964808, Bounty Hunters Special $1.08 Hold'em No Limit - Level5(125/250) - 2024/07/03 21:20:34
Table '121' 8-max Seat #8 is the button
Seat 1: b1ee83fd (33,365 in chips)
Seat 2: 94692891 (46,990 in chips)
Seat 3: 70a28fa5 (3,946 in chips)
Seat 4: 35a7cc5 (9,477 in chips)
Seat 5: 773e2010 (11,255 in chips)
Seat 6: Hero (42,607 in chips)
Seat 7: 20bf27c2 (15,694 in chips)
Seat 8: fbf32a16 (9,455 in chips)
94692891: posts the ante 35
773e2010: posts the ante 35
35a7cc5: posts the ante 35
b1ee83fd: posts the ante 35
20bf27c2: posts the ante 35
Hero: posts the ante 35
70a28fa5: posts the ante 35
fbf32a16: posts the ante 35
b1ee83fd: posts small blind 125
94692891: posts big blind 250
*** HOLE CARDS ***
Dealt to b1ee83fd 
Dealt to 94692891 
Dealt to 70a28fa5 
Dealt to 35a7cc5 
Dealt to 773e2010 
Dealt to Hero [Qh Ah]
Dealt to 20bf27c2 
Dealt to fbf32a16 
70a28fa5: folds
35a7cc5: folds
773e2010: raises 325 to 575
Hero: raises 325 to 900
20bf27c2: folds
fbf32a16: folds
b1ee83fd: folds
94692891: folds
773e2010: calls 325
*** FLOP *** [Kd 2s 5d]
773e2010: checks
Hero: checks
*** TURN *** [Kd 2s 5d] [Jc]
773e2010: checks
Hero: bets 811
773e2010: calls 811
*** RIVER *** [Kd 2s 5d Jc] [7d]
773e2010: checks
Hero: checks
773e2010: shows [9c 9s] (Pair of Nines)
Hero: shows [Qh Ah] (Ace-High)
*** SHOWDOWN ***
773e2010 collected 4,077 from pot
*** SUMMARY ***
Total pot 4,077 | Rake 0 | Jackpot 0 | Bingo 0 | Fortune 0 | Tax 0
Board [Kd 2s 5d Jc 7d]
Seat 1: b1ee83fd (small blind) folded before Flop
Seat 2: 94692891 (big blind) folded before Flop
Seat 3: 70a28fa5 folded before Flop
Seat 4: 35a7cc5 folded before Flop
Seat 5: 773e2010 showed [9c 9s] and won (4,077) with Pair of Nines
Seat 6: Hero showed [Qh Ah] and lost with Ace-High
Seat 7: 20bf27c2 folded before Flop
Seat 8: fbf32a16 (button) folded before Flop


Poker Hand #TM3449637661: Tournament #149964808, Bounty Hunters Special $1.08 Hold'em No Limit - Level5(125/250) - 2024/07/03 21:19:47
Table '121' 8-max Seat #7 is the button
Seat 1: b1ee83fd (30,917 in chips)
Seat 2: 94692891 (47,275 in chips)
Seat 3: 70a28fa5 (3,981 in chips)
Seat 4: 35a7cc5 (11,340 in chips)
Seat 5: 773e2010 (11,290 in chips)
Seat 6: Hero (42,642 in chips)
Seat 7: 20bf27c2 (15,729 in chips)
Seat 8: fbf32a16 (9,615 in chips)
94692891: posts the ante 35
773e2010: posts the ante 35
35a7cc5: posts the ante 35
b1ee83fd: posts the ante 35
20bf27c2: posts the ante 35
Hero: posts the ante 35
70a28fa5: posts the ante 35
fbf32a16: posts the ante 35
fbf32a16: posts small blind 125
b1ee83fd: posts big blind 250
*** HOLE CARDS ***
Dealt to b1ee83fd 
Dealt to 94692891 
Dealt to 70a28fa5 
Dealt to 35a7cc5 
Dealt to 773e2010 
Dealt to Hero [Kd 3h]
Dealt to 20bf27c2 
Dealt to fbf32a16 
94692891: calls 250
70a28fa5: folds
35a7cc5: raises 500 to 750
773e2010: folds
Hero: folds
20bf27c2: folds
fbf32a16: folds
b1ee83fd: calls 500
94692891: folds
*** FLOP *** [8c Qd Ts]
b1ee83fd: checks
35a7cc5: bets 1,078
b1ee83fd: calls 1,078
*** TURN *** [8c Qd Ts] [8h]
b1ee83fd: checks
35a7cc5: checks
*** RIVER *** [8c Qd Ts 8h] [2h]
b1ee83fd: checks
35a7cc5: checks
b1ee83fd: shows [Ah Kc] (Pair of Eights)
35a7cc5: shows [9h Ks] (Pair of Eights)
*** SHOWDOWN ***
b1ee83fd collected 4,311 from pot
*** SUMMARY ***
Total pot 4,311 | Rake 0 | Jackpot 0 | Bingo 0 | Fortune 0 | Tax 0
Board [8c Qd Ts 8h 2h]
Seat 1: b1ee83fd (big blind) showed [Ah Kc] and won (4,311) with Pair of Eights
Seat 2: 94692891 folded before Flop
Seat 3: 70a28fa5 folded before Flop
Seat 4: 35a7cc5 showed [9h Ks] and lost with Pair of Eights
Seat 5: 773e2010 folded before Flop
Seat 6: Hero folded before Flop
Seat 7: 20bf27c2 (button) folded before Flop
Seat 8: fbf32a16 (small blind) folded before Flop


Poker Hand #TM3449637605: Tournament #149964808, Bounty Hunters Special $1.08 Hold'em No Limit - Level5(125/250) - 2024/07/03 21:18:53
Table '121' 8-max Seat #6 is the button
Seat 1: b1ee83fd (30,952 in chips)
Seat 2: 94692891 (47,310 in chips)
Seat 3: 70a28fa5 (4,016 in chips)
Seat 4: 35a7cc5 (11,375 in chips)
Seat 5: 773e2010 (10,220 in chips)
Seat 6: Hero (42,677 in chips)
Seat 7: 20bf27c2 (16,339 in chips)
Seat 8: fbf32a16 (9,900 in chips)
94692891: posts the ante 35
773e2010: posts the ante 35
35a7cc5: posts the ante 35
b1ee83fd: posts the ante 35
Hero: posts the ante 35
70a28fa5: posts the ante 35
20bf27c2: posts the ante 35
fbf32a16: posts the ante 35
20bf27c2: posts small blind 125
fbf32a16: posts big blind 250
*** HOLE CARDS ***
Dealt to b1ee83fd 
Dealt to 94692891 
Dealt to 70a28fa5 
Dealt to 35a7cc5 
Dealt to 773e2010 
Dealt to Hero [4s Ks]
Dealt to 20bf27c2 
Dealt to fbf32a16 
b1ee83fd: folds
94692891: folds
70a28fa5: folds
35a7cc5: folds
773e2010: raises 325 to 575
Hero: folds
20bf27c2: calls 450
fbf32a16: folds
*** FLOP *** [9h 3d 4h]
20bf27c2: checks
773e2010: bets 1,109
20bf27c2: folds
Uncalled bet (1,109) returned to 773e2010
*** SHOWDOWN ***
773e2010 collected 1,680 from pot
*** SUMMARY ***
Total pot 1,680 | Rake 0 | Jackpot 0 | Bingo 0 | Fortune 0 | Tax 0
Board [9h 3d 4h]
Seat 1: b1ee83fd folded before Flop
Seat 2: 94692891 folded before Flop
Seat 3: 70a28fa5 folded before Flop
Seat 4: 35a7cc5 folded before Flop
Seat 5: 773e2010 won (1,680)
Seat 6: Hero (button) folded before Flop
Seat 7: 20bf27c2 (small blind) folded on the Flop
Seat 8: fbf32a16 (big blind) folded before Flop


Poker Hand #TM3449637570: Tournament #149964808, Bounty Hunters Special $1.08 Hold'em No Limit - Level5(125/250) - 2024/07/03 21:18:26
Table '121' 8-max Seat #5 is the button
Seat 1: b1ee83fd (30,987 in chips)
Seat 2: 94692891 (47,595 in chips)
Seat 3: 70a28fa5 (4,051 in chips)
Seat 4: 35a7cc5 (11,410 in chips)
Seat 5: 773e2010 (9,350 in chips)
Seat 6: Hero (42,837 in chips)
Seat 7: 20bf27c2 (16,624 in chips)
Seat 8: fbf32a16 (9,935 in chips)
94692891: posts the ante 35
773e2010: posts the ante 35
35a7cc5: posts the ante 35
b1ee83fd: posts the ante 35
70a28fa5: posts the ante 35
20bf27c2: posts the ante 35
Hero: posts the ante 35
fbf32a16: posts the ante 35
Hero: posts small blind 125
20bf27c2: posts big blind 250
*** HOLE CARDS ***
Dealt to b1ee83fd 
Dealt to 94692891 
Dealt to 70a28fa5 
Dealt to 35a7cc5 
Dealt to 773e2010 
Dealt to Hero [3s 7d]
Dealt to 20bf27c2 
Dealt to fbf32a16 
fbf32a16: folds
b1ee83fd: folds
94692891: calls 250
70a28fa5: folds
35a7cc5: folds
773e2010: raises 750 to 1,000
Hero: folds
20bf27c2: folds
94692891: folds
Uncalled bet (750) returned to 773e2010
*** SHOWDOWN ***
773e2010 collected 1,155 from pot
*** SUMMARY ***
Total pot 1,155 | Rake 0 | Jackpot 0 | Bingo 0 | Fortune 0 | Tax 0
Seat 1: b1ee83fd folded before Flop
Seat 2: 94692891 folded before Flop
Seat 3: 70a28fa5 folded before Flop
Seat 4: 35a7cc5 folded before Flop
Seat 5: 773e2010 (button) collected (1,155)
Seat 6: Hero (small blind) folded before Flop
Seat 7: 20bf27c2 (big blind) folded before Flop
Seat 8: fbf32a16 folded before Flop


Poker Hand #TM3449637523: Tournament #149964808, Bounty Hunters Special $1.08 Hold'em No Limit - Level5(125/250) - 2024/07/03 21:17:46
Table '121' 8-max Seat #4 is the button
Seat 1: b1ee83fd (31,522 in chips)
Seat 2: 94692891 (47,630 in chips)
Seat 3: 70a28fa5 (4,086 in chips)
Seat 4: 35a7cc5 (10,290 in chips)
Seat 5: 773e2010 (9,510 in chips)
Seat 6: Hero (43,122 in chips)
Seat 7: 20bf27c2 (16,659 in chips)
Seat 8: fbf32a16 (9,970 in chips)
94692891: posts the ante 35
773e2010: posts the ante 35
35a7cc5: posts the ante 35
b1ee83fd: posts the ante 35
70a28fa5: posts the ante 35
20bf27c2: posts the ante 35
Hero: posts the ante 35
fbf32a16: posts the ante 35
773e2010: posts small blind 125
Hero: posts big blind 250
*** HOLE CARDS ***
Dealt to b1ee83fd 
Dealt to 94692891 
Dealt to 70a28fa5 
Dealt to 35a7cc5 
Dealt to 773e2010 
Dealt to Hero [Ad 2d]
Dealt to 20bf27c2 
Dealt to fbf32a16 
20bf27c2: folds
fbf32a16: folds
b1ee83fd: raises 250 to 500
94692891: folds
70a28fa5: folds
35a7cc5: raises 9,755 to 10,255 and is all-in
773e2010: folds
Hero: folds
b1ee83fd: folds
Uncalled bet (9,755) returned to 35a7cc5
*** SHOWDOWN ***
35a7cc5 collected 1,655 from pot
*** SUMMARY ***
Total pot 1,655 | Rake 0 | Jackpot 0 | Bingo 0 | Fortune 0 | Tax 0
Seat 1: b1ee83fd folded before Flop
Seat 2: 94692891 folded before Flop
Seat 3: 70a28fa5 folded before Flop
Seat 4: 35a7cc5 (button) collected (1,655)
Seat 5: 773e2010 (small blind) folded before Flop
Seat 6: Hero (big blind) folded before Flop
Seat 7: 20bf27c2 folded before Flop
Seat 8: fbf32a16 folded before Flop


Poker Hand #TM3449637458: Tournament #149964808, Bounty Hunters Special $1.08 Hold'em No Limit - Level4(100/200) - 2024/07/03 21:16:50
Table '121' 8-max Seat #3 is the button
Seat 1: b1ee83fd (31,952 in chips)
Seat 2: 94692891 (47,660 in chips)
Seat 3: 70a28fa5 (4,116 in chips)
Seat 4: 35a7cc5 (9,280 in chips)
Seat 5: 773e2010 (9,940 in chips)
Seat 6: Hero (43,152 in chips)
Seat 7: 20bf27c2 (16,689 in chips)
Seat 8: fbf32a16 (10,000 in chips)
94692891: posts the ante 30
773e2010: posts the ante 30
35a7cc5: posts the ante 30
b1ee83fd: posts the ante 30
70a28fa5: posts the ante 30
20bf27c2: posts the ante 30
Hero: posts the ante 30
fbf32a16: posts the ante 30
35a7cc5: posts small blind 100
773e2010: posts big blind 200
*** HOLE CARDS ***
Dealt to b1ee83fd 
Dealt to 94692891 
Dealt to 70a28fa5 
Dealt to 35a7cc5 
Dealt to 773e2010 
Dealt to Hero [3c Th]
Dealt to 20bf27c2 
Dealt to fbf32a16 
Hero: folds
20bf27c2: folds
fbf32a16: folds
b1ee83fd: raises 200 to 400
94692891: folds
70a28fa5: folds
35a7cc5: calls 300
773e2010: calls 200
*** FLOP *** [2s 2c 2h]
35a7cc5: checks
773e2010: checks
b1ee83fd: checks
*** TURN *** [2s 2c 2h] [Js]
35a7cc5: bets 476
773e2010: folds
b1ee83fd: folds
Uncalled bet (476) returned to 35a7cc5
*** SHOWDOWN ***
35a7cc5 collected 1,440 from pot
*** SUMMARY ***
Total pot 1,440 | Rake 0 | Jackpot 0 | Bingo 0 | Fortune 0 | Tax 0
Board [2s 2c 2h Js]
Seat 1: b1ee83fd folded on the Turn
Seat 2: 94692891 folded before Flop
Seat 3: 70a28fa5 (button) folded before Flop
Seat 4: 35a7cc5 (small blind) won (1,440)
Seat 5: 773e2010 (big blind) folded on the Turn
Seat 6: Hero folded before Flop
Seat 7: 20bf27c2 folded before Flop
Seat 8: fbf32a16 folded before Flop


Poker Hand #TM3449637384: Tournament #149964808, Bounty Hunters Special $1.08 Hold'em No Limit - Level4(100/200) - 2024/07/03 21:15:54
Table '121' 8-max Seat #2 is the button
Seat 1: b1ee83fd (27,053 in chips)
Seat 2: 94692891 (47,890 in chips)
Seat 3: 70a28fa5 (4,246 in chips)
Seat 4: 35a7cc5 (9,510 in chips)
Seat 5: 773e2010 (9,970 in chips)
Seat 6: Hero (43,182 in chips)
Seat 7: 20bf27c2 (20,938 in chips)
94692891: posts the ante 30
773e2010: posts the ante 30
35a7cc5: posts the ante 30
b1ee83fd: posts the ante 30
20bf27c2: posts the ante 30
Hero: posts the ante 30
70a28fa5: posts the ante 30
70a28fa5: posts small blind 100
35a7cc5: posts big blind 200
*** HOLE CARDS ***
Dealt to b1ee83fd 
Dealt to 94692891 
Dealt to 70a28fa5 
Dealt to 35a7cc5 
Dealt to 773e2010 
Dealt to Hero [8c 4d]
Dealt to 20bf27c2 
773e2010: folds
Hero: folds
20bf27c2: calls 200
b1ee83fd: calls 200
94692891: calls 200
70a28fa5: folds
35a7cc5: checks
*** FLOP *** [Td 4c Qd]
35a7cc5: checks
20bf27c2: bets 600
b1ee83fd: calls 600
94692891: folds
35a7cc5: folds
*** TURN *** [Td 4c Qd] [2s]
20bf27c2: bets 600
b1ee83fd: calls 600
*** RIVER *** [Td 4c Qd 2s] [8h]
20bf27c2: bets 1,000
b1ee83fd: raises 1,819 to 2,819
20bf27c2: calls 1,819
b1ee83fd: shows [Qc 9d] (Pair of Queens)
20bf27c2: shows [7h Qh] (Pair of Queens)
*** SHOWDOWN ***
b1ee83fd collected 9,148 from pot
*** SUMMARY ***
Total pot 9,148 | Rake 0 | Jackpot 0 | Bingo 0 | Fortune 0 | Tax 0
Board [Td 4c Qd 2s 8h]
Seat 1: b1ee83fd showed [Qc 9d] and won (9,148) with Pair of Queens
Seat 2: 94692891 (button) folded on the Flop
Seat 3: 70a28fa5 (small blind) folded before Flop
Seat 4: 35a7cc5 (big blind) folded on the Flop
Seat 5: 773e2010 folded before Flop
Seat 6: Hero folded before Flop
Seat 7: 20bf27c2 showed [7h Qh] and lost with Pair of Queens


Poker Hand #TM3449637311: Tournament #149964808, Bounty Hunters Special $1.08 Hold'em No Limit - Level4(100/200) - 2024/07/03 21:14:55
Table '121' 8-max Seat #1 is the button
Seat 1: b1ee83fd (27,083 in chips)
Seat 2: 94692891 (41,430 in chips)
Seat 3: 70a28fa5 (4,476 in chips)
Seat 4: 35a7cc5 (9,540 in chips)
Seat 5: 773e2010 (10,000 in chips)
Seat 6: Hero (43,212 in chips)
Seat 7: 20bf27c2 (20,968 in chips)
Seat 8: fdd0a515 (6,080 in chips)
94692891: posts the ante 30
773e2010: posts the ante 30
fdd0a515: posts the ante 30
35a7cc5: posts the ante 30
b1ee83fd: posts the ante 30
20bf27c2: posts the ante 30
Hero: posts the ante 30
70a28fa5: posts the ante 30
94692891: posts small blind 100
70a28fa5: posts big blind 200
*** HOLE CARDS ***
Dealt to b1ee83fd 
Dealt to 94692891 
Dealt to 70a28fa5 
Dealt to 35a7cc5 
Dealt to 773e2010 
Dealt to Hero [6c Qh]
Dealt to 20bf27c2 
Dealt to fdd0a515 
35a7cc5: folds
773e2010: folds
Hero: folds
20bf27c2: folds
fdd0a515: raises 220 to 420
b1ee83fd: folds
94692891: calls 320
70a28fa5: folds
*** FLOP *** [9c 8d 4h]
94692891: checks
fdd0a515: bets 436
94692891: raises 1,614 to 2,050
fdd0a515: calls 1,614
*** TURN *** [9c 8d 4h] [2h]
94692891: bets 5,380
fdd0a515: calls 3,580 and is all-in
Uncalled bet (1,800) returned to 94692891
94692891: shows [4d 5h] (Pair of Fours)
fdd0a515: shows [8h Jh] (Pair of Eights)
*** RIVER *** [9c 8d 4h 2h] [5d]
*** SHOWDOWN ***
94692891 collected 12,540 from pot
*** SUMMARY ***
Total pot 12,540 | Rake 0 | Jackpot 0 | Bingo 0 | Fortune 0 | Tax 0
Board [9c 8d 4h 2h 5d]
Seat 1: b1ee83fd (button) folded before Flop
Seat 2: 94692891 (small blind) showed [4d 5h] and won (12,540) with Pair of Fives and Pair of Fours
Seat 3: 70a28fa5 (big blind) folded before Flop
Seat 4: 35a7cc5 folded before Flop
Seat 5: 773e2010 folded before Flop
Seat 6: Hero folded before Flop
Seat 7: 20bf27c2 folded before Flop
Seat 8: fdd0a515 showed [8h Jh] and lost with Pair of Eights


Poker Hand #TM3449637233: Tournament #149964808, Bounty Hunters Special $1.08 Hold'em No Limit - Level4(100/200) - 2024/07/03 21:13:57
Table '121' 8-max Seat #8 is the button
Seat 1: b1ee83fd (9,142 in chips)
Seat 2: 94692891 (50,572 in chips)
Seat 3: 70a28fa5 (4,906 in chips)
Seat 4: 35a7cc5 (9,970 in chips)
Seat 5: 148547c3 (7,849 in chips)
Seat 6: Hero (43,242 in chips)
Seat 7: 20bf27c2 (20,998 in chips)
Seat 8: fdd0a515 (6,110 in chips)
94692891: posts the ante 30
fdd0a515: posts the ante 30
148547c3: posts the ante 30
35a7cc5: posts the ante 30
b1ee83fd: posts the ante 30
20bf27c2: posts the ante 30
Hero: posts the ante 30
70a28fa5: posts the ante 30
b1ee83fd: posts small blind 100
94692891: posts big blind 200
*** HOLE CARDS ***
Dealt to b1ee83fd 
Dealt to 94692891 
Dealt to 70a28fa5 
Dealt to 35a7cc5 
Dealt to 148547c3 
Dealt to Hero [5s 9d]
Dealt to 20bf27c2 
Dealt to fdd0a515 
70a28fa5: raises 200 to 400
35a7cc5: calls 400
148547c3: raises 1,305 to 1,705
Hero: folds
20bf27c2: folds
fdd0a515: folds
b1ee83fd: calls 1,605
94692891: calls 1,505
70a28fa5: folds
35a7cc5: folds
*** FLOP *** [3d 2s 8h]
b1ee83fd: checks
94692891: bets 46,600
148547c3: calls 6,114 and is all-in
b1ee83fd: calls 7,407 and is all-in
Uncalled bet (39,193) returned to 94692891
94692891: shows [Ac 3c] (Pair of Treys)
148547c3: shows [7s 7c] (Pair of Sevens)
b1ee83fd: shows [7h 8d] (Pair of Eights)
*** TURN *** [3d 2s 8h] [5h]
*** RIVER *** [3d 2s 8h 5h] [8s]
*** SHOWDOWN ***
b1ee83fd collected 24,497 from pot
b1ee83fd collected 2,586 from pot
*** SUMMARY ***
Total pot 27,083 | Rake 0 | Jackpot 0 | Bingo 0 | Fortune 0 | Tax 0
Board [3d 2s 8h 5h 8s]
Seat 1: b1ee83fd (small blind) showed [7h 8d] and won (27,083) with Three Eights
Seat 2: 94692891 (big blind) showed [Ac 3c] and lost with Pair of Eights and Pair of Treys
Seat 3: 70a28fa5 folded before Flop
Seat 4: 35a7cc5 folded before Flop
Seat 5: 148547c3 showed [7s 7c] and lost with Pair of Eights and Pair of Sevens
Seat 6: Hero folded before Flop
Seat 7: 20bf27c2 folded before Flop
Seat 8: fdd0a515 (button) folded before Flop


Poker Hand #TM3449637172: Tournament #149964808, Bounty Hunters Special $1.08 Hold'em No Limit - Level4(100/200) - 2024/07/03 21:13:08
Table '121' 8-max Seat #7 is the button
Seat 1: b1ee83fd (9,372 in chips)
Seat 2: 94692891 (51,624 in chips)
Seat 3: 70a28fa5 (4,936 in chips)
Seat 4: 35a7cc5 (10,000 in chips)
Seat 5: 148547c3 (7,879 in chips)
Seat 6: Hero (43,272 in chips)
Seat 7: 20bf27c2 (19,466 in chips)
Seat 8: fdd0a515 (6,240 in chips)
94692891: posts the ante 30
fdd0a515: posts the ante 30
148547c3: posts the ante 30
35a7cc5: posts the ante 30
b1ee83fd: posts the ante 30
20bf27c2: posts the ante 30
Hero: posts the ante 30
70a28fa5: posts the ante 30
fdd0a515: posts small blind 100
b1ee83fd: posts big blind 200
*** HOLE CARDS ***
Dealt to b1ee83fd 
Dealt to 94692891 
Dealt to 70a28fa5 
Dealt to 35a7cc5 
Dealt to 148547c3 
Dealt to Hero [5s 2d]
Dealt to 20bf27c2 
Dealt to fdd0a515 
94692891: calls 200
70a28fa5: folds
35a7cc5: folds
148547c3: folds
Hero: folds
20bf27c2: calls 200
fdd0a515: folds
b1ee83fd: checks
*** FLOP *** [9d 3d 8s]
b1ee83fd: checks
94692891: bets 311
20bf27c2: raises 511 to 822
b1ee83fd: folds
94692891: calls 511
*** TURN *** [9d 3d 8s] [Kd]
94692891: checks
20bf27c2: checks
*** RIVER *** [9d 3d 8s Kd] [7h]
94692891: checks
20bf27c2: checks
94692891: shows [7d 6h] (Pair of Sevens)
20bf27c2: shows [Qd 9c] (Pair of Nines)
*** SHOWDOWN ***
20bf27c2 collected 2,584 from pot
*** SUMMARY ***
Total pot 2,584 | Rake 0 | Jackpot 0 | Bingo 0 | Fortune 0 | Tax 0
Board [9d 3d 8s Kd 7h]
Seat 1: b1ee83fd (big blind) folded on the Flop
Seat 2: 94692891 showed [7d 6h] and lost with Pair of Sevens
Seat 3: 70a28fa5 folded before Flop
Seat 4: 35a7cc5 folded before Flop
Seat 5: 148547c3 folded before Flop
Seat 6: Hero folded before Flop
Seat 7: 20bf27c2 (button) showed [Qd 9c] and won (2,584) with Pair of Nines
Seat 8: fdd0a515 (small blind) folded before Flop


Poker Hand #TM3449637097: Tournament #149964808, Bounty Hunters Special $1.08 Hold'em No Limit - Level4(100/200) - 2024/07/03 21:12:09
Table '121' 8-max Seat #6 is the button
Seat 1: b1ee83fd (8,397 in chips)
Seat 2: 94692891 (51,654 in chips)
Seat 3: 70a28fa5 (4,966 in chips)
Seat 5: 148547c3 (6,904 in chips)
Seat 6: Hero (43,902 in chips)
Seat 7: 20bf27c2 (20,096 in chips)
Seat 8: fdd0a515 (6,870 in chips)
94692891: posts the ante 30
fdd0a515: posts the ante 30
148547c3: posts the ante 30
b1ee83fd: posts the ante 30
Hero: posts the ante 30
70a28fa5: posts the ante 30
20bf27c2: posts the ante 30
20bf27c2: posts small blind 100
fdd0a515: posts big blind 200
*** HOLE CARDS ***
Dealt to b1ee83fd 
Dealt to 94692891 
Dealt to 70a28fa5 
Dealt to 148547c3 
Dealt to Hero [Ks 4s]
Dealt to 20bf27c2 
Dealt to fdd0a515 
b1ee83fd: raises 400 to 600
94692891: folds
70a28fa5: folds
148547c3: calls 600
Hero: calls 600
20bf27c2: calls 500
fdd0a515: calls 400
*** FLOP *** [Jd 9c Qh]
20bf27c2: checks
fdd0a515: checks
b1ee83fd: bets 2,408
148547c3: raises 3,866 to 6,274 and is all-in
Hero: folds
20bf27c2: folds
fdd0a515: folds
b1ee83fd: calls 3,866
148547c3: shows [Th 9s] (Pair of Nines)
b1ee83fd: shows [Qc Tc] (Pair of Queens)
*** TURN *** [Jd 9c Qh] [3d]
*** RIVER *** [Jd 9c Qh 3d] [8h]
*** SHOWDOWN ***
148547c3 collected 7,879 from pot
b1ee83fd collected 7,879 from pot
*** SUMMARY ***
Total pot 15,758 | Rake 0 | Jackpot 0 | Bingo 0 | Fortune 0 | Tax 0
Board [Jd 9c Qh 3d 8h]
Seat 1: b1ee83fd showed [Qc Tc] and won (7,879) with Queens-High Straight
Seat 2: 94692891 folded before Flop
Seat 3: 70a28fa5 folded before Flop
Seat 5: 148547c3 showed [Th 9s] and won (7,879) with Queens-High Straight
Seat 6: Hero (button) folded on the Flop
Seat 7: 20bf27c2 (small blind) folded on the Flop
Seat 8: fdd0a515 (big blind) folded on the Flop


Poker Hand #TM3449636985: Tournament #149964808, Bounty Hunters Special $1.08 Hold'em No Limit - Level4(100/200) - 2024/07/03 21:10:38
Table '121' 8-max Seat #5 is the button
Seat 1: b1ee83fd (8,427 in chips)
Seat 2: 94692891 (52,484 in chips)
Seat 3: 70a28fa5 (4,996 in chips)
Seat 4: 5ce7e257 (8,887 in chips)
Seat 5: 148547c3 (6,934 in chips)
Seat 6: Hero (33,835 in chips)
Seat 7: 20bf27c2 (20,326 in chips)
Seat 8: fdd0a515 (6,900 in chips)
94692891: posts the ante 30
5ce7e257: posts the ante 30
fdd0a515: posts the ante 30
148547c3: posts the ante 30
b1ee83fd: posts the ante 30
70a28fa5: posts the ante 30
20bf27c2: posts the ante 30
Hero: posts the ante 30
Hero: posts small blind 100
20bf27c2: posts big blind 200
*** HOLE CARDS ***
Dealt to b1ee83fd 
Dealt to 94692891 
Dealt to 70a28fa5 
Dealt to 5ce7e257 
Dealt to 148547c3 
Dealt to Hero [Jc Ah]
Dealt to 20bf27c2 
Dealt to fdd0a515 
fdd0a515: folds
b1ee83fd: folds
94692891: calls 200
70a28fa5: folds
5ce7e257: raises 600 to 800
148547c3: folds
Hero: calls 700
20bf27c2: folds
94692891: calls 600
*** FLOP *** [5c Kh Th]
Hero: checks
94692891: checks
5ce7e257: bets 460
Hero: calls 460
94692891: folds
*** TURN *** [5c Kh Th] [Ac]
Hero: checks
5ce7e257: bets 400
Hero: raises 2,280 to 2,680
5ce7e257: raises 4,917 to 7,597 and is all-in
Hero: calls 4,917
5ce7e257: shows [6s As] (Pair of Aces)
Hero: shows [Jc Ah] (Pair of Aces)
*** RIVER *** [5c Kh Th Ac] [Ad]
*** SHOWDOWN ***
Hero collected 18,954 from pot
*** SUMMARY ***
Total pot 18,954 | Rake 0 | Jackpot 0 | Bingo 0 | Fortune 0 | Tax 0
Board [5c Kh Th Ac Ad]
Seat 1: b1ee83fd folded before Flop
Seat 2: 94692891 folded on the Flop
Seat 3: 70a28fa5 folded before Flop
Seat 4: 5ce7e257 showed [6s As] and lost with Three Aces
Seat 5: 148547c3 (button) folded before Flop
Seat 6: Hero (small blind) showed [Jc Ah] and won (18,954) with Three Aces
Seat 7: 20bf27c2 (big blind) folded before Flop
Seat 8: fdd0a515 folded before Flop


Poker Hand #TM3449636900: Tournament #149964808, Bounty Hunters Special $1.08 Hold'em No Limit - Level4(100/200) - 2024/07/03 21:09:25
Table '121' 8-max Seat #4 is the button
Seat 1: b1ee83fd (8,457 in chips)
Seat 2: 94692891 (51,004 in chips)
Seat 3: 70a28fa5 (5,226 in chips)
Seat 4: 5ce7e257 (9,687 in chips)
Seat 5: 148547c3 (7,064 in chips)
Seat 6: Hero (34,065 in chips)
Seat 7: 20bf27c2 (20,356 in chips)
Seat 8: fdd0a515 (6,930 in chips)
94692891: posts the ante 30
5ce7e257: posts the ante 30
fdd0a515: posts the ante 30
148547c3: posts the ante 30
b1ee83fd: posts the ante 30
70a28fa5: posts the ante 30
20bf27c2: posts the ante 30
Hero: posts the ante 30
148547c3: posts small blind 100
Hero: posts big blind 200
*** HOLE CARDS ***
Dealt to b1ee83fd 
Dealt to 94692891 
Dealt to 70a28fa5 
Dealt to 5ce7e257 
Dealt to 148547c3 
Dealt to Hero [6s Kh]
Dealt to 20bf27c2 
Dealt to fdd0a515 
20bf27c2: folds
fdd0a515: folds
b1ee83fd: folds
94692891: calls 200
70a28fa5: calls 200
5ce7e257: calls 200
148547c3: folds
Hero: checks
*** FLOP *** [7s Jh 2h]
Hero: checks
94692891: bets 570
70a28fa5: folds
5ce7e257: calls 570
Hero: folds
*** TURN *** [7s Jh 2h] [5c]
94692891: bets 1,710
5ce7e257: folds
Uncalled bet (1,710) returned to 94692891
5ce7e257: shows [3s 3c] (Pair of Treys)
*** SHOWDOWN ***
94692891 collected 2,280 from pot
*** SUMMARY ***
Total pot 2,280 | Rake 0 | Jackpot 0 | Bingo 0 | Fortune 0 | Tax 0
Board [7s Jh 2h 5c]
Seat 1: b1ee83fd folded before Flop
Seat 2: 94692891 won (2,280)
Seat 3: 70a28fa5 folded on the Flop
Seat 4: 5ce7e257 (button) folded on the Turn
Seat 5: 148547c3 (small blind) folded before Flop
Seat 6: Hero (big blind) folded on the Flop
Seat 7: 20bf27c2 folded before Flop
Seat 8: fdd0a515 folded before Flop


Poker Hand #TM3449872572: Tournament #149964808, Bounty Hunters Special $1.08 Hold'em No Limit - Level4(100/200) - 2024/07/03 21:08:02
Table '124' 8-max Seat #8 is the button
Seat 1: e3ba8c21 (10,762 in chips)
Seat 2: Hero (21,084 in chips)
Seat 3: a7e3b09b (18,267 in chips)
Seat 4: 1a2a38a3 (11,270 in chips)
Seat 5: 7f924411 (7,530 in chips)
Seat 6: 75aa4279 (2,053 in chips)
Seat 7: cb130b8c (18,658 in chips)
Seat 8: 63b4dc91 (10,278 in chips)
1a2a38a3: posts the ante 30
63b4dc91: posts the ante 30
a7e3b09b: posts the ante 30
e3ba8c21: posts the ante 30
cb130b8c: posts the ante 30
75aa4279: posts the ante 30
7f924411: posts the ante 30
Hero: posts the ante 30
e3ba8c21: posts small blind 100
Hero: posts big blind 200
*** HOLE CARDS ***
Dealt to e3ba8c21 
Dealt to Hero [Js Jc]
Dealt to a7e3b09b 
Dealt to 1a2a38a3 
Dealt to 7f924411 
Dealt to 75aa4279 
Dealt to cb130b8c 
Dealt to 63b4dc91 
a7e3b09b: folds
1a2a38a3: raises 200 to 400
7f924411: folds
75aa4279: raises 1,623 to 2,023 and is all-in
cb130b8c: folds
63b4dc91: raises 8,225 to 10,248 and is all-in
e3ba8c21: folds
Hero: calls 10,048
1a2a38a3: folds
63b4dc91: shows [Ah Th]
Hero: shows [Js Jc]
75aa4279: shows [Qc Jd]
*** FLOP *** [3c 3s 9d]
*** TURN *** [3c 3s 9d] [9h]
*** RIVER *** [3c 3s 9d 9h] [2s]
*** SHOWDOWN ***
Hero collected 6,809 from pot
Hero collected 16,450 from pot
*** SUMMARY ***
Total pot 23,259 | Rake 0 | Jackpot 0 | Bingo 0 | Fortune 0 | Tax 0
Board [3c 3s 9d 9h 2s]
Seat 1: e3ba8c21 (small blind) folded before Flop
Seat 2: Hero (big blind) showed [Js Jc] and won (23,259) with Pair of Jacks and Pair of Nines
Seat 3: a7e3b09b folded before Flop
Seat 4: 1a2a38a3 folded before Flop
Seat 5: 7f924411 folded before Flop
Seat 6: 75aa4279 showed [Qc Jd] and lost with Pair of Nines and Pair of Treys
Seat 7: cb130b8c folded before Flop
Seat 8: 63b4dc91 (button) showed [Ah Th] and lost with Pair of Nines and Pair of Treys


Poker Hand #TM3449872500: Tournament #149964808, Bounty Hunters Special $1.08 Hold'em No Limit - Level4(100/200) - 2024/07/03 21:07:07
Table '124' 8-max Seat #7 is the button
Seat 1: e3ba8c21 (10,992 in chips)
Seat 2: Hero (21,514 in chips)
Seat 3: a7e3b09b (18,297 in chips)
Seat 4: 1a2a38a3 (10,360 in chips)
Seat 5: 7f924411 (7,560 in chips)
Seat 6: 75aa4279 (2,083 in chips)
Seat 7: cb130b8c (18,688 in chips)
Seat 8: 63b4dc91 (10,408 in chips)
1a2a38a3: posts the ante 30
a7e3b09b: posts the ante 30
63b4dc91: posts the ante 30
e3ba8c21: posts the ante 30
cb130b8c: posts the ante 30
75aa4279: posts the ante 30
7f924411: posts the ante 30
Hero: posts the ante 30
63b4dc91: posts small blind 100
e3ba8c21: posts big blind 200
*** HOLE CARDS ***
Dealt to e3ba8c21 
Dealt to Hero [Kd Tc]
Dealt to a7e3b09b 
Dealt to 1a2a38a3 
Dealt to 7f924411 
Dealt to 75aa4279 
Dealt to cb130b8c 
Dealt to 63b4dc91 
Hero: raises 200 to 400
a7e3b09b: folds
1a2a38a3: raises 1,340 to 1,740
7f924411: folds
75aa4279: folds
cb130b8c: folds
63b4dc91: folds
e3ba8c21: folds
Hero: folds
Uncalled bet (1,340) returned to 1a2a38a3
*** SHOWDOWN ***
1a2a38a3 collected 1,340 from pot
*** SUMMARY ***
Total pot 1,340 | Rake 0 | Jackpot 0 | Bingo 0 | Fortune 0 | Tax 0
Seat 1: e3ba8c21 (big blind) folded before Flop
Seat 2: Hero folded before Flop
Seat 3: a7e3b09b folded before Flop
Seat 4: 1a2a38a3 collected (1,340)
Seat 5: 7f924411 folded before Flop
Seat 6: 75aa4279 folded before Flop
Seat 7: cb130b8c (button) folded before Flop
Seat 8: 63b4dc91 (small blind) folded before Flop


Poker Hand #TM3449872430: Tournament #149964808, Bounty Hunters Special $1.08 Hold'em No Limit - Level3(80/160) - 2024/07/03 21:06:07
Table '124' 8-max Seat #6 is the button
Seat 1: e3ba8c21 (11,016 in chips)
Seat 2: Hero (21,698 in chips)
Seat 3: a7e3b09b (18,321 in chips)
Seat 4: 1a2a38a3 (10,384 in chips)
Seat 5: 7f924411 (7,584 in chips)
Seat 6: 75aa4279 (2,107 in chips)
Seat 7: cb130b8c (18,792 in chips)
Seat 8: 63b4dc91 (10,000 in chips)
1a2a38a3: posts the ante 24
a7e3b09b: posts the ante 24
63b4dc91: posts the ante 24
e3ba8c21: posts the ante 24
cb130b8c: posts the ante 24
75aa4279: posts the ante 24
7f924411: posts the ante 24
Hero: posts the ante 24
cb130b8c: posts small blind 80
63b4dc91: posts big blind 160
*** HOLE CARDS ***
Dealt to e3ba8c21 
Dealt to Hero [7c 6s]
Dealt to a7e3b09b 
Dealt to 1a2a38a3 
Dealt to 7f924411 
Dealt to 75aa4279 
Dealt to cb130b8c 
Dealt to 63b4dc91 
e3ba8c21: folds
Hero: calls 160
a7e3b09b: folds
1a2a38a3: folds
7f924411: folds
75aa4279: folds
cb130b8c: folds
63b4dc91: raises 320 to 480
Hero: folds
Uncalled bet (320) returned to 63b4dc91
*** SHOWDOWN ***
63b4dc91 collected 592 from pot
*** SUMMARY ***
Total pot 592 | Rake 0 | Jackpot 0 | Bingo 0 | Fortune 0 | Tax 0
Seat 1: e3ba8c21 folded before Flop
Seat 2: Hero folded before Flop
Seat 3: a7e3b09b folded before Flop
Seat 4: 1a2a38a3 folded before Flop
Seat 5: 7f924411 folded before Flop
Seat 6: 75aa4279 (button) folded before Flop
Seat 7: cb130b8c (small blind) folded before Flop
Seat 8: 63b4dc91 (big blind) collected (592)


Poker Hand #TM3449872399: Tournament #149964808, Bounty Hunters Special $1.08 Hold'em No Limit - Level3(80/160) - 2024/07/03 21:05:38
Table '124' 8-max Seat #5 is the button
Seat 1: e3ba8c21 (11,040 in chips)
Seat 2: Hero (21,722 in chips)
Seat 3: a7e3b09b (18,345 in chips)
Seat 4: 1a2a38a3 (10,000 in chips)
Seat 5: 7f924411 (7,608 in chips)
Seat 6: 75aa4279 (2,211 in chips)
Seat 7: cb130b8c (18,976 in chips)
1a2a38a3: posts the ante 24
a7e3b09b: posts the ante 24
e3ba8c21: posts the ante 24
cb130b8c: posts the ante 24
75aa4279: posts the ante 24
7f924411: posts the ante 24
Hero: posts the ante 24
75aa4279: posts small blind 80
cb130b8c: posts big blind 160
*** HOLE CARDS ***
Dealt to e3ba8c21 
Dealt to Hero [8h Ac]
Dealt to a7e3b09b 
Dealt to 1a2a38a3 
Dealt to 7f924411 
Dealt to 75aa4279 
Dealt to cb130b8c 
e3ba8c21: folds
Hero: folds
a7e3b09b: folds
1a2a38a3: raises 160 to 320
7f924411: folds
75aa4279: folds
cb130b8c: folds
Uncalled bet (160) returned to 1a2a38a3
*** SHOWDOWN ***
1a2a38a3 collected 568 from pot
*** SUMMARY ***
Total pot 568 | Rake 0 | Jackpot 0 | Bingo 0 | Fortune 0 | Tax 0
Seat 1: e3ba8c21 folded before Flop
Seat 2: Hero folded before Flop
Seat 3: a7e3b09b folded before Flop
Seat 4: 1a2a38a3 collected (568)
Seat 5: 7f924411 (button) folded before Flop
Seat 6: 75aa4279 (small blind) folded before Flop
Seat 7: cb130b8c (big blind) folded before Flop


Poker Hand #TM3449872315: Tournament #149964808, Bounty Hunters Special $1.08 Hold'em No Limit - Level3(80/160) - 2024/07/03 21:04:29
Table '124' 8-max Seat #3 is the button
Seat 1: e3ba8c21 (11,064 in chips)
Seat 2: Hero (20,234 in chips)
Seat 3: a7e3b09b (18,369 in chips)
Seat 5: 7f924411 (7,712 in chips)
Seat 6: 75aa4279 (2,867 in chips)
Seat 7: cb130b8c (19,000 in chips)
Seat 8: 3515f371 (656 in chips)
a7e3b09b: posts the ante 24
e3ba8c21: posts the ante 24
cb130b8c: posts the ante 24
3515f371: posts the ante 24
75aa4279: posts the ante 24
Hero: posts the ante 24
7f924411: posts the ante 24
7f924411: posts small blind 80
75aa4279: posts big blind 160
*** HOLE CARDS ***
Dealt to e3ba8c21 
Dealt to Hero [8d Jh]
Dealt to a7e3b09b 
Dealt to 7f924411 
Dealt to 75aa4279 
Dealt to cb130b8c 
Dealt to 3515f371 
cb130b8c: folds
3515f371: raises 472 to 632 and is all-in
e3ba8c21: folds
Hero: calls 632
a7e3b09b: folds
7f924411: folds
75aa4279: calls 472
*** FLOP *** [7s 3h 9h]
75aa4279: checks
Hero: bets 708
75aa4279: folds
Uncalled bet (708) returned to Hero
Hero: shows [8d Jh] (Jack-High)
3515f371: shows [2h 4h] (Nine-High)
*** TURN *** [7s 3h 9h] [Kd]
*** RIVER *** [7s 3h 9h Kd] [Td]
*** SHOWDOWN ***
Hero collected 2,144 from pot
*** SUMMARY ***
Total pot 2,144 | Rake 0 | Jackpot 0 | Bingo 0 | Fortune 0 | Tax 0
Board [7s 3h 9h Kd Td]
Seat 1: e3ba8c21 folded before Flop
Seat 2: Hero showed [8d Jh] and won (2,144) with Jacks-High Straight
Seat 3: a7e3b09b (button) folded before Flop
Seat 5: 7f924411 (small blind) folded before Flop
Seat 6: 75aa4279 (big blind) folded on the Flop
Seat 7: cb130b8c folded before Flop
Seat 8: 3515f371 showed [2h 4h] and lost with King-High


Poker Hand #TM3449872223: Tournament #149964808, Bounty Hunters Special $1.08 Hold'em No Limit - Level3(80/160) - 2024/07/03 21:03:08
Table '124' 8-max Seat #2 is the button
Seat 1: e3ba8c21 (11,088 in chips)
Seat 2: Hero (20,258 in chips)
Seat 3: a7e3b09b (18,473 in chips)
Seat 5: 7f924411 (7,896 in chips)
Seat 6: 75aa4279 (2,891 in chips)
Seat 7: cb130b8c (9,320 in chips)
Seat 8: 3515f371 (9,976 in chips)
a7e3b09b: posts the ante 24
e3ba8c21: posts the ante 24
cb130b8c: posts the ante 24
3515f371: posts the ante 24
75aa4279: posts the ante 24
Hero: posts the ante 24
7f924411: posts the ante 24
a7e3b09b: posts small blind 80
7f924411: posts big blind 160
*** HOLE CARDS ***
Dealt to e3ba8c21 
Dealt to Hero [6c 5s]
Dealt to a7e3b09b 
Dealt to 7f924411 
Dealt to 75aa4279 
Dealt to cb130b8c 
Dealt to 3515f371 
75aa4279: folds
cb130b8c: raises 160 to 320
3515f371: raises 1,048 to 1,368
e3ba8c21: folds
Hero: folds
a7e3b09b: folds
7f924411: folds
cb130b8c: raises 7,928 to 9,296 and is all-in
3515f371: calls 7,928
cb130b8c: shows [Qc Qd]
3515f371: shows [Qs Jc]
*** FLOP *** [5d 2c 5c]
*** TURN *** [5d 2c 5c] [Js]
*** RIVER *** [5d 2c 5c Js] [8d]
*** SHOWDOWN ***
cb130b8c collected 19,000 from pot
*** SUMMARY ***
Total pot 19,000 | Rake 0 | Jackpot 0 | Bingo 0 | Fortune 0 | Tax 0
Board [5d 2c 5c Js 8d]
Seat 1: e3ba8c21 folded before Flop
Seat 2: Hero (button) folded before Flop
Seat 3: a7e3b09b (small blind) folded before Flop
Seat 5: 7f924411 (big blind) folded before Flop
Seat 6: 75aa4279 folded before Flop
Seat 7: cb130b8c showed [Qc Qd] and won (19,000) with Pair of Queens and Pair of Fives
Seat 8: 3515f371 showed [Qs Jc] and lost with Pair of Jacks and Pair of Fives


Poker Hand #TM3449872153: Tournament #149964808, Bounty Hunters Special $1.08 Hold'em No Limit - Level3(80/160) - 2024/07/03 21:02:09
Table '124' 8-max Seat #1 is the button
Seat 1: e3ba8c21 (10,440 in chips)
Seat 2: Hero (20,362 in chips)
Seat 3: a7e3b09b (18,897 in chips)
Seat 4: f8ede0f3 (9,123 in chips)
Seat 5: 7f924411 (7,920 in chips)
Seat 6: 75aa4279 (2,915 in chips)
Seat 7: cb130b8c (9,344 in chips)
Seat 8: 3515f371 (10,000 in chips)
a7e3b09b: posts the ante 24
e3ba8c21: posts the ante 24
f8ede0f3: posts the ante 24
cb130b8c: posts the ante 24
3515f371: posts the ante 24
75aa4279: posts the ante 24
7f924411: posts the ante 24
Hero: posts the ante 24
Hero: posts small blind 80
a7e3b09b: posts big blind 160
*** HOLE CARDS ***
Dealt to e3ba8c21 
Dealt to Hero [4d Jd]
Dealt to a7e3b09b 
Dealt to f8ede0f3 
Dealt to 7f924411 
Dealt to 75aa4279 
Dealt to cb130b8c 
Dealt to 3515f371 
f8ede0f3: folds
7f924411: folds
75aa4279: folds
cb130b8c: folds
3515f371: folds
e3ba8c21: raises 240 to 400
Hero: folds
a7e3b09b: calls 240
*** FLOP *** [Ks 2d 5s]
a7e3b09b: checks
e3ba8c21: checks
*** TURN *** [Ks 2d 5s] [5c]
a7e3b09b: checks
e3ba8c21: bets 311
a7e3b09b: folds
Uncalled bet (311) returned to e3ba8c21
*** SHOWDOWN ***
e3ba8c21 collected 1,072 from pot
*** SUMMARY ***
Total pot 1,072 | Rake 0 | Jackpot 0 | Bingo 0 | Fortune 0 | Tax 0
Board [Ks 2d 5s 5c]
Seat 1: e3ba8c21 (button) won (1,072)
Seat 2: Hero (small blind) folded before Flop
Seat 3: a7e3b09b (big blind) folded on the Turn
Seat 4: f8ede0f3 folded before Flop
Seat 5: 7f924411 folded before Flop
Seat 6: 75aa4279 folded before Flop
Seat 7: cb130b8c folded before Flop
Seat 8: 3515f371 folded before Flop


Poker Hand #TM3449872110: Tournament #149964808, Bounty Hunters Special $1.08 Hold'em No Limit - Level3(80/160) - 2024/07/03 20:54:58
Table '124' 8-max Seat #7 is the button
Seat 1: e3ba8c21 (10,544 in chips)
Seat 2: Hero (20,546 in chips)
Seat 3: a7e3b09b (18,921 in chips)
Seat 4: f8ede0f3 (9,147 in chips)
Seat 5: 7f924411 (7,536 in chips)
Seat 6: 75aa4279 (2,939 in chips)
Seat 7: cb130b8c (9,368 in chips)
a7e3b09b: posts the ante 24
e3ba8c21: posts the ante 24
f8ede0f3: posts the ante 24
cb130b8c: posts the ante 24
75aa4279: posts the ante 24
7f924411: posts the ante 24
Hero: posts the ante 24
e3ba8c21: posts small blind 80
Hero: posts big blind 160
*** HOLE CARDS ***
Dealt to e3ba8c21 
Dealt to Hero [3d Ks]
Dealt to a7e3b09b 
Dealt to f8ede0f3 
Dealt to 7f924411 
Dealt to 75aa4279 
Dealt to cb130b8c 
a7e3b09b: folds
f8ede0f3: folds
7f924411: raises 160 to 320
75aa4279: folds
cb130b8c: folds
e3ba8c21: folds
Hero: folds
Uncalled bet (160) returned to 7f924411
*** SHOWDOWN ***
7f924411 collected 568 from pot
*** SUMMARY ***
Total pot 568 | Rake 0 | Jackpot 0 | Bingo 0 | Fortune 0 | Tax 0
Seat 1: e3ba8c21 (small blind) folded before Flop
Seat 2: Hero (big blind) folded before Flop
Seat 3: a7e3b09b folded before Flop
Seat 4: f8ede0f3 folded before Flop
Seat 5: 7f924411 collected (568)
Seat 6: 75aa4279 folded before Flop
Seat 7: cb130b8c (button) folded before Flop


Poker Hand #TM3449872047: Tournament #149964808, Bounty Hunters Special $1.08 Hold'em No Limit - Level3(80/160) - 2024/07/03 20:54:07
Table '124' 8-max Seat #6 is the button
Seat 1: e3ba8c21 (10,000 in chips)
Seat 2: Hero (20,730 in chips)
Seat 3: a7e3b09b (18,945 in chips)
Seat 4: f8ede0f3 (9,171 in chips)
Seat 5: 7f924411 (7,720 in chips)
Seat 6: 75aa4279 (2,963 in chips)
Seat 7: cb130b8c (9,472 in chips)
a7e3b09b: posts the ante 24
e3ba8c21: posts the ante 24
f8ede0f3: posts the ante 24
cb130b8c: posts the ante 24
75aa4279: posts the ante 24
7f924411: posts the ante 24
Hero: posts the ante 24
cb130b8c: posts small blind 80
e3ba8c21: posts big blind 160
*** HOLE CARDS ***
Dealt to e3ba8c21 
Dealt to Hero [Tc Js]
Dealt to a7e3b09b 
Dealt to f8ede0f3 
Dealt to 7f924411 
Dealt to 75aa4279 
Dealt to cb130b8c 
Hero: calls 160
a7e3b09b: folds
f8ede0f3: folds
7f924411: calls 160
75aa4279: folds
cb130b8c: folds
e3ba8c21: raises 560 to 720
Hero: folds
7f924411: folds
Uncalled bet (560) returned to e3ba8c21
*** SHOWDOWN ***
e3ba8c21 collected 728 from pot
*** SUMMARY ***
Total pot 728 | Rake 0 | Jackpot 0 | Bingo 0 | Fortune 0 | Tax 0
Seat 1: e3ba8c21 (big blind) collected (728)
Seat 2: Hero folded before Flop
Seat 3: a7e3b09b folded before Flop
Seat 4: f8ede0f3 folded before Flop
Seat 5: 7f924411 folded before Flop
Seat 6: 75aa4279 (button) folded before Flop
Seat 7: cb130b8c (small blind) folded before Flop


Poker Hand #TM3449871981: Tournament #149964808, Bounty Hunters Special $1.08 Hold'em No Limit - Level3(80/160) - 2024/07/03 20:53:11
Table '124' 8-max Seat #5 is the button
Seat 2: Hero (20,754 in chips)
Seat 3: a7e3b09b (18,969 in chips)
Seat 4: f8ede0f3 (9,195 in chips)
Seat 5: 7f924411 (8,384 in chips)
Seat 6: 75aa4279 (3,627 in chips)
Seat 7: cb130b8c (9,656 in chips)
Seat 8: a6abdb97 (9,535 in chips)
a7e3b09b: posts the ante 24
f8ede0f3: posts the ante 24
cb130b8c: posts the ante 24
a6abdb97: posts the ante 24
75aa4279: posts the ante 24
7f924411: posts the ante 24
Hero: posts the ante 24
75aa4279: posts small blind 80
cb130b8c: posts big blind 160
*** HOLE CARDS ***
Dealt to Hero [Th Qs]
Dealt to a7e3b09b 
Dealt to f8ede0f3 
Dealt to 7f924411 
Dealt to 75aa4279 
Dealt to cb130b8c 
Dealt to a6abdb97 
a6abdb97: raises 480 to 640
Hero: folds
a7e3b09b: folds
f8ede0f3: folds
7f924411: calls 640
75aa4279: calls 560
cb130b8c: folds
*** FLOP *** [9c 4s Ts]
75aa4279: checks
a6abdb97: checks
7f924411: checks
*** TURN *** [9c 4s Ts] [Ad]
75aa4279: checks
a6abdb97: bets 1,124
7f924411: folds
75aa4279: folds
Uncalled bet (1,124) returned to a6abdb97
*** SHOWDOWN ***
a6abdb97 collected 2,248 from pot
*** SUMMARY ***
Total pot 2,248 | Rake 0 | Jackpot 0 | Bingo 0 | Fortune 0 | Tax 0
Board [9c 4s Ts Ad]
Seat 2: Hero folded before Flop
Seat 3: a7e3b09b folded before Flop
Seat 4: f8ede0f3 folded before Flop
Seat 5: 7f924411 (button) folded on the Turn
Seat 6: 75aa4279 (small blind) folded on the Turn
Seat 7: cb130b8c (big blind) folded before Flop
Seat 8: a6abdb97 won (2,248)


Poker Hand #TM3449861923: Tournament #149964808, Bounty Hunters Special $1.08 Hold'em No Limit - Level3(80/160) - 2024/07/03 20:51:37
Table '14' 8-max Seat #4 is the button
Seat 1: 794fa451 (10,282 in chips)
Seat 2: 9823561 (9,020 in chips)
Seat 3: c807d389 (9,123 in chips)
Seat 4: 65f3225a (9,776 in chips)
Seat 5: 5bc4d104 (12,644 in chips)
Seat 6: d61c1be0 (9,922 in chips)
Seat 7: Hero (20,778 in chips)
Seat 8: 5f608407 (6,666 in chips)
65f3225a: posts the ante 24
794fa451: posts the ante 24
d61c1be0: posts the ante 24
c807d389: posts the ante 24
9823561: posts the ante 24
5f608407: posts the ante 24
Hero: posts the ante 24
5bc4d104: posts the ante 24
5bc4d104: posts small blind 80
d61c1be0: posts big blind 160
*** HOLE CARDS ***
Dealt to 794fa451 
Dealt to 9823561 
Dealt to c807d389 
Dealt to 65f3225a 
Dealt to 5bc4d104 
Dealt to d61c1be0 
Dealt to Hero [4d 5h]
Dealt to 5f608407 
Hero: folds
5f608407: raises 160 to 320
794fa451: raises 720 to 1,040
9823561: folds
c807d389: folds
65f3225a: folds
5bc4d104: calls 960
d61c1be0: folds
5f608407: folds
*** FLOP *** [2c 5d 7c]
5bc4d104: checks
794fa451: checks
*** TURN *** [2c 5d 7c] [4c]
5bc4d104: bets 909
794fa451: calls 909
*** RIVER *** [2c 5d 7c 4c] [9h]
5bc4d104: checks
794fa451: checks
5bc4d104: shows [Qh Ts] (Queen-High)
794fa451: shows [Ac Qd] (Ace-High)
*** SHOWDOWN ***
794fa451 collected 4,570 from pot
*** SUMMARY ***
Total pot 4,570 | Rake 0 | Jackpot 0 | Bingo 0 | Fortune 0 | Tax 0
Board [2c 5d 7c 4c 9h]
Seat 1: 794fa451 showed [Ac Qd] and won (4,570) with Ace-High
Seat 2: 9823561 folded before Flop
Seat 3: c807d389 folded before Flop
Seat 4: 65f3225a (button) folded before Flop
Seat 5: 5bc4d104 (small blind) showed [Qh Ts] and lost with Queen-High
Seat 6: d61c1be0 (big blind) folded before Flop
Seat 7: Hero folded before Flop
Seat 8: 5f608407 folded before Flop


Poker Hand #TM3449861825: Tournament #149964808, Bounty Hunters Special $1.08 Hold'em No Limit - Level3(80/160) - 2024/07/03 20:50:17
Table '14' 8-max Seat #3 is the button
Seat 1: 794fa451 (10,306 in chips)
Seat 2: 9823561 (9,044 in chips)
Seat 3: c807d389 (9,627 in chips)
Seat 4: 65f3225a (9,880 in chips)
Seat 5: 5bc4d104 (12,828 in chips)
Seat 6: d61c1be0 (9,946 in chips)
Seat 7: Hero (19,890 in chips)
Seat 8: 5f608407 (6,690 in chips)
794fa451: posts the ante 24
65f3225a: posts the ante 24
d61c1be0: posts the ante 24
c807d389: posts the ante 24
9823561: posts the ante 24
5f608407: posts the ante 24
Hero: posts the ante 24
5bc4d104: posts the ante 24
65f3225a: posts small blind 80
5bc4d104: posts big blind 160
*** HOLE CARDS ***
Dealt to 794fa451 
Dealt to 9823561 
Dealt to c807d389 
Dealt to 65f3225a 
Dealt to 5bc4d104 
Dealt to d61c1be0 
Dealt to Hero [Jc Js]
Dealt to 5f608407 
d61c1be0: folds
Hero: raises 320 to 480
5f608407: folds
794fa451: folds
9823561: folds
c807d389: calls 480
65f3225a: folds
5bc4d104: folds
*** FLOP *** [Jd 6h 9c]
Hero: checks
c807d389: checks
*** TURN *** [Jd 6h 9c] [2d]
Hero: checks
c807d389: checks
*** RIVER *** [Jd 6h 9c 2d] [As]
Hero: bets 1,392
c807d389: folds
Uncalled bet (1,392) returned to Hero
*** SHOWDOWN ***
Hero collected 1,392 from pot
*** SUMMARY ***
Total pot 1,392 | Rake 0 | Jackpot 0 | Bingo 0 | Fortune 0 | Tax 0
Board [Jd 6h 9c 2d As]
Seat 1: 794fa451 folded before Flop
Seat 2: 9823561 folded before Flop
Seat 3: c807d389 (button) folded on the River
Seat 4: 65f3225a (small blind) folded before Flop
Seat 5: 5bc4d104 (big blind) folded before Flop
Seat 6: d61c1be0 folded before Flop
Seat 7: Hero won (1,392)
Seat 8: 5f608407 folded before Flop


Poker Hand #TM3449861763: Tournament #149964808, Bounty Hunters Special $1.08 Hold'em No Limit - Level2(60/120) - 2024/07/03 20:49:28
Table '14' 8-max Seat #2 is the button
Seat 1: 794fa451 (10,000 in chips)
Seat 2: 9823561 (9,062 in chips)
Seat 3: c807d389 (9,705 in chips)
Seat 4: 65f3225a (10,018 in chips)
Seat 5: 5bc4d104 (12,846 in chips)
Seat 6: d61c1be0 (9,964 in chips)
Seat 7: Hero (19,908 in chips)
Seat 8: 5f608407 (6,708 in chips)
794fa451: posts the ante 18
65f3225a: posts the ante 18
d61c1be0: posts the ante 18
c807d389: posts the ante 18
9823561: posts the ante 18
5f608407: posts the ante 18
Hero: posts the ante 18
5bc4d104: posts the ante 18
c807d389: posts small blind 60
65f3225a: posts big blind 120
*** HOLE CARDS ***
Dealt to 794fa451 
Dealt to 9823561 
Dealt to c807d389 
Dealt to 65f3225a 
Dealt to 5bc4d104 
Dealt to d61c1be0 
Dealt to Hero [Th 5s]
Dealt to 5f608407 
5bc4d104: folds
d61c1be0: folds
Hero: folds
5f608407: folds
794fa451: raises 180 to 300
9823561: folds
c807d389: folds
65f3225a: folds
Uncalled bet (180) returned to 794fa451
*** SHOWDOWN ***
794fa451 collected 444 from pot
*** SUMMARY ***
Total pot 444 | Rake 0 | Jackpot 0 | Bingo 0 | Fortune 0 | Tax 0
Seat 1: 794fa451 collected (444)
Seat 2: 9823561 (button) folded before Flop
Seat 3: c807d389 (small blind) folded before Flop
Seat 4: 65f3225a (big blind) folded before Flop
Seat 5: 5bc4d104 folded before Flop
Seat 6: d61c1be0 folded before Flop
Seat 7: Hero folded before Flop
Seat 8: 5f608407 folded before Flop


Poker Hand #TM3449861608: Tournament #149964808, Bounty Hunters Special $1.08 Hold'em No Limit - Level2(60/120) - 2024/07/03 20:47:33
Table '14' 8-max Seat #8 is the button
Seat 2: 9823561 (9,140 in chips)
Seat 3: c807d389 (9,570 in chips)
Seat 4: 65f3225a (10,036 in chips)
Seat 5: 5bc4d104 (12,864 in chips)
Seat 6: d61c1be0 (9,982 in chips)
Seat 7: Hero (20,046 in chips)
Seat 8: 5f608407 (6,573 in chips)
65f3225a: posts the ante 18
d61c1be0: posts the ante 18
c807d389: posts the ante 18
9823561: posts the ante 18
5f608407: posts the ante 18
Hero: posts the ante 18
5bc4d104: posts the ante 18
9823561: posts small blind 60
c807d389: posts big blind 120
*** HOLE CARDS ***
Dealt to 9823561 
Dealt to c807d389 
Dealt to 65f3225a 
Dealt to 5bc4d104 
Dealt to d61c1be0 
Dealt to Hero [Ks 3s]
Dealt to 5f608407 
65f3225a: folds
5bc4d104: folds
d61c1be0: folds
Hero: calls 120
5f608407: raises 240 to 360
9823561: folds
c807d389: raises 513 to 873
Hero: folds
5f608407: calls 513
*** FLOP *** [Ah 6s Jd]
c807d389: bets 678
5f608407: calls 678
*** TURN *** [Ah 6s Jd] [Kc]
c807d389: checks
5f608407: bets 1,704
c807d389: calls 1,704
*** RIVER *** [Ah 6s Jd Kc] [Tc]
c807d389: checks
5f608407: checks
c807d389: shows [Qd Qh] (Aces-High Straight)
5f608407: shows [Jh Qs] (Aces-High Straight)
*** SHOWDOWN ***
5f608407 collected 3,408 from pot
c807d389 collected 3,408 from pot
*** SUMMARY ***
Total pot 6,816 | Rake 0 | Jackpot 0 | Bingo 0 | Fortune 0 | Tax 0
Board [Ah 6s Jd Kc Tc]
Seat 2: 9823561 (small blind) folded before Flop
Seat 3: c807d389 (big blind) showed [Qd Qh] and won (3,408) with Aces-High Straight
Seat 4: 65f3225a folded before Flop
Seat 5: 5bc4d104 folded before Flop
Seat 6: d61c1be0 folded before Flop
Seat 7: Hero folded before Flop
Seat 8: 5f608407 (button) showed [Jh Qs] and won (3,408) with Aces-High Straight


Poker Hand #TM3449861531: Tournament #149964808, Bounty Hunters Special $1.08 Hold'em No Limit - Level2(60/120) - 2024/07/03 20:46:34
Table '14' 8-max Seat #7 is the button
Seat 2: 9823561 (9,278 in chips)
Seat 3: c807d389 (9,588 in chips)
Seat 4: 65f3225a (10,054 in chips)
Seat 5: 5bc4d104 (12,096 in chips)
Seat 6: d61c1be0 (10,000 in chips)
Seat 7: Hero (20,544 in chips)
Seat 8: 5f608407 (6,651 in chips)
65f3225a: posts the ante 18
d61c1be0: posts the ante 18
c807d389: posts the ante 18
9823561: posts the ante 18
5f608407: posts the ante 18
Hero: posts the ante 18
5bc4d104: posts the ante 18
5f608407: posts small blind 60
9823561: posts big blind 120
*** HOLE CARDS ***
Dealt to 9823561 
Dealt to c807d389 
Dealt to 65f3225a 
Dealt to 5bc4d104 
Dealt to d61c1be0 
Dealt to Hero [3d Td]
Dealt to 5f608407 
c807d389: folds
65f3225a: folds
5bc4d104: raises 120 to 240
d61c1be0: folds
Hero: calls 240
5f608407: folds
9823561: folds
*** FLOP *** [5d 4d Qs]
5bc4d104: bets 240
Hero: calls 240
*** TURN *** [5d 4d Qs] [8s]
5bc4d104: checks
Hero: checks
*** RIVER *** [5d 4d Qs 8s] [As]
5bc4d104: checks
Hero: checks
5bc4d104: shows [Tc Kd] (Ace-High)
Hero: shows [3d Td] (Ace-High)
*** SHOWDOWN ***
5bc4d104 collected 1,266 from pot
*** SUMMARY ***
Total pot 1,266 | Rake 0 | Jackpot 0 | Bingo 0 | Fortune 0 | Tax 0
Board [5d 4d Qs 8s As]
Seat 2: 9823561 (big blind) folded before Flop
Seat 3: c807d389 folded before Flop
Seat 4: 65f3225a folded before Flop
Seat 5: 5bc4d104 showed [Tc Kd] and won (1,266) with Ace-High
Seat 6: d61c1be0 folded before Flop
Seat 7: Hero (button) showed [3d Td] and lost with Ace-High
Seat 8: 5f608407 (small blind) folded before Flop


Poker Hand #TM3449861429: Tournament #149964808, Bounty Hunters Special $1.08 Hold'em No Limit - Level2(60/120) - 2024/07/03 20:45:21
Table '14' 8-max Seat #5 is the button
Seat 1: 83f3b8e0 (10,016 in chips)
Seat 2: 9823561 (9,296 in chips)
Seat 3: c807d389 (9,606 in chips)
Seat 4: 65f3225a (10,072 in chips)
Seat 5: 5bc4d104 (12,654 in chips)
Seat 7: Hero (20,622 in chips)
Seat 8: 5f608407 (6,789 in chips)
65f3225a: posts the ante 18
83f3b8e0: posts the ante 18
c807d389: posts the ante 18
9823561: posts the ante 18
5f608407: posts the ante 18
Hero: posts the ante 18
5bc4d104: posts the ante 18
Hero: posts small blind 60
5f608407: posts big blind 120
*** HOLE CARDS ***
Dealt to 83f3b8e0 
Dealt to 9823561 
Dealt to c807d389 
Dealt to 65f3225a 
Dealt to 5bc4d104 
Dealt to Hero [6d Jc]
Dealt to 5f608407 
83f3b8e0: raises 144 to 264
9823561: folds
c807d389: folds
65f3225a: folds
5bc4d104: calls 264
Hero: folds
5f608407: folds
*** FLOP *** [3s 3d Kd]
83f3b8e0: bets 276
5bc4d104: calls 276
*** TURN *** [3s 3d Kd] [Js]
83f3b8e0: bets 360
5bc4d104: folds
Uncalled bet (360) returned to 83f3b8e0
*** SHOWDOWN ***
83f3b8e0 collected 1,386 from pot
*** SUMMARY ***
Total pot 1,386 | Rake 0 | Jackpot 0 | Bingo 0 | Fortune 0 | Tax 0
Board [3s 3d Kd Js]
Seat 1: 83f3b8e0 won (1,386)
Seat 2: 9823561 folded before Flop
Seat 3: c807d389 folded before Flop
Seat 4: 65f3225a folded before Flop
Seat 5: 5bc4d104 (button) folded on the Turn
Seat 7: Hero (small blind) folded before Flop
Seat 8: 5f608407 (big blind) folded before Flop


Poker Hand #TM3449861320: Tournament #149964808, Bounty Hunters Special $1.08 Hold'em No Limit - Level2(60/120) - 2024/07/03 20:44:06
Table '14' 8-max Seat #4 is the button
Seat 1: 83f3b8e0 (10,034 in chips)
Seat 2: 9823561 (9,314 in chips)
Seat 3: c807d389 (9,624 in chips)
Seat 4: 65f3225a (9,484 in chips)
Seat 5: 5bc4d104 (12,912 in chips)
Seat 7: Hero (20,880 in chips)
Seat 8: 5f608407 (6,807 in chips)
65f3225a: posts the ante 18
83f3b8e0: posts the ante 18
c807d389: posts the ante 18
9823561: posts the ante 18
5f608407: posts the ante 18
Hero: posts the ante 18
5bc4d104: posts the ante 18
5bc4d104: posts small blind 60
Hero: posts big blind 120
*** HOLE CARDS ***
Dealt to 83f3b8e0 
Dealt to 9823561 
Dealt to c807d389 
Dealt to 65f3225a 
Dealt to 5bc4d104 
Dealt to Hero [Jh Qh]
Dealt to 5f608407 
5f608407: folds
83f3b8e0: folds
9823561: folds
c807d389: folds
65f3225a: raises 120 to 240
5bc4d104: calls 180
Hero: calls 120
*** FLOP *** [8d 2c Kh]
5bc4d104: checks
Hero: checks
65f3225a: bets 280
5bc4d104: folds
Hero: folds
Uncalled bet (280) returned to 65f3225a
*** SHOWDOWN ***
65f3225a collected 846 from pot
*** SUMMARY ***
Total pot 846 | Rake 0 | Jackpot 0 | Bingo 0 | Fortune 0 | Tax 0
Board [8d 2c Kh]
Seat 1: 83f3b8e0 folded before Flop
Seat 2: 9823561 folded before Flop
Seat 3: c807d389 folded before Flop
Seat 4: 65f3225a (button) won (846)
Seat 5: 5bc4d104 (small blind) folded on the Flop
Seat 7: Hero (big blind) folded on the Flop
Seat 8: 5f608407 folded before Flop


Poker Hand #TM3449861178: Tournament #149964808, Bounty Hunters Special $1.08 Hold'em No Limit - Level2(60/120) - 2024/07/03 20:42:28
Table '14' 8-max Seat #3 is the button
Seat 1: 83f3b8e0 (10,052 in chips)
Seat 2: 9823561 (9,332 in chips)
Seat 3: c807d389 (9,642 in chips)
Seat 4: 65f3225a (9,862 in chips)
Seat 5: 5bc4d104 (13,290 in chips)
Seat 6: 7b7b5466 (10,707 in chips)
Seat 7: Hero (20,034 in chips)
Seat 8: 5f608407 (6,825 in chips)
7b7b5466: posts the ante 18
83f3b8e0: posts the ante 18
65f3225a: posts the ante 18
c807d389: posts the ante 18
9823561: posts the ante 18
5f608407: posts the ante 18
Hero: posts the ante 18
5bc4d104: posts the ante 18
65f3225a: posts small blind 60
5bc4d104: posts big blind 120
*** HOLE CARDS ***
Dealt to 83f3b8e0 
Dealt to 9823561 
Dealt to c807d389 
Dealt to 65f3225a 
Dealt to 5bc4d104 
Dealt to 7b7b5466 
Dealt to Hero [Jh Js]
Dealt to 5f608407 
7b7b5466: folds
Hero: raises 240 to 360
5f608407: folds
83f3b8e0: folds
9823561: folds
c807d389: folds
65f3225a: calls 300
5bc4d104: calls 240
*** FLOP *** [Kc As Qs]
65f3225a: checks
5bc4d104: checks
Hero: checks
*** TURN *** [Kc As Qs] [6h]
65f3225a: checks
5bc4d104: checks
Hero: checks
*** RIVER *** [Kc As Qs 6h] [7c]
65f3225a: checks
5bc4d104: checks
Hero: checks
65f3225a: shows [7s 9c] (Pair of Sevens)
5bc4d104: shows [7h 5h] (Pair of Sevens)
Hero: shows [Jh Js] (Pair of Jacks)
*** SHOWDOWN ***
Hero collected 1,224 from pot
*** SUMMARY ***
Total pot 1,224 | Rake 0 | Jackpot 0 | Bingo 0 | Fortune 0 | Tax 0
Board [Kc As Qs 6h 7c]
Seat 1: 83f3b8e0 folded before Flop
Seat 2: 9823561 folded before Flop
Seat 3: c807d389 (button) folded before Flop
Seat 4: 65f3225a (small blind) showed [7s 9c] and lost with Pair of Sevens
Seat 5: 5bc4d104 (big blind) showed [7h 5h] and lost with Pair of Sevens
Seat 6: 7b7b5466 folded before Flop
Seat 7: Hero showed [Jh Js] and won (1,224) with Pair of Jacks
Seat 8: 5f608407 folded before Flop


Poker Hand #TM3449861057: Tournament #149964808, Bounty Hunters Special $1.08 Hold'em No Limit - Level2(60/120) - 2024/07/03 20:40:56
Table '14' 8-max Seat #2 is the button
Seat 1: 83f3b8e0 (10,070 in chips)
Seat 2: 9823561 (9,350 in chips)
Seat 3: c807d389 (9,720 in chips)
Seat 4: 65f3225a (10,000 in chips)
Seat 5: 5bc4d104 (11,784 in chips)
Seat 6: 7b7b5466 (10,725 in chips)
Seat 7: Hero (20,292 in chips)
Seat 8: 5f608407 (7,803 in chips)
7b7b5466: posts the ante 18
83f3b8e0: posts the ante 18
65f3225a: posts the ante 18
c807d389: posts the ante 18
9823561: posts the ante 18
5f608407: posts the ante 18
Hero: posts the ante 18
5bc4d104: posts the ante 18
c807d389: posts small blind 60
65f3225a: posts big blind 120
*** HOLE CARDS ***
Dealt to 83f3b8e0 
Dealt to 9823561 
Dealt to c807d389 
Dealt to 65f3225a 
Dealt to 5bc4d104 
Dealt to 7b7b5466 
Dealt to Hero [Qs Ah]
Dealt to 5f608407 
5bc4d104: raises 120 to 240
7b7b5466: folds
Hero: calls 240
5f608407: raises 720 to 960
83f3b8e0: folds
9823561: folds
c807d389: folds
65f3225a: folds
5bc4d104: calls 720
Hero: folds
*** FLOP *** [6s Qd 9s]
5bc4d104: bets 1,242
5f608407: folds
Uncalled bet (1,242) returned to 5bc4d104
*** SHOWDOWN ***
5bc4d104 collected 2,484 from pot
*** SUMMARY ***
Total pot 2,484 | Rake 0 | Jackpot 0 | Bingo 0 | Fortune 0 | Tax 0
Board [6s Qd 9s]
Seat 1: 83f3b8e0 folded before Flop
Seat 2: 9823561 (button) folded before Flop
Seat 3: c807d389 (small blind) folded before Flop
Seat 4: 65f3225a (big blind) folded before Flop
Seat 5: 5bc4d104 won (2,484)
Seat 6: 7b7b5466 folded before Flop
Seat 7: Hero folded before Flop
Seat 8: 5f608407 folded on the Flop


Poker Hand #TM3449860964: Tournament #149964808, Bounty Hunters Special $1.08 Hold'em No Limit - Level1(50/100) - 2024/07/03 20:39:50
Table '14' 8-max Seat #1 is the button
Seat 1: 83f3b8e0 (9,680 in chips)
Seat 2: 9823561 (9,415 in chips)
Seat 3: c807d389 (9,985 in chips)
Seat 5: 5bc4d104 (11,799 in chips)
Seat 6: 7b7b5466 (10,740 in chips)
Seat 7: Hero (20,307 in chips)
Seat 8: 5f608407 (7,818 in chips)
7b7b5466: posts the ante 15
83f3b8e0: posts the ante 15
c807d389: posts the ante 15
9823561: posts the ante 15
5f608407: posts the ante 15
Hero: posts the ante 15
5bc4d104: posts the ante 15
9823561: posts small blind 50
c807d389: posts big blind 100
*** HOLE CARDS ***
Dealt to 83f3b8e0 
Dealt to 9823561 
Dealt to c807d389 
Dealt to 5bc4d104 
Dealt to 7b7b5466 
Dealt to Hero [7c Tc]
Dealt to 5f608407 
5bc4d104: folds
7b7b5466: folds
Hero: folds
5f608407: folds
83f3b8e0: raises 150 to 250
9823561: folds
c807d389: calls 150
*** FLOP *** [9h 2h 2c]
c807d389: checks
83f3b8e0: checks
*** TURN *** [9h 2h 2c] [3c]
c807d389: checks
83f3b8e0: bets 217
c807d389: folds
Uncalled bet (217) returned to 83f3b8e0
*** SHOWDOWN ***
83f3b8e0 collected 655 from pot
*** SUMMARY ***
Total pot 655 | Rake 0 | Jackpot 0 | Bingo 0 | Fortune 0 | Tax 0
Board [9h 2h 2c 3c]
Seat 1: 83f3b8e0 (button) won (655)
Seat 2: 9823561 (small blind) folded before Flop
Seat 3: c807d389 (big blind) folded on the Turn
Seat 5: 5bc4d104 folded before Flop
Seat 6: 7b7b5466 folded before Flop
Seat 7: Hero folded before Flop
Seat 8: 5f608407 folded before Flop


Poker Hand #TM3449860785: Tournament #149964808, Bounty Hunters Special $1.08 Hold'em No Limit - Level1(50/100) - 2024/07/03 20:37:49
Table '14' 8-max Seat #8 is the button
Seat 1: 83f3b8e0 (9,745 in chips)
Seat 2: 9823561 (10,115 in chips)
Seat 3: c807d389 (10,000 in chips)
Seat 4: 2b212758 (10,331 in chips)
Seat 5: 5bc4d104 (11,814 in chips)
Seat 6: 7b7b5466 (9,900 in chips)
Seat 7: Hero (20,322 in chips)
Seat 8: 5f608407 (7,833 in chips)
7b7b5466: posts the ante 15
83f3b8e0: posts the ante 15
2b212758: posts the ante 15
c807d389: posts the ante 15
9823561: posts the ante 15
5f608407: posts the ante 15
Hero: posts the ante 15
5bc4d104: posts the ante 15
83f3b8e0: posts small blind 50
9823561: posts big blind 100
*** HOLE CARDS ***
Dealt to 83f3b8e0 
Dealt to 9823561 
Dealt to c807d389 
Dealt to 2b212758 
Dealt to 5bc4d104 
Dealt to 7b7b5466 
Dealt to Hero [5d Qc]
Dealt to 5f608407 
c807d389: folds
2b212758: folds
5bc4d104: folds
7b7b5466: calls 100
Hero: folds
5f608407: folds
83f3b8e0: folds
9823561: raises 200 to 300
7b7b5466: calls 200
*** FLOP *** [Jh Td 3s]
9823561: checks
7b7b5466: bets 385
9823561: calls 385
*** TURN *** [Jh Td 3s] [Th]
9823561: checks
7b7b5466: bets 770
9823561: folds
Uncalled bet (770) returned to 7b7b5466
*** SHOWDOWN ***
7b7b5466 collected 1,540 from pot
*** SUMMARY ***
Total pot 1,540 | Rake 0 | Jackpot 0 | Bingo 0 | Fortune 0 | Tax 0
Board [Jh Td 3s Th]
Seat 1: 83f3b8e0 (small blind) folded before Flop
Seat 2: 9823561 (big blind) folded on the Turn
Seat 3: c807d389 folded before Flop
Seat 4: 2b212758 folded before Flop
Seat 5: 5bc4d104 folded before Flop
Seat 6: 7b7b5466 won (1,540)
Seat 7: Hero folded before Flop
Seat 8: 5f608407 (button) folded before Flop


Poker Hand #TM3449860690: Tournament #149964808, Bounty Hunters Special $1.08 Hold'em No Limit - Level1(50/100) - 2024/07/03 20:36:46
Table '14' 8-max Seat #7 is the button
Seat 1: 83f3b8e0 (9,860 in chips)
Seat 2: 9823561 (10,130 in chips)
Seat 3: b3c9ab49 (1,019 in chips)
Seat 4: 2b212758 (10,346 in chips)
Seat 5: 5bc4d104 (10,555 in chips)
Seat 6: 7b7b5466 (9,915 in chips)
Seat 7: Hero (20,337 in chips)
Seat 8: 5f608407 (7,898 in chips)
7b7b5466: posts the ante 15
83f3b8e0: posts the ante 15
2b212758: posts the ante 15
b3c9ab49: posts the ante 15
9823561: posts the ante 15
5f608407: posts the ante 15
Hero: posts the ante 15
5bc4d104: posts the ante 15
5f608407: posts small blind 50
83f3b8e0: posts big blind 100
*** HOLE CARDS ***
Dealt to 83f3b8e0 
Dealt to 9823561 
Dealt to b3c9ab49 
Dealt to 2b212758 
Dealt to 5bc4d104 
Dealt to 7b7b5466 
Dealt to Hero [8h Jc]
Dealt to 5f608407 
9823561: folds
b3c9ab49: raises 904 to 1,004 and is all-in
2b212758: folds
5bc4d104: calls 1,004
7b7b5466: folds
Hero: folds
5f608407: folds
83f3b8e0: folds
b3c9ab49: shows [Qc 9h]
5bc4d104: shows [Qd Jh]
*** FLOP *** [7s Ad Ac]
*** TURN *** [7s Ad Ac] [Qh]
*** RIVER *** [7s Ad Ac Qh] [5s]
*** SHOWDOWN ***
5bc4d104 collected 2,278 from pot
*** SUMMARY ***
Total pot 2,278 | Rake 0 | Jackpot 0 | Bingo 0 | Fortune 0 | Tax 0
Board [7s Ad Ac Qh 5s]
Seat 1: 83f3b8e0 (big blind) folded before Flop
Seat 2: 9823561 folded before Flop
Seat 3: b3c9ab49 showed [Qc 9h] and lost with Pair of Aces and Pair of Queens
Seat 4: 2b212758 folded before Flop
Seat 5: 5bc4d104 showed [Qd Jh] and won (2,278) with Pair of Aces and Pair of Queens
Seat 6: 7b7b5466 folded before Flop
Seat 7: Hero (button) folded before Flop
Seat 8: 5f608407 (small blind) folded before Flop


Poker Hand #TM3449860609: Tournament #149964808, Bounty Hunters Special $1.08 Hold'em No Limit - Level1(50/100) - 2024/07/03 20:35:58
Table '14' 8-max Seat #6 is the button
Seat 1: 83f3b8e0 (9,875 in chips)
Seat 2: 9823561 (10,145 in chips)
Seat 3: b3c9ab49 (1,034 in chips)
Seat 4: 2b212758 (10,361 in chips)
Seat 5: 5bc4d104 (10,000 in chips)
Seat 6: 7b7b5466 (10,130 in chips)
Seat 7: Hero (20,402 in chips)
Seat 8: 5f608407 (8,113 in chips)
7b7b5466: posts the ante 15
83f3b8e0: posts the ante 15
2b212758: posts the ante 15
b3c9ab49: posts the ante 15
9823561: posts the ante 15
5f608407: posts the ante 15
Hero: posts the ante 15
5bc4d104: posts the ante 15
Hero: posts small blind 50
5f608407: posts big blind 100
*** HOLE CARDS ***
Dealt to 83f3b8e0 
Dealt to 9823561 
Dealt to b3c9ab49 
Dealt to 2b212758 
Dealt to 5bc4d104 
Dealt to 7b7b5466 
Dealt to Hero [9c 4s]
Dealt to 5f608407 
83f3b8e0: folds
9823561: folds
b3c9ab49: folds
2b212758: folds
5bc4d104: raises 100 to 200
7b7b5466: calls 200
Hero: folds
5f608407: calls 100
*** FLOP *** [Ts Td 7s]
5f608407: checks
5bc4d104: bets 200
7b7b5466: folds
5f608407: folds
Uncalled bet (200) returned to 5bc4d104
*** SHOWDOWN ***
5bc4d104 collected 770 from pot
*** SUMMARY ***
Total pot 770 | Rake 0 | Jackpot 0 | Bingo 0 | Fortune 0 | Tax 0
Board [Ts Td 7s]
Seat 1: 83f3b8e0 folded before Flop
Seat 2: 9823561 folded before Flop
Seat 3: b3c9ab49 folded before Flop
Seat 4: 2b212758 folded before Flop
Seat 5: 5bc4d104 won (770)
Seat 6: 7b7b5466 (button) folded on the Flop
Seat 7: Hero (small blind) folded before Flop
Seat 8: 5f608407 (big blind) folded on the Flop


Poker Hand #TM3449860528: Tournament #149964808, Bounty Hunters Special $1.08 Hold'em No Limit - Level1(50/100) - 2024/07/03 20:35:09
Table '14' 8-max Seat #4 is the button
Seat 1: 83f3b8e0 (9,890 in chips)
Seat 2: 9823561 (10,160 in chips)
Seat 3: b3c9ab49 (1,049 in chips)
Seat 4: 2b212758 (10,376 in chips)
Seat 6: 7b7b5466 (9,840 in chips)
Seat 7: Hero (20,617 in chips)
Seat 8: 5f608407 (8,128 in chips)
7b7b5466: posts the ante 15
83f3b8e0: posts the ante 15
2b212758: posts the ante 15
b3c9ab49: posts the ante 15
9823561: posts the ante 15
5f608407: posts the ante 15
Hero: posts the ante 15
7b7b5466: posts small blind 50
Hero: posts big blind 100
*** HOLE CARDS ***
Dealt to 83f3b8e0 
Dealt to 9823561 
Dealt to b3c9ab49 
Dealt to 2b212758 
Dealt to 7b7b5466 
Dealt to Hero [9s 4h]
Dealt to 5f608407 
5f608407: folds
83f3b8e0: folds
9823561: folds
b3c9ab49: folds
2b212758: folds
7b7b5466: raises 100 to 200
Hero: calls 100
*** FLOP *** [Kd Qc Qd]
7b7b5466: checks
Hero: checks
*** TURN *** [Kd Qc Qd] [5c]
7b7b5466: checks
Hero: checks
*** RIVER *** [Kd Qc Qd 5c] [7h]
7b7b5466: checks
Hero: checks
7b7b5466: shows [As 6h] (Pair of Queens)
Hero: shows [9s 4h] (Pair of Queens)
*** SHOWDOWN ***
7b7b5466 collected 505 from pot
*** SUMMARY ***
Total pot 505 | Rake 0 | Jackpot 0 | Bingo 0 | Fortune 0 | Tax 0
Board [Kd Qc Qd 5c 7h]
Seat 1: 83f3b8e0 folded before Flop
Seat 2: 9823561 folded before Flop
Seat 3: b3c9ab49 folded before Flop
Seat 4: 2b212758 (button) folded before Flop
Seat 6: 7b7b5466 (small blind) showed [As 6h] and won (505) with Pair of Queens
Seat 7: Hero (big blind) showed [9s 4h] and lost with Pair of Queens
Seat 8: 5f608407 folded before Flop


Poker Hand #TM3449860402: Tournament #149964808, Bounty Hunters Special $1.08 Hold'em No Limit - Level1(50/100) - 2024/07/03 20:33:46
Table '14' 8-max Seat #3 is the button
Seat 1: 83f3b8e0 (9,905 in chips)
Seat 2: 9823561 (10,175 in chips)
Seat 3: b3c9ab49 (10,904 in chips)
Seat 4: 2b212758 (10,441 in chips)
Seat 6: 7b7b5466 (9,955 in chips)
Seat 7: Hero (9,855 in chips)
Seat 8: 5f608407 (8,825 in chips)
7b7b5466: posts the ante 15
83f3b8e0: posts the ante 15
2b212758: posts the ante 15
b3c9ab49: posts the ante 15
9823561: posts the ante 15
5f608407: posts the ante 15
Hero: posts the ante 15
2b212758: posts small blind 50
7b7b5466: posts big blind 100
*** HOLE CARDS ***
Dealt to 83f3b8e0 
Dealt to 9823561 
Dealt to b3c9ab49 
Dealt to 2b212758 
Dealt to 7b7b5466 
Dealt to Hero [As 5s]
Dealt to 5f608407 
Hero: calls 100
5f608407: raises 200 to 300
83f3b8e0: folds
9823561: folds
b3c9ab49: calls 300
2b212758: folds
7b7b5466: folds
Hero: calls 200
*** FLOP *** [2h 6s 2s]
Hero: bets 382
5f608407: calls 382
b3c9ab49: raises 10,207 to 10,589 and is all-in
Hero: calls 9,158 and is all-in
5f608407: folds
Uncalled bet (1,049) returned to b3c9ab49
b3c9ab49: shows [6h 7d] (Pair of Sixes and Pair of Twos)
Hero: shows [As 5s] (Pair of Twos)
*** TURN *** [2h 6s 2s] [Ad]
*** RIVER *** [2h 6s 2s Ad] [8c]
*** SHOWDOWN ***
Hero collected 20,617 from pot
*** SUMMARY ***
Total pot 20,617 | Rake 0 | Jackpot 0 | Bingo 0 | Fortune 0 | Tax 0
Board [2h 6s 2s Ad 8c]
Seat 1: 83f3b8e0 folded before Flop
Seat 2: 9823561 folded before Flop
Seat 3: b3c9ab49 (button) showed [6h 7d] and lost with Pair of Sixes and Pair of Twos
Seat 4: 2b212758 (small blind) folded before Flop
Seat 6: 7b7b5466 (big blind) folded before Flop
Seat 7: Hero showed [As 5s] and won (20,617) with Pair of Aces and Pair of Twos
Seat 8: 5f608407 folded on the Flop


Poker Hand #TM3449860287: Tournament #149964808, Bounty Hunters Special $1.08 Hold'em No Limit - Level1(50/100) - 2024/07/03 20:32:32
Table '14' 8-max Seat #2 is the button
Seat 1: 83f3b8e0 (9,920 in chips)
Seat 2: 9823561 (10,190 in chips)
Seat 3: b3c9ab49 (9,569 in chips)
Seat 4: 2b212758 (10,556 in chips)
Seat 5: 8b6c31b (9,970 in chips)
Seat 6: 7b7b5466 (9,970 in chips)
Seat 7: Hero (9,870 in chips)
Seat 8: 5f608407 (9,970 in chips)
7b7b5466: posts the ante 15
8b6c31b: posts the ante 15
83f3b8e0: posts the ante 15
2b212758: posts the ante 15
b3c9ab49: posts the ante 15
9823561: posts the ante 15
5f608407: posts the ante 15
Hero: posts the ante 15
b3c9ab49: posts small blind 50
2b212758: posts big blind 100
*** HOLE CARDS ***
Dealt to 83f3b8e0 
Dealt to 9823561 
Dealt to b3c9ab49 
Dealt to 2b212758 
Dealt to 8b6c31b 
Dealt to 7b7b5466 
Dealt to Hero [Qc 3c]
Dealt to 5f608407 
8b6c31b: folds
7b7b5466: folds
Hero: folds
5f608407: raises 100 to 200
83f3b8e0: folds
9823561: folds
b3c9ab49: raises 310 to 510
2b212758: folds
5f608407: calls 310
*** FLOP *** [Js 8s 9h]
b3c9ab49: bets 620
5f608407: calls 620
*** TURN *** [Js 8s 9h] [8d]
b3c9ab49: bets 1,860
5f608407: folds
Uncalled bet (1,860) returned to b3c9ab49
*** SHOWDOWN ***
b3c9ab49 collected 2,480 from pot
*** SUMMARY ***
Total pot 2,480 | Rake 0 | Jackpot 0 | Bingo 0 | Fortune 0 | Tax 0
Board [Js 8s 9h 8d]
Seat 1: 83f3b8e0 folded before Flop
Seat 2: 9823561 (button) folded before Flop
Seat 3: b3c9ab49 (small blind) won (2,480)
Seat 4: 2b212758 (big blind) folded before Flop
Seat 5: 8b6c31b folded before Flop
Seat 6: 7b7b5466 folded before Flop
Seat 7: Hero folded before Flop
Seat 8: 5f608407 folded on the Turn


Poker Hand #TM3449860197: Tournament #149964808, Bounty Hunters Special $1.08 Hold'em No Limit - Level1(50/100) - 2024/07/03 20:31:32
Table '14' 8-max Seat #1 is the button
Seat 1: 83f3b8e0 (9,935 in chips)
Seat 2: 9823561 (10,255 in chips)
Seat 3: b3c9ab49 (10,000 in chips)
Seat 4: 2b212758 (9,985 in chips)
Seat 5: 8b6c31b (9,985 in chips)
Seat 6: 7b7b5466 (9,985 in chips)
Seat 7: Hero (9,885 in chips)
Seat 8: 5f608407 (9,985 in chips)
7b7b5466: posts the ante 15
8b6c31b: posts the ante 15
83f3b8e0: posts the ante 15
2b212758: posts the ante 15
b3c9ab49: posts the ante 15
9823561: posts the ante 15
5f608407: posts the ante 15
Hero: posts the ante 15
9823561: posts small blind 50
b3c9ab49: posts big blind 100
*** HOLE CARDS ***
Dealt to 83f3b8e0 
Dealt to 9823561 
Dealt to b3c9ab49 
Dealt to 2b212758 
Dealt to 8b6c31b 
Dealt to 7b7b5466 
Dealt to Hero [7s 6c]
Dealt to 5f608407 
2b212758: raises 120 to 220
8b6c31b: folds
7b7b5466: folds
Hero: folds
5f608407: folds
83f3b8e0: folds
9823561: folds
b3c9ab49: calls 120
*** FLOP *** [Kd 7h Jc]
b3c9ab49: checks
2b212758: bets 196
b3c9ab49: calls 196
*** TURN *** [Kd 7h Jc] [Kc]
b3c9ab49: checks
2b212758: bets 400
b3c9ab49: folds
Uncalled bet (400) returned to 2b212758
*** SHOWDOWN ***
2b212758 collected 1,002 from pot
*** SUMMARY ***
Total pot 1,002 | Rake 0 | Jackpot 0 | Bingo 0 | Fortune 0 | Tax 0
Board [Kd 7h Jc Kc]
Seat 1: 83f3b8e0 (button) folded before Flop
Seat 2: 9823561 (small blind) folded before Flop
Seat 3: b3c9ab49 (big blind) folded on the Turn
Seat 4: 2b212758 won (1,002)
Seat 5: 8b6c31b folded before Flop
Seat 6: 7b7b5466 folded before Flop
Seat 7: Hero folded before Flop
Seat 8: 5f608407 folded before Flop


Poker Hand #TM3449860055: Tournament #149964808, Bounty Hunters Special $1.08 Hold'em No Limit - Level1(50/100) - 2024/07/03 20:30:02
Table '14' 8-max Seat #8 is the button
Seat 1: 83f3b8e0 (10,000 in chips)
Seat 2: 9823561 (10,000 in chips)
Seat 3: 7372a93b (10,000 in chips)
Seat 4: 2b212758 (10,000 in chips)
Seat 5: 8b6c31b (10,000 in chips)
Seat 6: 7b7b5466 (10,000 in chips)
Seat 7: Hero (10,000 in chips)
Seat 8: 5f608407 (10,000 in chips)
7b7b5466: posts the ante 15
8b6c31b: posts the ante 15
83f3b8e0: posts the ante 15
2b212758: posts the ante 15
7372a93b: posts the ante 15
9823561: posts the ante 15
5f608407: posts the ante 15
Hero: posts the ante 15
83f3b8e0: posts small blind 50
9823561: posts big blind 100
*** HOLE CARDS ***
Dealt to 83f3b8e0 
Dealt to 9823561 
Dealt to 7372a93b 
Dealt to 2b212758 
Dealt to 8b6c31b 
Dealt to 7b7b5466 
Dealt to Hero [5h 6h]
Dealt to 5f608407 
7372a93b: folds
2b212758: folds
8b6c31b: folds
7b7b5466: folds
Hero: calls 100
5f608407: folds
83f3b8e0: folds
9823561: checks
*** FLOP *** [Td Kd 5d]
9823561: checks
Hero: checks
*** TURN *** [Td Kd 5d] [Jd]
9823561: checks
Hero: checks
*** RIVER *** [Td Kd 5d Jd] [2h]
9823561: bets 1,000
Hero: folds
Uncalled bet (1,000) returned to 9823561
*** SHOWDOWN ***
9823561 collected 370 from pot
*** SUMMARY ***
Total pot 370 | Rake 0 | Jackpot 0 | Bingo 0 | Fortune 0 | Tax 0
Board [Td Kd 5d Jd 2h]
Seat 1: 83f3b8e0 (small blind) folded before Flop
Seat 2: 9823561 (big blind) won (370)
Seat 3: 7372a93b folded before Flop
Seat 4: 2b212758 folded before Flop
Seat 5: 8b6c31b folded before Flop
Seat 6: 7b7b5466 folded before Flop
Seat 7: Hero folded on the River
Seat 8: 5f608407 (button) folded before Flop


