Poker Hand #TM3577473022: Tournament #157957577, Bounty Hunters Big One $1.08 Hold'em No Limit - Level2(60/120) - 2024/08/13 17:49:51
Table '102' 8-max Seat #4 is the button
Seat 1: Hero (1,842 in chips)
Seat 2: 4685d1a2 (9,945 in chips)
Seat 3: f4826447 (8,274 in chips)
Seat 4: d218129 (20,828 in chips)
Seat 5: b17739e2 (11,655 in chips)
Seat 6: c6700974 (10,431 in chips)
Seat 7: 7399ac60 (13,564 in chips)
Seat 8: 2f13ac41 (6,040 in chips)
d218129: posts the ante 18
b17739e2: posts the ante 18
4685d1a2: posts the ante 18
7399ac60: posts the ante 18
c6700974: posts the ante 18
2f13ac41: posts the ante 18
f4826447: posts the ante 18
Hero: posts the ante 18
b17739e2: posts small blind 60
c6700974: posts big blind 120
*** HOLE CARDS ***
Dealt to Hero [As 5s]
Dealt to 4685d1a2 
Dealt to f4826447 
Dealt to d218129 
Dealt to b17739e2 
Dealt to c6700974 
Dealt to 7399ac60 
Dealt to 2f13ac41 
7399ac60: calls 120
2f13ac41: folds
Hero: raises 1,704 to 1,824 and is all-in
4685d1a2: folds
f4826447: folds
d218129: raises 18,986 to 20,810 and is all-in
b17739e2: folds
c6700974: folds
7399ac60: folds
Uncalled bet (18,986) returned to d218129
d218129: shows [7d 4d]
Hero: shows [As 5s]
*** FLOP *** [2h Tc 5d]
*** TURN *** [2h Tc 5d] [Qd]
*** RIVER *** [2h Tc 5d Qd] [7s]
*** SHOWDOWN ***
d218129 collected 4,092 from pot
*** SUMMARY ***
Total pot 4,092 | Rake 0 | Jackpot 0 | Bingo 0 | Fortune 0 | Tax 0
Board [2h Tc 5d Qd 7s]
Seat 1: Hero showed [As 5s] and lost with Pair of Fives
Seat 2: 4685d1a2 folded before Flop
Seat 3: f4826447 folded before Flop
Seat 4: d218129 (button) showed [7d 4d] and won (4,092) with Pair of Sevens
Seat 5: b17739e2 (small blind) folded before Flop
Seat 6: c6700974 (big blind) folded before Flop
Seat 7: 7399ac60 folded before Flop
Seat 8: 2f13ac41 folded before Flop


Poker Hand #TM3577472992: Tournament #157957577, Bounty Hunters Big One $1.08 Hold'em No Limit - Level2(60/120) - 2024/08/13 17:48:31
Table '102' 8-max Seat #3 is the button
Seat 1: Hero (11,542 in chips)
Seat 2: 4685d1a2 (9,963 in chips)
Seat 3: f4826447 (9,492 in chips)
Seat 4: d218129 (9,700 in chips)
Seat 5: b17739e2 (11,793 in chips)
Seat 6: c6700974 (10,449 in chips)
Seat 7: 7399ac60 (13,582 in chips)
Seat 8: 2f13ac41 (6,058 in chips)
b17739e2: posts the ante 18
d218129: posts the ante 18
4685d1a2: posts the ante 18
7399ac60: posts the ante 18
c6700974: posts the ante 18
2f13ac41: posts the ante 18
f4826447: posts the ante 18
Hero: posts the ante 18
d218129: posts small blind 60
b17739e2: posts big blind 120
*** HOLE CARDS ***
Dealt to Hero [Kd Ks]
Dealt to 4685d1a2 
Dealt to f4826447 
Dealt to d218129 
Dealt to b17739e2 
Dealt to c6700974 
Dealt to 7399ac60 
Dealt to 2f13ac41 
c6700974: folds
7399ac60: folds
2f13ac41: folds
Hero: raises 240 to 360
4685d1a2: folds
f4826447: raises 840 to 1,200
d218129: raises 8,482 to 9,682 and is all-in
b17739e2: folds
Hero: calls 9,322
f4826447: folds
d218129: shows [Ah Tc]
Hero: shows [Kd Ks]
*** FLOP *** [9d 9c Ad]
*** TURN *** [9d 9c Ad] [Jh]
*** RIVER *** [9d 9c Ad Jh] [Jd]
*** SHOWDOWN ***
d218129 collected 20,828 from pot
*** SUMMARY ***
Total pot 20,828 | Rake 0 | Jackpot 0 | Bingo 0 | Fortune 0 | Tax 0
Board [9d 9c Ad Jh Jd]
Seat 1: Hero showed [Kd Ks] and lost with Pair of Kings and Pair of Jacks
Seat 2: 4685d1a2 folded before Flop
Seat 3: f4826447 (button) folded before Flop
Seat 4: d218129 (small blind) showed [Ah Tc] and won (20,828) with Pair of Aces and Pair of Jacks
Seat 5: b17739e2 (big blind) folded before Flop
Seat 6: c6700974 folded before Flop
Seat 7: 7399ac60 folded before Flop
Seat 8: 2f13ac41 folded before Flop


Poker Hand #TM3577472983: Tournament #157957577, Bounty Hunters Big One $1.08 Hold'em No Limit - Level2(60/120) - 2024/08/13 17:47:57
Table '102' 8-max Seat #2 is the button
Seat 1: Hero (11,560 in chips)
Seat 2: 4685d1a2 (9,981 in chips)
Seat 3: f4826447 (9,570 in chips)
Seat 4: d218129 (9,982 in chips)
Seat 5: b17739e2 (11,811 in chips)
Seat 6: c6700974 (10,467 in chips)
Seat 7: 7399ac60 (13,600 in chips)
Seat 8: 2f13ac41 (5,608 in chips)
b17739e2: posts the ante 18
d218129: posts the ante 18
4685d1a2: posts the ante 18
7399ac60: posts the ante 18
c6700974: posts the ante 18
2f13ac41: posts the ante 18
f4826447: posts the ante 18
Hero: posts the ante 18
f4826447: posts small blind 60
d218129: posts big blind 120
*** HOLE CARDS ***
Dealt to Hero [9s 6c]
Dealt to 4685d1a2 
Dealt to f4826447 
Dealt to d218129 
Dealt to b17739e2 
Dealt to c6700974 
Dealt to 7399ac60 
Dealt to 2f13ac41 
b17739e2: folds
c6700974: folds
7399ac60: folds
2f13ac41: raises 144 to 264
Hero: folds
4685d1a2: folds
f4826447: folds
d218129: calls 144
*** FLOP *** [5h Qs Ah]
d218129: checks
2f13ac41: checks
*** TURN *** [5h Qs Ah] [8s]
d218129: checks
2f13ac41: checks
*** RIVER *** [5h Qs Ah 8s] [7s]
d218129: checks
2f13ac41: checks
d218129: shows [9c 2c] (Ace-High)
2f13ac41: shows [Kd 3d] (Ace-High)
*** SHOWDOWN ***
2f13ac41 collected 732 from pot
*** SUMMARY ***
Total pot 732 | Rake 0 | Jackpot 0 | Bingo 0 | Fortune 0 | Tax 0
Board [5h Qs Ah 8s 7s]
Seat 1: Hero folded before Flop
Seat 2: 4685d1a2 (button) folded before Flop
Seat 3: f4826447 (small blind) folded before Flop
Seat 4: d218129 (big blind) showed [9c 2c] and lost with Ace-High
Seat 5: b17739e2 folded before Flop
Seat 6: c6700974 folded before Flop
Seat 7: 7399ac60 folded before Flop
Seat 8: 2f13ac41 showed [Kd 3d] and won (732) with Ace-High


Poker Hand #TM3577472960: Tournament #157957577, Bounty Hunters Big One $1.08 Hold'em No Limit - Level2(60/120) - 2024/08/13 17:47:02
Table '102' 8-max Seat #1 is the button
Seat 1: Hero (14,236 in chips)
Seat 2: 4685d1a2 (10,059 in chips)
Seat 3: f4826447 (9,708 in chips)
Seat 4: d218129 (10,000 in chips)
Seat 5: b17739e2 (11,829 in chips)
Seat 6: c6700974 (10,485 in chips)
Seat 7: 7399ac60 (10,636 in chips)
Seat 8: 2f13ac41 (5,626 in chips)
b17739e2: posts the ante 18
d218129: posts the ante 18
4685d1a2: posts the ante 18
7399ac60: posts the ante 18
c6700974: posts the ante 18
2f13ac41: posts the ante 18
f4826447: posts the ante 18
Hero: posts the ante 18
4685d1a2: posts small blind 60
f4826447: posts big blind 120
*** HOLE CARDS ***
Dealt to Hero [Kd Qd]
Dealt to 4685d1a2 
Dealt to f4826447 
Dealt to d218129 
Dealt to b17739e2 
Dealt to c6700974 
Dealt to 7399ac60 
Dealt to 2f13ac41 
d218129: folds
b17739e2: folds
c6700974: folds
7399ac60: calls 120
2f13ac41: folds
Hero: raises 282 to 402
4685d1a2: folds
f4826447: folds
7399ac60: calls 282
*** FLOP *** [3c Jh Ts]
7399ac60: checks
Hero: bets 564
7399ac60: calls 564
*** TURN *** [3c Jh Ts] [Qs]
7399ac60: checks
Hero: bets 1,692
7399ac60: calls 1,692
*** RIVER *** [3c Jh Ts Qs] [Th]
7399ac60: bets 5,640
Hero: folds
Uncalled bet (5,640) returned to 7399ac60
Hero: shows [Qd] (Pair of Queens and Pair of Tens)
*** SHOWDOWN ***
7399ac60 collected 5,640 from pot
*** SUMMARY ***
Total pot 5,640 | Rake 0 | Jackpot 0 | Bingo 0 | Fortune 0 | Tax 0
Board [3c Jh Ts Qs Th]
Seat 1: Hero (button) folded on the River
Seat 2: 4685d1a2 (small blind) folded before Flop
Seat 3: f4826447 (big blind) folded before Flop
Seat 4: d218129 folded before Flop
Seat 5: b17739e2 folded before Flop
Seat 6: c6700974 folded before Flop
Seat 7: 7399ac60 won (5,640)
Seat 8: 2f13ac41 folded before Flop


Poker Hand #TM3577472954: Tournament #157957577, Bounty Hunters Big One $1.08 Hold'em No Limit - Level2(60/120) - 2024/08/13 17:46:40
Table '102' 8-max Seat #8 is the button
Seat 1: Hero (14,314 in chips)
Seat 2: 4685d1a2 (10,197 in chips)
Seat 3: f4826447 (9,726 in chips)
Seat 4: 3834ad1f (18,813 in chips)
Seat 5: b17739e2 (11,847 in chips)
Seat 6: c6700974 (10,503 in chips)
Seat 7: 7399ac60 (10,330 in chips)
Seat 8: 2f13ac41 (5,644 in chips)
b17739e2: posts the ante 18
4685d1a2: posts the ante 18
7399ac60: posts the ante 18
c6700974: posts the ante 18
2f13ac41: posts the ante 18
f4826447: posts the ante 18
3834ad1f: posts the ante 18
Hero: posts the ante 18
Hero: posts small blind 60
4685d1a2: posts big blind 120
*** HOLE CARDS ***
Dealt to Hero [Ks 2c]
Dealt to 4685d1a2 
Dealt to f4826447 
Dealt to 3834ad1f 
Dealt to b17739e2 
Dealt to c6700974 
Dealt to 7399ac60 
Dealt to 2f13ac41 
f4826447: folds
3834ad1f: folds
b17739e2: folds
c6700974: folds
7399ac60: raises 360 to 480
2f13ac41: folds
Hero: folds
4685d1a2: folds
Uncalled bet (360) returned to 7399ac60
*** SHOWDOWN ***
7399ac60 collected 444 from pot
*** SUMMARY ***
Total pot 444 | Rake 0 | Jackpot 0 | Bingo 0 | Fortune 0 | Tax 0
Seat 1: Hero (small blind) folded before Flop
Seat 2: 4685d1a2 (big blind) folded before Flop
Seat 3: f4826447 folded before Flop
Seat 4: 3834ad1f folded before Flop
Seat 5: b17739e2 folded before Flop
Seat 6: c6700974 folded before Flop
Seat 7: 7399ac60 collected (444)
Seat 8: 2f13ac41 (button) folded before Flop


Poker Hand #TM3577472941: Tournament #157957577, Bounty Hunters Big One $1.08 Hold'em No Limit - Level2(60/120) - 2024/08/13 17:46:05
Table '102' 8-max Seat #7 is the button
Seat 1: Hero (14,692 in chips)
Seat 2: 4685d1a2 (10,215 in chips)
Seat 3: f4826447 (9,744 in chips)
Seat 4: 3834ad1f (18,831 in chips)
Seat 5: b17739e2 (11,865 in chips)
Seat 6: c6700974 (10,521 in chips)
Seat 7: 7399ac60 (9,784 in chips)
Seat 8: 2f13ac41 (5,722 in chips)
b17739e2: posts the ante 18
4685d1a2: posts the ante 18
7399ac60: posts the ante 18
c6700974: posts the ante 18
2f13ac41: posts the ante 18
f4826447: posts the ante 18
3834ad1f: posts the ante 18
Hero: posts the ante 18
2f13ac41: posts small blind 60
Hero: posts big blind 120
*** HOLE CARDS ***
Dealt to Hero [5h Ah]
Dealt to 4685d1a2 
Dealt to f4826447 
Dealt to 3834ad1f 
Dealt to b17739e2 
Dealt to c6700974 
Dealt to 7399ac60 
Dealt to 2f13ac41 
4685d1a2: folds
f4826447: folds
3834ad1f: folds
b17739e2: folds
c6700974: folds
7399ac60: raises 240 to 360
2f13ac41: folds
Hero: calls 240
*** FLOP *** [2d Ks Qh]
Hero: checks
7399ac60: bets 693
Hero: folds
Uncalled bet (693) returned to 7399ac60
*** SHOWDOWN ***
7399ac60 collected 924 from pot
*** SUMMARY ***
Total pot 924 | Rake 0 | Jackpot 0 | Bingo 0 | Fortune 0 | Tax 0
Board [2d Ks Qh]
Seat 1: Hero (big blind) folded on the Flop
Seat 2: 4685d1a2 folded before Flop
Seat 3: f4826447 folded before Flop
Seat 4: 3834ad1f folded before Flop
Seat 5: b17739e2 folded before Flop
Seat 6: c6700974 folded before Flop
Seat 7: 7399ac60 (button) won (924)
Seat 8: 2f13ac41 (small blind) folded before Flop


Poker Hand #TM3577472926: Tournament #157957577, Bounty Hunters Big One $1.08 Hold'em No Limit - Level2(60/120) - 2024/08/13 17:45:21
Table '102' 8-max Seat #6 is the button
Seat 1: Hero (14,950 in chips)
Seat 2: 4685d1a2 (10,233 in chips)
Seat 3: f4826447 (9,762 in chips)
Seat 4: 3834ad1f (18,849 in chips)
Seat 5: b17739e2 (11,883 in chips)
Seat 6: c6700974 (10,539 in chips)
Seat 7: 7399ac60 (9,862 in chips)
Seat 8: 2f13ac41 (5,296 in chips)
b17739e2: posts the ante 18
4685d1a2: posts the ante 18
c6700974: posts the ante 18
7399ac60: posts the ante 18
2f13ac41: posts the ante 18
f4826447: posts the ante 18
3834ad1f: posts the ante 18
Hero: posts the ante 18
7399ac60: posts small blind 60
2f13ac41: posts big blind 120
*** HOLE CARDS ***
Dealt to Hero [Ac 7c]
Dealt to 4685d1a2 
Dealt to f4826447 
Dealt to 3834ad1f 
Dealt to b17739e2 
Dealt to c6700974 
Dealt to 7399ac60 
Dealt to 2f13ac41 
Hero: raises 120 to 240
4685d1a2: folds
f4826447: folds
3834ad1f: folds
b17739e2: folds
c6700974: folds
7399ac60: folds
2f13ac41: calls 120
*** FLOP *** [Jd Jh Qs]
2f13ac41: checks
Hero: checks
*** TURN *** [Jd Jh Qs] [8s]
2f13ac41: bets 480
Hero: folds
Uncalled bet (480) returned to 2f13ac41
*** SHOWDOWN ***
2f13ac41 collected 684 from pot
*** SUMMARY ***
Total pot 684 | Rake 0 | Jackpot 0 | Bingo 0 | Fortune 0 | Tax 0
Board [Jd Jh Qs 8s]
Seat 1: Hero folded on the Turn
Seat 2: 4685d1a2 folded before Flop
Seat 3: f4826447 folded before Flop
Seat 4: 3834ad1f folded before Flop
Seat 5: b17739e2 folded before Flop
Seat 6: c6700974 (button) folded before Flop
Seat 7: 7399ac60 (small blind) folded before Flop
Seat 8: 2f13ac41 (big blind) won (684)


Poker Hand #TM3577472907: Tournament #157957577, Bounty Hunters Big One $1.08 Hold'em No Limit - Level2(60/120) - 2024/08/13 17:44:40
Table '102' 8-max Seat #5 is the button
Seat 1: Hero (14,968 in chips)
Seat 2: 4685d1a2 (9,363 in chips)
Seat 3: f4826447 (9,780 in chips)
Seat 4: 3834ad1f (18,867 in chips)
Seat 5: b17739e2 (11,901 in chips)
Seat 6: c6700974 (10,617 in chips)
Seat 7: 7399ac60 (10,000 in chips)
Seat 8: 2f13ac41 (5,878 in chips)
b17739e2: posts the ante 18
4685d1a2: posts the ante 18
7399ac60: posts the ante 18
c6700974: posts the ante 18
2f13ac41: posts the ante 18
f4826447: posts the ante 18
3834ad1f: posts the ante 18
Hero: posts the ante 18
c6700974: posts small blind 60
7399ac60: posts big blind 120
*** HOLE CARDS ***
Dealt to Hero [7d Jh]
Dealt to 4685d1a2 
Dealt to f4826447 
Dealt to 3834ad1f 
Dealt to b17739e2 
Dealt to c6700974 
Dealt to 7399ac60 
Dealt to 2f13ac41 
2f13ac41: raises 144 to 264
Hero: folds
4685d1a2: calls 264
f4826447: folds
3834ad1f: folds
b17739e2: folds
c6700974: folds
7399ac60: folds
*** FLOP *** [As 2s Ts]
2f13ac41: checks
4685d1a2: bets 300
2f13ac41: calls 300
*** TURN *** [As 2s Ts] [4s]
2f13ac41: checks
4685d1a2: bets 480
2f13ac41: folds
Uncalled bet (480) returned to 4685d1a2
*** SHOWDOWN ***
4685d1a2 collected 1,452 from pot
*** SUMMARY ***
Total pot 1,452 | Rake 0 | Jackpot 0 | Bingo 0 | Fortune 0 | Tax 0
Board [As 2s Ts 4s]
Seat 1: Hero folded before Flop
Seat 2: 4685d1a2 won (1,452)
Seat 3: f4826447 folded before Flop
Seat 4: 3834ad1f folded before Flop
Seat 5: b17739e2 (button) folded before Flop
Seat 6: c6700974 (small blind) folded before Flop
Seat 7: 7399ac60 (big blind) folded before Flop
Seat 8: 2f13ac41 folded on the Turn


Poker Hand #TM3577472888: Tournament #157957577, Bounty Hunters Big One $1.08 Hold'em No Limit - Level2(60/120) - 2024/08/13 17:43:54
Table '102' 8-max Seat #4 is the button
Seat 1: Hero (14,986 in chips)
Seat 2: 4685d1a2 (9,681 in chips)
Seat 3: f4826447 (9,798 in chips)
Seat 4: 3834ad1f (18,885 in chips)
Seat 5: b17739e2 (11,979 in chips)
Seat 6: c6700974 (10,131 in chips)
Seat 7: 287e6858 (8,644 in chips)
Seat 8: 2f13ac41 (5,896 in chips)
b17739e2: posts the ante 18
4685d1a2: posts the ante 18
c6700974: posts the ante 18
287e6858: posts the ante 18
2f13ac41: posts the ante 18
f4826447: posts the ante 18
3834ad1f: posts the ante 18
Hero: posts the ante 18
b17739e2: posts small blind 60
c6700974: posts big blind 120
*** HOLE CARDS ***
Dealt to Hero [Kd 6s]
Dealt to 4685d1a2 
Dealt to f4826447 
Dealt to 3834ad1f 
Dealt to b17739e2 
Dealt to c6700974 
Dealt to 287e6858 
Dealt to 2f13ac41 
287e6858: folds
2f13ac41: folds
Hero: folds
4685d1a2: raises 180 to 300
f4826447: folds
3834ad1f: folds
b17739e2: folds
c6700974: calls 180
*** FLOP *** [5h Jh 3c]
c6700974: checks
4685d1a2: checks
*** TURN *** [5h Jh 3c] [6d]
c6700974: bets 402
4685d1a2: folds
Uncalled bet (402) returned to c6700974
*** SHOWDOWN ***
c6700974 collected 804 from pot
*** SUMMARY ***
Total pot 804 | Rake 0 | Jackpot 0 | Bingo 0 | Fortune 0 | Tax 0
Board [5h Jh 3c 6d]
Seat 1: Hero folded before Flop
Seat 2: 4685d1a2 folded on the Turn
Seat 3: f4826447 folded before Flop
Seat 4: 3834ad1f (button) folded before Flop
Seat 5: b17739e2 (small blind) folded before Flop
Seat 6: c6700974 (big blind) won (804)
Seat 7: 287e6858 folded before Flop
Seat 8: 2f13ac41 folded before Flop


Poker Hand #TM3577472871: Tournament #157957577, Bounty Hunters Big One $1.08 Hold'em No Limit - Level2(60/120) - 2024/08/13 17:42:59
Table '102' 8-max Seat #3 is the button
Seat 1: Hero (15,244 in chips)
Seat 2: 4685d1a2 (9,699 in chips)
Seat 3: f4826447 (9,816 in chips)
Seat 4: 3834ad1f (18,963 in chips)
Seat 5: b17739e2 (11,313 in chips)
Seat 6: c6700974 (10,149 in chips)
Seat 7: 287e6858 (8,902 in chips)
Seat 8: 2f13ac41 (5,914 in chips)
b17739e2: posts the ante 18
4685d1a2: posts the ante 18
c6700974: posts the ante 18
287e6858: posts the ante 18
2f13ac41: posts the ante 18
f4826447: posts the ante 18
Hero: posts the ante 18
3834ad1f: posts the ante 18
3834ad1f: posts small blind 60
b17739e2: posts big blind 120
*** HOLE CARDS ***
Dealt to Hero [Qc As]
Dealt to 4685d1a2 
Dealt to f4826447 
Dealt to 3834ad1f 
Dealt to b17739e2 
Dealt to c6700974 
Dealt to 287e6858 
Dealt to 2f13ac41 
c6700974: folds
287e6858: raises 120 to 240
2f13ac41: folds
Hero: calls 240
4685d1a2: folds
f4826447: folds
3834ad1f: folds
b17739e2: calls 120
*** FLOP *** [9s 2s 2c]
b17739e2: checks
287e6858: checks
Hero: checks
*** TURN *** [9s 2s 2c] [7h]
b17739e2: bets 610
287e6858: folds
Hero: folds
Uncalled bet (610) returned to b17739e2
*** SHOWDOWN ***
b17739e2 collected 924 from pot
*** SUMMARY ***
Total pot 924 | Rake 0 | Jackpot 0 | Bingo 0 | Fortune 0 | Tax 0
Board [9s 2s 2c 7h]
Seat 1: Hero folded on the Turn
Seat 2: 4685d1a2 folded before Flop
Seat 3: f4826447 (button) folded before Flop
Seat 4: 3834ad1f (small blind) folded before Flop
Seat 5: b17739e2 (big blind) won (924)
Seat 6: c6700974 folded before Flop
Seat 7: 287e6858 folded on the Turn
Seat 8: 2f13ac41 folded before Flop


Poker Hand #TM3577472852: Tournament #157957577, Bounty Hunters Big One $1.08 Hold'em No Limit - Level2(60/120) - 2024/08/13 17:42:05
Table '102' 8-max Seat #2 is the button
Seat 1: Hero (14,578 in chips)
Seat 2: 4685d1a2 (9,957 in chips)
Seat 3: f4826447 (9,894 in chips)
Seat 4: 3834ad1f (19,221 in chips)
Seat 5: b17739e2 (11,331 in chips)
Seat 6: c6700974 (10,167 in chips)
Seat 7: 287e6858 (8,920 in chips)
Seat 8: 2f13ac41 (5,932 in chips)
b17739e2: posts the ante 18
4685d1a2: posts the ante 18
c6700974: posts the ante 18
287e6858: posts the ante 18
2f13ac41: posts the ante 18
f4826447: posts the ante 18
Hero: posts the ante 18
3834ad1f: posts the ante 18
f4826447: posts small blind 60
3834ad1f: posts big blind 120
*** HOLE CARDS ***
Dealt to Hero [Tc Kc]
Dealt to 4685d1a2 
Dealt to f4826447 
Dealt to 3834ad1f 
Dealt to b17739e2 
Dealt to c6700974 
Dealt to 287e6858 
Dealt to 2f13ac41 
b17739e2: folds
c6700974: folds
287e6858: folds
2f13ac41: folds
Hero: raises 120 to 240
4685d1a2: calls 240
f4826447: folds
3834ad1f: calls 120
*** FLOP *** [Ah 3h Qh]
3834ad1f: checks
Hero: checks
4685d1a2: checks
*** TURN *** [Ah 3h Qh] [6d]
3834ad1f: checks
Hero: checks
4685d1a2: checks
*** RIVER *** [Ah 3h Qh 6d] [Jc]
3834ad1f: checks
Hero: bets 1,080
4685d1a2: folds
3834ad1f: folds
Uncalled bet (1,080) returned to Hero
*** SHOWDOWN ***
Hero collected 924 from pot
*** SUMMARY ***
Total pot 924 | Rake 0 | Jackpot 0 | Bingo 0 | Fortune 0 | Tax 0
Board [Ah 3h Qh 6d Jc]
Seat 1: Hero won (924)
Seat 2: 4685d1a2 (button) folded on the River
Seat 3: f4826447 (small blind) folded before Flop
Seat 4: 3834ad1f (big blind) folded on the River
Seat 5: b17739e2 folded before Flop
Seat 6: c6700974 folded before Flop
Seat 7: 287e6858 folded before Flop
Seat 8: 2f13ac41 folded before Flop


Poker Hand #TM3577472841: Tournament #157957577, Bounty Hunters Big One $1.08 Hold'em No Limit - Level2(60/120) - 2024/08/13 17:41:25
Table '102' 8-max Seat #1 is the button
Seat 1: Hero (14,896 in chips)
Seat 2: 4685d1a2 (10,035 in chips)
Seat 3: f4826447 (9,408 in chips)
Seat 4: 3834ad1f (19,239 in chips)
Seat 5: b17739e2 (11,349 in chips)
Seat 6: c6700974 (10,185 in chips)
Seat 7: 287e6858 (8,938 in chips)
Seat 8: 2f13ac41 (5,950 in chips)
b17739e2: posts the ante 18
4685d1a2: posts the ante 18
c6700974: posts the ante 18
287e6858: posts the ante 18
2f13ac41: posts the ante 18
f4826447: posts the ante 18
Hero: posts the ante 18
3834ad1f: posts the ante 18
4685d1a2: posts small blind 60
f4826447: posts big blind 120
*** HOLE CARDS ***
Dealt to Hero [Ah 4h]
Dealt to 4685d1a2 
Dealt to f4826447 
Dealt to 3834ad1f 
Dealt to b17739e2 
Dealt to c6700974 
Dealt to 287e6858 
Dealt to 2f13ac41 
3834ad1f: folds
b17739e2: folds
c6700974: folds
287e6858: folds
2f13ac41: folds
Hero: raises 180 to 300
4685d1a2: folds
f4826447: raises 780 to 1,080
Hero: folds
Uncalled bet (780) returned to f4826447
*** SHOWDOWN ***
f4826447 collected 804 from pot
*** SUMMARY ***
Total pot 804 | Rake 0 | Jackpot 0 | Bingo 0 | Fortune 0 | Tax 0
Seat 1: Hero (button) folded before Flop
Seat 2: 4685d1a2 (small blind) folded before Flop
Seat 3: f4826447 (big blind) collected (804)
Seat 4: 3834ad1f folded before Flop
Seat 5: b17739e2 folded before Flop
Seat 6: c6700974 folded before Flop
Seat 7: 287e6858 folded before Flop
Seat 8: 2f13ac41 folded before Flop


Poker Hand #TM3577472806: Tournament #157957577, Bounty Hunters Big One $1.08 Hold'em No Limit - Level1(50/100) - 2024/08/13 17:39:45
Table '102' 8-max Seat #8 is the button
Seat 1: Hero (14,961 in chips)
Seat 2: 4685d1a2 (10,150 in chips)
Seat 3: f4826447 (10,000 in chips)
Seat 4: 3834ad1f (19,254 in chips)
Seat 5: b17739e2 (9,730 in chips)
Seat 6: c6700974 (10,200 in chips)
Seat 7: 287e6858 (9,530 in chips)
Seat 8: 2f13ac41 (6,175 in chips)
b17739e2: posts the ante 15
4685d1a2: posts the ante 15
c6700974: posts the ante 15
287e6858: posts the ante 15
2f13ac41: posts the ante 15
f4826447: posts the ante 15
3834ad1f: posts the ante 15
Hero: posts the ante 15
Hero: posts small blind 50
4685d1a2: posts big blind 100
*** HOLE CARDS ***
Dealt to Hero [5d Tc]
Dealt to 4685d1a2 
Dealt to f4826447 
Dealt to 3834ad1f 
Dealt to b17739e2 
Dealt to c6700974 
Dealt to 287e6858 
Dealt to 2f13ac41 
f4826447: raises 110 to 210
3834ad1f: folds
b17739e2: calls 210
c6700974: folds
287e6858: calls 210
2f13ac41: calls 210
Hero: folds
4685d1a2: folds
*** FLOP *** [9c 5h 7d]
f4826447: checks
b17739e2: checks
287e6858: checks
2f13ac41: checks
*** TURN *** [9c 5h 7d] [2d]
f4826447: bets 367
b17739e2: calls 367
287e6858: calls 367
2f13ac41: folds
*** RIVER *** [9c 5h 7d 2d] [Ac]
f4826447: checks
b17739e2: checks
287e6858: checks
f4826447: shows [Kd Jc] (Ace-High)
b17739e2: shows [8h 9h] (Pair of Nines)
287e6858: shows [6h 9s] (Pair of Nines)
*** SHOWDOWN ***
b17739e2 collected 2,211 from pot
*** SUMMARY ***
Total pot 2,211 | Rake 0 | Jackpot 0 | Bingo 0 | Fortune 0 | Tax 0
Board [9c 5h 7d 2d Ac]
Seat 1: Hero (small blind) folded before Flop
Seat 2: 4685d1a2 (big blind) folded before Flop
Seat 3: f4826447 showed [Kd Jc] and lost with Ace-High
Seat 4: 3834ad1f folded before Flop
Seat 5: b17739e2 showed [8h 9h] and won (2,211) with Pair of Nines
Seat 6: c6700974 folded before Flop
Seat 7: 287e6858 showed [6h 9s] and lost with Pair of Nines
Seat 8: 2f13ac41 (button) folded on the Turn


Poker Hand #TM3577472783: Tournament #157957577, Bounty Hunters Big One $1.08 Hold'em No Limit - Level1(50/100) - 2024/08/13 17:38:40
Table '102' 8-max Seat #7 is the button
Seat 1: Hero (15,818 in chips)
Seat 2: 4685d1a2 (10,165 in chips)
Seat 3: a88bb08e (8,197 in chips)
Seat 4: 3834ad1f (9,875 in chips)
Seat 5: b17739e2 (9,745 in chips)
Seat 6: c6700974 (10,215 in chips)
Seat 7: 287e6858 (9,745 in chips)
Seat 8: 2f13ac41 (6,240 in chips)
b17739e2: posts the ante 15
4685d1a2: posts the ante 15
c6700974: posts the ante 15
287e6858: posts the ante 15
2f13ac41: posts the ante 15
3834ad1f: posts the ante 15
Hero: posts the ante 15
a88bb08e: posts the ante 15
2f13ac41: posts small blind 50
Hero: posts big blind 100
*** HOLE CARDS ***
Dealt to Hero [Jd 7s]
Dealt to 4685d1a2 
Dealt to a88bb08e 
Dealt to 3834ad1f 
Dealt to b17739e2 
Dealt to c6700974 
Dealt to 287e6858 
Dealt to 2f13ac41 
4685d1a2: folds
a88bb08e: raises 100 to 200
3834ad1f: calls 200
b17739e2: folds
c6700974: folds
287e6858: calls 200
2f13ac41: folds
Hero: calls 100
*** FLOP *** [2d 7d Qc]
Hero: bets 321
a88bb08e: raises 321 to 642
3834ad1f: calls 642
287e6858: folds
Hero: calls 321
*** TURN *** [2d 7d Qc] [Ts]
Hero: checks
a88bb08e: bets 1,448
3834ad1f: raises 7,570 to 9,018 and is all-in
Hero: folds
a88bb08e: calls 5,892 and is all-in
Uncalled bet (1,678) returned to 3834ad1f
3834ad1f: shows [7h Th] (Pair of Tens and Pair of Sevens)
a88bb08e: shows [Ks Qh] (Pair of Queens)
*** RIVER *** [2d 7d Qc Ts] [Td]
*** SHOWDOWN ***
3834ad1f collected 17,576 from pot
*** SUMMARY ***
Total pot 17,576 | Rake 0 | Jackpot 0 | Bingo 0 | Fortune 0 | Tax 0
Board [2d 7d Qc Ts Td]
Seat 1: Hero (big blind) folded on the Turn
Seat 2: 4685d1a2 folded before Flop
Seat 3: a88bb08e showed [Ks Qh] and lost with Pair of Queens and Pair of Tens
Seat 4: 3834ad1f showed [7h Th] and won (17,576) with Tens Full over Sevens
Seat 5: b17739e2 folded before Flop
Seat 6: c6700974 folded before Flop
Seat 7: 287e6858 (button) folded on the Flop
Seat 8: 2f13ac41 (small blind) folded before Flop


Poker Hand #TM3577472758: Tournament #157957577, Bounty Hunters Big One $1.08 Hold'em No Limit - Level1(50/100) - 2024/08/13 17:37:27
Table '102' 8-max Seat #6 is the button
Seat 1: Hero (12,678 in chips)
Seat 2: 4685d1a2 (10,180 in chips)
Seat 3: a88bb08e (8,212 in chips)
Seat 4: 3834ad1f (9,890 in chips)
Seat 5: b17739e2 (9,760 in chips)
Seat 6: c6700974 (10,230 in chips)
Seat 7: 287e6858 (9,810 in chips)
Seat 8: 2f13ac41 (9,240 in chips)
b17739e2: posts the ante 15
4685d1a2: posts the ante 15
c6700974: posts the ante 15
287e6858: posts the ante 15
2f13ac41: posts the ante 15
3834ad1f: posts the ante 15
Hero: posts the ante 15
a88bb08e: posts the ante 15
287e6858: posts small blind 50
2f13ac41: posts big blind 100
*** HOLE CARDS ***
Dealt to Hero [Kh Ac]
Dealt to 4685d1a2 
Dealt to a88bb08e 
Dealt to 3834ad1f 
Dealt to b17739e2 
Dealt to c6700974 
Dealt to 287e6858 
Dealt to 2f13ac41 
Hero: raises 120 to 220
4685d1a2: folds
a88bb08e: folds
3834ad1f: folds
b17739e2: folds
c6700974: folds
287e6858: folds
2f13ac41: raises 480 to 700
Hero: calls 480
*** FLOP *** [Kd Js 2h]
2f13ac41: bets 750
Hero: calls 750
*** TURN *** [Kd Js 2h] [Jc]
2f13ac41: checks
Hero: bets 1,535
2f13ac41: calls 1,535
*** RIVER *** [Kd Js 2h Jc] [3h]
2f13ac41: checks
Hero: checks
2f13ac41: shows [Ad Qs] (Pair of Jacks)
Hero: shows [Kh Ac] (Pair of Kings and Pair of Jacks)
*** SHOWDOWN ***
Hero collected 6,140 from pot
*** SUMMARY ***
Total pot 6,140 | Rake 0 | Jackpot 0 | Bingo 0 | Fortune 0 | Tax 0
Board [Kd Js 2h Jc 3h]
Seat 1: Hero showed [Kh Ac] and won (6,140) with Pair of Kings and Pair of Jacks
Seat 2: 4685d1a2 folded before Flop
Seat 3: a88bb08e folded before Flop
Seat 4: 3834ad1f folded before Flop
Seat 5: b17739e2 folded before Flop
Seat 6: c6700974 (button) folded before Flop
Seat 7: 287e6858 (small blind) folded before Flop
Seat 8: 2f13ac41 (big blind) showed [Ad Qs] and lost with Pair of Jacks


Poker Hand #TM3577472734: Tournament #157957577, Bounty Hunters Big One $1.08 Hold'em No Limit - Level1(50/100) - 2024/08/13 17:36:12
Table '102' 8-max Seat #5 is the button
Seat 1: Hero (9,575 in chips)
Seat 2: 4685d1a2 (10,195 in chips)
Seat 3: a88bb08e (10,235 in chips)
Seat 4: 3834ad1f (9,905 in chips)
Seat 5: b17739e2 (9,775 in chips)
Seat 6: c6700974 (10,295 in chips)
Seat 7: 287e6858 (10,295 in chips)
Seat 8: 2f13ac41 (9,725 in chips)
b17739e2: posts the ante 15
4685d1a2: posts the ante 15
c6700974: posts the ante 15
287e6858: posts the ante 15
2f13ac41: posts the ante 15
3834ad1f: posts the ante 15
Hero: posts the ante 15
a88bb08e: posts the ante 15
c6700974: posts small blind 50
287e6858: posts big blind 100
*** HOLE CARDS ***
Dealt to Hero [7h Qh]
Dealt to 4685d1a2 
Dealt to a88bb08e 
Dealt to 3834ad1f 
Dealt to b17739e2 
Dealt to c6700974 
Dealt to 287e6858 
Dealt to 2f13ac41 
2f13ac41: raises 110 to 210
Hero: calls 210
4685d1a2: folds
a88bb08e: raises 110 to 320
3834ad1f: folds
b17739e2: folds
c6700974: folds
287e6858: calls 220
2f13ac41: calls 110
Hero: calls 110
*** FLOP *** [5h 2h Ts]
287e6858: checks
2f13ac41: checks
Hero: checks
a88bb08e: checks
*** TURN *** [5h 2h Ts] [Jc]
287e6858: bets 150
2f13ac41: calls 150
Hero: calls 150
a88bb08e: calls 150
*** RIVER *** [5h 2h Ts Jc] [Kh]
287e6858: checks
2f13ac41: checks
Hero: bets 1,538
a88bb08e: calls 1,538
287e6858: folds
2f13ac41: folds
Hero: shows [7h Qh] (King High Flush)
a88bb08e: shows [Kd Qd] (Pair of Kings)
*** SHOWDOWN ***
Hero collected 5,126 from pot
*** SUMMARY ***
Total pot 5,126 | Rake 0 | Jackpot 0 | Bingo 0 | Fortune 0 | Tax 0
Board [5h 2h Ts Jc Kh]
Seat 1: Hero showed [7h Qh] and won (5,126) with King High Flush
Seat 2: 4685d1a2 folded before Flop
Seat 3: a88bb08e showed [Kd Qd] and lost with Pair of Kings
Seat 4: 3834ad1f folded before Flop
Seat 5: b17739e2 (button) folded before Flop
Seat 6: c6700974 (small blind) folded before Flop
Seat 7: 287e6858 (big blind) folded on the River
Seat 8: 2f13ac41 folded on the River


Poker Hand #TM3577472722: Tournament #157957577, Bounty Hunters Big One $1.08 Hold'em No Limit - Level1(50/100) - 2024/08/13 17:35:34
Table '102' 8-max Seat #4 is the button
Seat 1: Hero (9,590 in chips)
Seat 2: 4685d1a2 (10,210 in chips)
Seat 3: a88bb08e (10,250 in chips)
Seat 4: 3834ad1f (9,450 in chips)
Seat 5: b17739e2 (9,840 in chips)
Seat 6: c6700974 (10,410 in chips)
Seat 7: 287e6858 (10,510 in chips)
Seat 8: 2f13ac41 (9,740 in chips)
b17739e2: posts the ante 15
4685d1a2: posts the ante 15
c6700974: posts the ante 15
287e6858: posts the ante 15
2f13ac41: posts the ante 15
3834ad1f: posts the ante 15
Hero: posts the ante 15
a88bb08e: posts the ante 15
b17739e2: posts small blind 50
c6700974: posts big blind 100
*** HOLE CARDS ***
Dealt to Hero [Kh 8d]
Dealt to 4685d1a2 
Dealt to a88bb08e 
Dealt to 3834ad1f 
Dealt to b17739e2 
Dealt to c6700974 
Dealt to 287e6858 
Dealt to 2f13ac41 
287e6858: raises 100 to 200
2f13ac41: folds
Hero: folds
4685d1a2: folds
a88bb08e: folds
3834ad1f: raises 300 to 500
b17739e2: folds
c6700974: folds
287e6858: folds
Uncalled bet (300) returned to 3834ad1f
*** SHOWDOWN ***
3834ad1f collected 670 from pot
*** SUMMARY ***
Total pot 670 | Rake 0 | Jackpot 0 | Bingo 0 | Fortune 0 | Tax 0
Seat 1: Hero folded before Flop
Seat 2: 4685d1a2 folded before Flop
Seat 3: a88bb08e folded before Flop
Seat 4: 3834ad1f (button) collected (670)
Seat 5: b17739e2 (small blind) folded before Flop
Seat 6: c6700974 (big blind) folded before Flop
Seat 7: 287e6858 folded before Flop
Seat 8: 2f13ac41 folded before Flop


Poker Hand #TM3577472699: Tournament #157957577, Bounty Hunters Big One $1.08 Hold'em No Limit - Level1(50/100) - 2024/08/13 17:34:14
Table '102' 8-max Seat #3 is the button
Seat 1: Hero (9,605 in chips)
Seat 2: 4685d1a2 (10,625 in chips)
Seat 3: a88bb08e (10,265 in chips)
Seat 4: 3834ad1f (9,865 in chips)
Seat 5: b17739e2 (9,955 in chips)
Seat 6: c6700974 (10,425 in chips)
Seat 7: 287e6858 (9,305 in chips)
Seat 8: 2f13ac41 (9,955 in chips)
b17739e2: posts the ante 15
4685d1a2: posts the ante 15
c6700974: posts the ante 15
287e6858: posts the ante 15
2f13ac41: posts the ante 15
Hero: posts the ante 15
3834ad1f: posts the ante 15
a88bb08e: posts the ante 15
3834ad1f: posts small blind 50
b17739e2: posts big blind 100
*** HOLE CARDS ***
Dealt to Hero [2c 8h]
Dealt to 4685d1a2 
Dealt to a88bb08e 
Dealt to 3834ad1f 
Dealt to b17739e2 
Dealt to c6700974 
Dealt to 287e6858 
Dealt to 2f13ac41 
c6700974: folds
287e6858: raises 100 to 200
2f13ac41: calls 200
Hero: folds
4685d1a2: calls 200
a88bb08e: folds
3834ad1f: calls 150
b17739e2: folds
*** FLOP *** [4h Jd 8d]
3834ad1f: checks
287e6858: bets 200
2f13ac41: folds
4685d1a2: calls 200
3834ad1f: calls 200
*** TURN *** [4h Jd 8d] [2h]
3834ad1f: checks
287e6858: bets 8,890 and is all-in
4685d1a2: folds
3834ad1f: folds
Uncalled bet (8,890) returned to 287e6858
*** SHOWDOWN ***
287e6858 collected 1,620 from pot
*** SUMMARY ***
Total pot 1,620 | Rake 0 | Jackpot 0 | Bingo 0 | Fortune 0 | Tax 0
Board [4h Jd 8d 2h]
Seat 1: Hero folded before Flop
Seat 2: 4685d1a2 folded on the Turn
Seat 3: a88bb08e (button) folded before Flop
Seat 4: 3834ad1f (small blind) folded on the Turn
Seat 5: b17739e2 (big blind) folded before Flop
Seat 6: c6700974 folded before Flop
Seat 7: 287e6858 won (1,620)
Seat 8: 2f13ac41 folded on the Flop


Poker Hand #TM3577472675: Tournament #157957577, Bounty Hunters Big One $1.08 Hold'em No Limit - Level1(50/100) - 2024/08/13 17:32:32
Table '102' 8-max Seat #2 is the button
Seat 1: Hero (9,620 in chips)
Seat 2: 4685d1a2 (9,370 in chips)
Seat 3: a88bb08e (10,330 in chips)
Seat 4: 3834ad1f (10,330 in chips)
Seat 5: b17739e2 (9,970 in chips)
Seat 6: c6700974 (10,440 in chips)
Seat 7: 287e6858 (9,970 in chips)
Seat 8: 2f13ac41 (9,970 in chips)
b17739e2: posts the ante 15
4685d1a2: posts the ante 15
c6700974: posts the ante 15
287e6858: posts the ante 15
2f13ac41: posts the ante 15
Hero: posts the ante 15
3834ad1f: posts the ante 15
a88bb08e: posts the ante 15
a88bb08e: posts small blind 50
3834ad1f: posts big blind 100
*** HOLE CARDS ***
Dealt to Hero [Ah 2s]
Dealt to 4685d1a2 
Dealt to a88bb08e 
Dealt to 3834ad1f 
Dealt to b17739e2 
Dealt to c6700974 
Dealt to 287e6858 
Dealt to 2f13ac41 
b17739e2: folds
c6700974: folds
287e6858: raises 100 to 200
2f13ac41: folds
Hero: folds
4685d1a2: raises 100 to 300
a88bb08e: folds
3834ad1f: calls 200
287e6858: calls 100
*** FLOP *** [7d Qh 9c]
3834ad1f: checks
287e6858: bets 150
4685d1a2: calls 150
3834ad1f: calls 150
*** TURN *** [7d Qh 9c] [3c]
3834ad1f: checks
287e6858: checks
4685d1a2: checks
*** RIVER *** [7d Qh 9c 3c] [Th]
3834ad1f: checks
287e6858: bets 100
4685d1a2: raises 100 to 200
3834ad1f: folds
287e6858: calls 100
4685d1a2: shows [As Tc] (Pair of Tens)
287e6858: shows [Jc Ts] (Pair of Tens)
*** SHOWDOWN ***
4685d1a2 collected 1,920 from pot
*** SUMMARY ***
Total pot 1,920 | Rake 0 | Jackpot 0 | Bingo 0 | Fortune 0 | Tax 0
Board [7d Qh 9c 3c Th]
Seat 1: Hero folded before Flop
Seat 2: 4685d1a2 (button) showed [As Tc] and won (1,920) with Pair of Tens
Seat 3: a88bb08e (small blind) folded before Flop
Seat 4: 3834ad1f (big blind) folded on the River
Seat 5: b17739e2 folded before Flop
Seat 6: c6700974 folded before Flop
Seat 7: 287e6858 showed [Jc Ts] and lost with Pair of Tens
Seat 8: 2f13ac41 folded before Flop


Poker Hand #TM3577472645: Tournament #157957577, Bounty Hunters Big One $1.08 Hold'em No Limit - Level1(50/100) - 2024/08/13 17:30:53
Table '102' 8-max Seat #1 is the button
Seat 1: Hero (9,935 in chips)
Seat 2: 4685d1a2 (9,685 in chips)
Seat 3: a88bb08e (9,985 in chips)
Seat 4: 3834ad1f (9,985 in chips)
Seat 5: b17739e2 (9,985 in chips)
Seat 6: c6700974 (10,455 in chips)
Seat 7: 287e6858 (9,985 in chips)
Seat 8: 2f13ac41 (9,985 in chips)
b17739e2: posts the ante 15
4685d1a2: posts the ante 15
c6700974: posts the ante 15
287e6858: posts the ante 15
2f13ac41: posts the ante 15
Hero: posts the ante 15
3834ad1f: posts the ante 15
a88bb08e: posts the ante 15
4685d1a2: posts small blind 50
a88bb08e: posts big blind 100
*** HOLE CARDS ***
Dealt to Hero [Ah Jd]
Dealt to 4685d1a2 
Dealt to a88bb08e 
Dealt to 3834ad1f 
Dealt to b17739e2 
Dealt to c6700974 
Dealt to 287e6858 
Dealt to 2f13ac41 
3834ad1f: raises 200 to 300
b17739e2: folds
c6700974: folds
287e6858: folds
2f13ac41: folds
Hero: calls 300
4685d1a2: calls 250
a88bb08e: raises 200 to 500
3834ad1f: raises 1,500 to 2,000
Hero: folds
4685d1a2: folds
a88bb08e: raises 1,500 to 3,500
3834ad1f: calls 1,500
*** FLOP *** [4d 8c 3c]
a88bb08e: checks
3834ad1f: checks
*** TURN *** [4d 8c 3c] [Kc]
a88bb08e: bets 2,548
3834ad1f: raises 3,922 to 6,470 and is all-in
a88bb08e: calls 3,922 and is all-in
3834ad1f: shows [Kd Ad] (Pair of Kings)
a88bb08e: shows [Ks Ac] (Pair of Kings)
*** RIVER *** [4d 8c 3c Kc] [Qs]
Hero: shows [Ah Jd] (Ace-High)
*** SHOWDOWN ***
3834ad1f collected 10,330 from pot
a88bb08e collected 10,330 from pot
*** SUMMARY ***
Total pot 20,660 | Rake 0 | Jackpot 0 | Bingo 0 | Fortune 0 | Tax 0
Board [4d 8c 3c Kc Qs]
Seat 1: Hero (button) folded before Flop
Seat 2: 4685d1a2 (small blind) folded before Flop
Seat 3: a88bb08e (big blind) showed [Ks Ac] and won (10,330) with Pair of Kings
Seat 4: 3834ad1f showed [Kd Ad] and won (10,330) with Pair of Kings
Seat 5: b17739e2 folded before Flop
Seat 6: c6700974 folded before Flop
Seat 7: 287e6858 folded before Flop
Seat 8: 2f13ac41 folded before Flop


Poker Hand #TM3577472633: Tournament #157957577, Bounty Hunters Big One $1.08 Hold'em No Limit - Level1(50/100) - 2024/08/13 17:30:02
Table '102' 8-max Seat #8 is the button
Seat 1: Hero (10,000 in chips)
Seat 2: 4685d1a2 (10,000 in chips)
Seat 3: a88bb08e (10,000 in chips)
Seat 4: 3834ad1f (10,000 in chips)
Seat 5: b17739e2 (10,000 in chips)
Seat 6: c6700974 (10,000 in chips)
Seat 7: 287e6858 (10,000 in chips)
Seat 8: 2f13ac41 (10,000 in chips)
b17739e2: posts the ante 15
4685d1a2: posts the ante 15
c6700974: posts the ante 15
287e6858: posts the ante 15
2f13ac41: posts the ante 15
3834ad1f: posts the ante 15
Hero: posts the ante 15
a88bb08e: posts the ante 15
Hero: posts small blind 50
4685d1a2: posts big blind 100
*** HOLE CARDS ***
Dealt to Hero [8d 4s]
Dealt to 4685d1a2 
Dealt to a88bb08e 
Dealt to 3834ad1f 
Dealt to b17739e2 
Dealt to c6700974 
Dealt to 287e6858 
Dealt to 2f13ac41 
a88bb08e: folds
3834ad1f: folds
b17739e2: folds
c6700974: raises 100 to 200
287e6858: folds
2f13ac41: folds
Hero: folds
4685d1a2: raises 100 to 300
c6700974: calls 100
*** FLOP *** [8h 5d 9d]
4685d1a2: checks
c6700974: bets 255
4685d1a2: folds
Uncalled bet (255) returned to c6700974
*** SHOWDOWN ***
c6700974 collected 770 from pot
*** SUMMARY ***
Total pot 770 | Rake 0 | Jackpot 0 | Bingo 0 | Fortune 0 | Tax 0
Board [8h 5d 9d]
Seat 1: Hero (small blind) folded before Flop
Seat 2: 4685d1a2 (big blind) folded on the Flop
Seat 3: a88bb08e folded before Flop
Seat 4: 3834ad1f folded before Flop
Seat 5: b17739e2 folded before Flop
Seat 6: c6700974 won (770)
Seat 7: 287e6858 folded before Flop
Seat 8: 2f13ac41 (button) folded before Flop


