Poker Hand #TM3553139486: Tournament #156543396, Bounty Hunters Special $1.08 Hold'em No Limit - Level38(60,000/120,000) - 2024/08/05 16:17:31
Table '149' 9-max Seat #4 is the button
Seat 1: 4e9c4c34 (1,410,628 in chips)
Seat 3: fece3a3c (6,880,517 in chips)
Seat 4: c50c4803 (1,860,012 in chips)
Seat 5: Hero (1,123,367 in chips)
Seat 6: 45f2a4a4 (5,370,657 in chips)
Seat 8: 3d8f9953 (3,254,282 in chips)
Seat 9: 5f81cdd7 (2,350,537 in chips)
4e9c4c34: posts the ante 18,000
5f81cdd7: posts the ante 18,000
3d8f9953: posts the ante 18,000
fece3a3c: posts the ante 18,000
45f2a4a4: posts the ante 18,000
c50c4803: posts the ante 18,000
Hero: posts the ante 18,000
Hero: posts small blind 60,000
45f2a4a4: posts big blind 120,000
*** HOLE CARDS ***
Dealt to 4e9c4c34 
Dealt to fece3a3c 
Dealt to c50c4803 
Dealt to Hero [4c Ac]
Dealt to 45f2a4a4 
Dealt to 3d8f9953 
Dealt to 5f81cdd7 
3d8f9953: folds
5f81cdd7: folds
4e9c4c34: raises 120,000 to 240,000
fece3a3c: calls 240,000
c50c4803: folds
Hero: raises 865,367 to 1,105,367 and is all-in
45f2a4a4: folds
4e9c4c34: raises 287,261 to 1,392,628 and is all-in
fece3a3c: calls 1,152,628
4e9c4c34: shows [Ks Qs]
fece3a3c: shows [Qd Kh]
Hero: shows [4c Ac]
*** FLOP *** [3s 7s Td]
*** TURN *** [3s 7s Td] [Qc]
*** RIVER *** [3s 7s Td Qc] [8h]
*** SHOWDOWN ***
4e9c4c34 collected 1,781,051 from pot
fece3a3c collected 1,781,050 from pot
4e9c4c34 collected 287,261 from pot
fece3a3c collected 287,261 from pot
*** SUMMARY ***
Total pot 4,136,623 | Rake 0 | Jackpot 0 | Bingo 0 | Fortune 0 | Tax 0
Board [3s 7s Td Qc 8h]
Seat 1: 4e9c4c34 showed [Ks Qs] and won (2,068,312) with Pair of Queens
Seat 3: fece3a3c showed [Qd Kh] and won (2,068,311) with Pair of Queens
Seat 4: c50c4803 (button) folded before Flop
Seat 5: Hero (small blind) showed [4c Ac] and lost with Ace-High
Seat 6: 45f2a4a4 (big blind) folded before Flop
Seat 8: 3d8f9953 folded before Flop
Seat 9: 5f81cdd7 folded before Flop


Poker Hand #TM3553139466: Tournament #156543396, Bounty Hunters Special $1.08 Hold'em No Limit - Level38(60,000/120,000) - 2024/08/05 16:16:45
Table '149' 9-max Seat #3 is the button
Seat 1: 4e9c4c34 (1,428,628 in chips)
Seat 3: fece3a3c (6,898,517 in chips)
Seat 4: c50c4803 (885,006 in chips)
Seat 5: Hero (2,008,373 in chips)
Seat 6: 45f2a4a4 (5,388,657 in chips)
Seat 8: 3d8f9953 (3,272,282 in chips)
Seat 9: 5f81cdd7 (2,368,537 in chips)
4e9c4c34: posts the ante 18,000
5f81cdd7: posts the ante 18,000
3d8f9953: posts the ante 18,000
fece3a3c: posts the ante 18,000
45f2a4a4: posts the ante 18,000
c50c4803: posts the ante 18,000
Hero: posts the ante 18,000
c50c4803: posts small blind 60,000
Hero: posts big blind 120,000
*** HOLE CARDS ***
Dealt to 4e9c4c34 
Dealt to fece3a3c 
Dealt to c50c4803 
Dealt to Hero [Kh Jc]
Dealt to 45f2a4a4 
Dealt to 3d8f9953 
Dealt to 5f81cdd7 
45f2a4a4: folds
3d8f9953: folds
5f81cdd7: folds
4e9c4c34: folds
fece3a3c: folds
c50c4803: raises 747,006 to 867,006 and is all-in
Hero: calls 747,006
c50c4803: shows [Ks Td]
Hero: shows [Kh Jc]
*** FLOP *** [9h 7s 4c]
*** TURN *** [9h 7s 4c] [8h]
*** RIVER *** [9h 7s 4c 8h] [6h]
*** SHOWDOWN ***
c50c4803 collected 1,860,012 from pot
*** SUMMARY ***
Total pot 1,860,012 | Rake 0 | Jackpot 0 | Bingo 0 | Fortune 0 | Tax 0
Board [9h 7s 4c 8h 6h]
Seat 1: 4e9c4c34 folded before Flop
Seat 3: fece3a3c (button) folded before Flop
Seat 4: c50c4803 (small blind) showed [Ks Td] and won (1,860,012) with Tens-High Straight
Seat 5: Hero (big blind) showed [Kh Jc] and lost with King-High
Seat 6: 45f2a4a4 folded before Flop
Seat 8: 3d8f9953 folded before Flop
Seat 9: 5f81cdd7 folded before Flop


Poker Hand #TM3553139450: Tournament #156543396, Bounty Hunters Special $1.08 Hold'em No Limit - Level38(60,000/120,000) - 2024/08/05 16:15:58
Table '149' 9-max Seat #1 is the button
Seat 1: 4e9c4c34 (1,446,628 in chips)
Seat 3: fece3a3c (6,976,517 in chips)
Seat 4: c50c4803 (1,023,006 in chips)
Seat 5: Hero (2,266,373 in chips)
Seat 6: 45f2a4a4 (5,406,657 in chips)
Seat 8: 3d8f9953 (3,290,282 in chips)
Seat 9: 5f81cdd7 (1,840,537 in chips)
4e9c4c34: posts the ante 18,000
5f81cdd7: posts the ante 18,000
3d8f9953: posts the ante 18,000
45f2a4a4: posts the ante 18,000
fece3a3c: posts the ante 18,000
c50c4803: posts the ante 18,000
Hero: posts the ante 18,000
fece3a3c: posts small blind 60,000
c50c4803: posts big blind 120,000
*** HOLE CARDS ***
Dealt to 4e9c4c34 
Dealt to fece3a3c 
Dealt to c50c4803 
Dealt to Hero [Jd Kc]
Dealt to 45f2a4a4 
Dealt to 3d8f9953 
Dealt to 5f81cdd7 
Hero: raises 120,000 to 240,000
45f2a4a4: folds
3d8f9953: folds
5f81cdd7: raises 480,000 to 720,000
4e9c4c34: folds
fece3a3c: folds
c50c4803: folds
Hero: folds
Uncalled bet (480,000) returned to 5f81cdd7
*** SHOWDOWN ***
5f81cdd7 collected 786,000 from pot
*** SUMMARY ***
Total pot 786,000 | Rake 0 | Jackpot 0 | Bingo 0 | Fortune 0 | Tax 0
Seat 1: 4e9c4c34 (button) folded before Flop
Seat 3: fece3a3c (small blind) folded before Flop
Seat 4: c50c4803 (big blind) folded before Flop
Seat 5: Hero folded before Flop
Seat 6: 45f2a4a4 folded before Flop
Seat 8: 3d8f9953 folded before Flop
Seat 9: 5f81cdd7 collected (786,000)


Poker Hand #TM3553139437: Tournament #156543396, Bounty Hunters Special $1.08 Hold'em No Limit - Level37(50,000/100,000) - 2024/08/05 16:15:27
Table '149' 9-max Seat #9 is the button
Seat 1: 4e9c4c34 (1,511,628 in chips)
Seat 3: fece3a3c (7,091,517 in chips)
Seat 4: c50c4803 (783,006 in chips)
Seat 5: Hero (2,281,373 in chips)
Seat 6: 45f2a4a4 (5,421,657 in chips)
Seat 8: 3d8f9953 (3,305,282 in chips)
Seat 9: 5f81cdd7 (1,855,537 in chips)
4e9c4c34: posts the ante 15,000
5f81cdd7: posts the ante 15,000
3d8f9953: posts the ante 15,000
45f2a4a4: posts the ante 15,000
fece3a3c: posts the ante 15,000
c50c4803: posts the ante 15,000
Hero: posts the ante 15,000
4e9c4c34: posts small blind 50,000
fece3a3c: posts big blind 100,000
*** HOLE CARDS ***
Dealt to 4e9c4c34 
Dealt to fece3a3c 
Dealt to c50c4803 
Dealt to Hero [5s 8s]
Dealt to 45f2a4a4 
Dealt to 3d8f9953 
Dealt to 5f81cdd7 
c50c4803: raises 668,006 to 768,006 and is all-in
Hero: folds
45f2a4a4: folds
3d8f9953: folds
5f81cdd7: folds
4e9c4c34: folds
fece3a3c: folds
Uncalled bet (668,006) returned to c50c4803
*** SHOWDOWN ***
c50c4803 collected 355,000 from pot
*** SUMMARY ***
Total pot 355,000 | Rake 0 | Jackpot 0 | Bingo 0 | Fortune 0 | Tax 0
Seat 1: 4e9c4c34 (small blind) folded before Flop
Seat 3: fece3a3c (big blind) folded before Flop
Seat 4: c50c4803 collected (355,000)
Seat 5: Hero folded before Flop
Seat 6: 45f2a4a4 folded before Flop
Seat 8: 3d8f9953 folded before Flop
Seat 9: 5f81cdd7 (button) folded before Flop


Poker Hand #TM3553139423: Tournament #156543396, Bounty Hunters Special $1.08 Hold'em No Limit - Level37(50,000/100,000) - 2024/08/05 16:14:40
Table '149' 9-max Seat #8 is the button
Seat 1: 4e9c4c34 (1,626,628 in chips)
Seat 3: fece3a3c (6,186,367 in chips)
Seat 4: c50c4803 (798,006 in chips)
Seat 5: Hero (2,296,373 in chips)
Seat 6: 45f2a4a4 (6,101,807 in chips)
Seat 8: 3d8f9953 (3,320,282 in chips)
Seat 9: 5f81cdd7 (1,920,537 in chips)
4e9c4c34: posts the ante 15,000
3d8f9953: posts the ante 15,000
5f81cdd7: posts the ante 15,000
45f2a4a4: posts the ante 15,000
fece3a3c: posts the ante 15,000
c50c4803: posts the ante 15,000
Hero: posts the ante 15,000
5f81cdd7: posts small blind 50,000
4e9c4c34: posts big blind 100,000
*** HOLE CARDS ***
Dealt to 4e9c4c34 
Dealt to fece3a3c 
Dealt to c50c4803 
Dealt to Hero [Jh 5s]
Dealt to 45f2a4a4 
Dealt to 3d8f9953 
Dealt to 5f81cdd7 
fece3a3c: calls 100,000
c50c4803: folds
Hero: folds
45f2a4a4: raises 250,000 to 350,000
3d8f9953: folds
5f81cdd7: folds
4e9c4c34: folds
fece3a3c: calls 250,000
*** FLOP *** [2d Ts 7s]
fece3a3c: checks
45f2a4a4: bets 315,150
fece3a3c: calls 315,150
*** TURN *** [2d Ts 7s] [8d]
fece3a3c: checks
45f2a4a4: checks
*** RIVER *** [2d Ts 7s 8d] [3h]
fece3a3c: checks
45f2a4a4: checks
fece3a3c: shows [6s 6c] (Pair of Sixes)
45f2a4a4: shows [As Jd] (Ace-High)
*** SHOWDOWN ***
fece3a3c collected 1,585,300 from pot
*** SUMMARY ***
Total pot 1,585,300 | Rake 0 | Jackpot 0 | Bingo 0 | Fortune 0 | Tax 0
Board [2d Ts 7s 8d 3h]
Seat 1: 4e9c4c34 (big blind) folded before Flop
Seat 3: fece3a3c showed [6s 6c] and won (1,585,300) with Pair of Sixes
Seat 4: c50c4803 folded before Flop
Seat 5: Hero folded before Flop
Seat 6: 45f2a4a4 showed [As Jd] and lost with Ace-High
Seat 8: 3d8f9953 (button) folded before Flop
Seat 9: 5f81cdd7 (small blind) folded before Flop


Poker Hand #TM3553139408: Tournament #156543396, Bounty Hunters Special $1.08 Hold'em No Limit - Level37(50,000/100,000) - 2024/08/05 16:14:03
Table '149' 9-max Seat #6 is the button
Seat 1: 4e9c4c34 (1,641,628 in chips)
Seat 3: fece3a3c (6,301,367 in chips)
Seat 4: c50c4803 (813,006 in chips)
Seat 5: Hero (2,411,373 in chips)
Seat 6: 45f2a4a4 (6,116,807 in chips)
Seat 8: 3d8f9953 (3,435,282 in chips)
Seat 9: 5f81cdd7 (1,530,537 in chips)
4e9c4c34: posts the ante 15,000
5f81cdd7: posts the ante 15,000
3d8f9953: posts the ante 15,000
45f2a4a4: posts the ante 15,000
fece3a3c: posts the ante 15,000
c50c4803: posts the ante 15,000
Hero: posts the ante 15,000
3d8f9953: posts small blind 50,000
5f81cdd7: posts big blind 100,000
*** HOLE CARDS ***
Dealt to 4e9c4c34 
Dealt to fece3a3c 
Dealt to c50c4803 
Dealt to Hero [Qd Tc]
Dealt to 45f2a4a4 
Dealt to 3d8f9953 
Dealt to 5f81cdd7 
4e9c4c34: folds
fece3a3c: calls 100,000
c50c4803: folds
Hero: calls 100,000
45f2a4a4: folds
3d8f9953: calls 50,000
5f81cdd7: raises 1,415,537 to 1,515,537 and is all-in
fece3a3c: folds
Hero: folds
3d8f9953: folds
Uncalled bet (1,415,537) returned to 5f81cdd7
*** SHOWDOWN ***
5f81cdd7 collected 505,000 from pot
*** SUMMARY ***
Total pot 505,000 | Rake 0 | Jackpot 0 | Bingo 0 | Fortune 0 | Tax 0
Seat 1: 4e9c4c34 folded before Flop
Seat 3: fece3a3c folded before Flop
Seat 4: c50c4803 folded before Flop
Seat 5: Hero folded before Flop
Seat 6: 45f2a4a4 (button) folded before Flop
Seat 8: 3d8f9953 (small blind) folded before Flop
Seat 9: 5f81cdd7 (big blind) collected (505,000)


Poker Hand #TM3553139399: Tournament #156543396, Bounty Hunters Special $1.08 Hold'em No Limit - Level37(50,000/100,000) - 2024/08/05 16:13:34
Table '149' 9-max Seat #5 is the button
Seat 1: 4e9c4c34 (1,656,628 in chips)
Seat 3: fece3a3c (6,316,367 in chips)
Seat 4: c50c4803 (828,006 in chips)
Seat 5: Hero (2,426,373 in chips)
Seat 6: 45f2a4a4 (5,926,807 in chips)
Seat 8: 3d8f9953 (3,550,282 in chips)
Seat 9: 5f81cdd7 (1,545,537 in chips)
4e9c4c34: posts the ante 15,000
5f81cdd7: posts the ante 15,000
3d8f9953: posts the ante 15,000
fece3a3c: posts the ante 15,000
45f2a4a4: posts the ante 15,000
c50c4803: posts the ante 15,000
Hero: posts the ante 15,000
45f2a4a4: posts small blind 50,000
3d8f9953: posts big blind 100,000
*** HOLE CARDS ***
Dealt to 4e9c4c34 
Dealt to fece3a3c 
Dealt to c50c4803 
Dealt to Hero [5h 4c]
Dealt to 45f2a4a4 
Dealt to 3d8f9953 
Dealt to 5f81cdd7 
5f81cdd7: folds
4e9c4c34: folds
fece3a3c: folds
c50c4803: folds
Hero: folds
45f2a4a4: raises 200,000 to 300,000
3d8f9953: folds
Uncalled bet (200,000) returned to 45f2a4a4
*** SHOWDOWN ***
45f2a4a4 collected 305,000 from pot
*** SUMMARY ***
Total pot 305,000 | Rake 0 | Jackpot 0 | Bingo 0 | Fortune 0 | Tax 0
Seat 1: 4e9c4c34 folded before Flop
Seat 3: fece3a3c folded before Flop
Seat 4: c50c4803 folded before Flop
Seat 5: Hero (button) folded before Flop
Seat 6: 45f2a4a4 (small blind) collected (305,000)
Seat 8: 3d8f9953 (big blind) folded before Flop
Seat 9: 5f81cdd7 folded before Flop


Poker Hand #TM3553139362: Tournament #156543396, Bounty Hunters Special $1.08 Hold'em No Limit - Level37(50,000/100,000) - 2024/08/05 16:11:59
Table '149' 9-max Seat #4 is the button
Seat 1: 4e9c4c34 (1,671,628 in chips)
Seat 3: fece3a3c (7,328,017 in chips)
Seat 4: c50c4803 (843,006 in chips)
Seat 5: Hero (2,641,373 in chips)
Seat 6: 45f2a4a4 (6,141,807 in chips)
Seat 8: 3d8f9953 (2,063,632 in chips)
Seat 9: 5f81cdd7 (1,560,537 in chips)
4e9c4c34: posts the ante 15,000
5f81cdd7: posts the ante 15,000
3d8f9953: posts the ante 15,000
fece3a3c: posts the ante 15,000
45f2a4a4: posts the ante 15,000
c50c4803: posts the ante 15,000
Hero: posts the ante 15,000
Hero: posts small blind 50,000
45f2a4a4: posts big blind 100,000
*** HOLE CARDS ***
Dealt to 4e9c4c34 
Dealt to fece3a3c 
Dealt to c50c4803 
Dealt to Hero [Th Qd]
Dealt to 45f2a4a4 
Dealt to 3d8f9953 
Dealt to 5f81cdd7 
3d8f9953: raises 100,000 to 200,000
5f81cdd7: folds
4e9c4c34: folds
fece3a3c: calls 200,000
c50c4803: folds
Hero: calls 150,000
45f2a4a4: calls 100,000
*** FLOP *** [Ac 7d 3d]
Hero: checks
45f2a4a4: checks
3d8f9953: bets 300,000
fece3a3c: calls 300,000
Hero: folds
45f2a4a4: folds
*** TURN *** [Ac 7d 3d] [2s]
3d8f9953: checks
fece3a3c: bets 496,650
3d8f9953: calls 496,650
*** RIVER *** [Ac 7d 3d 2s] [2c]
3d8f9953: checks
fece3a3c: checks
3d8f9953: shows [Ad Tc] (Pair of Aces and Pair of Twos)
fece3a3c: shows [8h Ah] (Pair of Aces and Pair of Twos)
*** SHOWDOWN ***
3d8f9953 collected 2,498,300 from pot
*** SUMMARY ***
Total pot 2,498,300 | Rake 0 | Jackpot 0 | Bingo 0 | Fortune 0 | Tax 0
Board [Ac 7d 3d 2s 2c]
Seat 1: 4e9c4c34 folded before Flop
Seat 3: fece3a3c showed [8h Ah] and lost with Pair of Aces and Pair of Twos
Seat 4: c50c4803 (button) folded before Flop
Seat 5: Hero (small blind) folded on the Flop
Seat 6: 45f2a4a4 (big blind) folded on the Flop
Seat 8: 3d8f9953 showed [Ad Tc] and won (2,498,300) with Pair of Aces and Pair of Twos
Seat 9: 5f81cdd7 folded before Flop


Poker Hand #TM3553139356: Tournament #156543396, Bounty Hunters Special $1.08 Hold'em No Limit - Level37(50,000/100,000) - 2024/08/05 16:11:43
Table '149' 9-max Seat #3 is the button
Seat 1: 4e9c4c34 (1,686,628 in chips)
Seat 3: fece3a3c (7,343,017 in chips)
Seat 4: c50c4803 (908,006 in chips)
Seat 5: Hero (2,756,373 in chips)
Seat 6: 45f2a4a4 (6,156,807 in chips)
Seat 8: 3d8f9953 (1,823,632 in chips)
Seat 9: 5f81cdd7 (1,575,537 in chips)
4e9c4c34: posts the ante 15,000
5f81cdd7: posts the ante 15,000
3d8f9953: posts the ante 15,000
fece3a3c: posts the ante 15,000
45f2a4a4: posts the ante 15,000
c50c4803: posts the ante 15,000
Hero: posts the ante 15,000
c50c4803: posts small blind 50,000
Hero: posts big blind 100,000
*** HOLE CARDS ***
Dealt to 4e9c4c34 
Dealt to fece3a3c 
Dealt to c50c4803 
Dealt to Hero [2c 7c]
Dealt to 45f2a4a4 
Dealt to 3d8f9953 
Dealt to 5f81cdd7 
45f2a4a4: folds
3d8f9953: raises 100,000 to 200,000
5f81cdd7: folds
4e9c4c34: folds
fece3a3c: folds
c50c4803: folds
Hero: folds
Uncalled bet (100,000) returned to 3d8f9953
*** SHOWDOWN ***
3d8f9953 collected 355,000 from pot
*** SUMMARY ***
Total pot 355,000 | Rake 0 | Jackpot 0 | Bingo 0 | Fortune 0 | Tax 0
Seat 1: 4e9c4c34 folded before Flop
Seat 3: fece3a3c (button) folded before Flop
Seat 4: c50c4803 (small blind) folded before Flop
Seat 5: Hero (big blind) folded before Flop
Seat 6: 45f2a4a4 folded before Flop
Seat 8: 3d8f9953 collected (355,000)
Seat 9: 5f81cdd7 folded before Flop


Poker Hand #TM3553139335: Tournament #156543396, Bounty Hunters Special $1.08 Hold'em No Limit - Level37(50,000/100,000) - 2024/08/05 16:10:40
Table '149' 9-max Seat #1 is the button
Seat 1: 4e9c4c34 (1,701,628 in chips)
Seat 3: fece3a3c (7,659,520 in chips)
Seat 4: c50c4803 (316,503 in chips)
Seat 5: Hero (2,771,373 in chips)
Seat 6: 45f2a4a4 (6,371,807 in chips)
Seat 8: 3d8f9953 (1,838,632 in chips)
Seat 9: 5f81cdd7 (1,590,537 in chips)
4e9c4c34: posts the ante 15,000
5f81cdd7: posts the ante 15,000
3d8f9953: posts the ante 15,000
45f2a4a4: posts the ante 15,000
fece3a3c: posts the ante 15,000
c50c4803: posts the ante 15,000
Hero: posts the ante 15,000
fece3a3c: posts small blind 50,000
c50c4803: posts big blind 100,000
*** HOLE CARDS ***
Dealt to 4e9c4c34 
Dealt to fece3a3c 
Dealt to c50c4803 
Dealt to Hero [9h Ac]
Dealt to 45f2a4a4 
Dealt to 3d8f9953 
Dealt to 5f81cdd7 
Hero: folds
45f2a4a4: raises 100,000 to 200,000
3d8f9953: folds
5f81cdd7: folds
4e9c4c34: folds
fece3a3c: raises 7,444,520 to 7,644,520 and is all-in
c50c4803: calls 201,503 and is all-in
45f2a4a4: folds
Uncalled bet (7,343,017) returned to fece3a3c
fece3a3c: shows [As Kd]
c50c4803: shows [Qh Qc]
*** FLOP *** [8s Jh 3s]
*** TURN *** [8s Jh 3s] [Jd]
*** RIVER *** [8s Jh 3s Jd] [5h]
Hero: shows [9h Ac] (Pair of Jacks)
*** SHOWDOWN ***
c50c4803 collected 908,006 from pot
*** SUMMARY ***
Total pot 908,006 | Rake 0 | Jackpot 0 | Bingo 0 | Fortune 0 | Tax 0
Board [8s Jh 3s Jd 5h]
Seat 1: 4e9c4c34 (button) folded before Flop
Seat 3: fece3a3c (small blind) showed [As Kd] and lost with Pair of Jacks
Seat 4: c50c4803 (big blind) showed [Qh Qc] and won (908,006) with Pair of Queens and Pair of Jacks
Seat 5: Hero folded before Flop
Seat 6: 45f2a4a4 folded before Flop
Seat 8: 3d8f9953 folded before Flop
Seat 9: 5f81cdd7 folded before Flop


Poker Hand #TM3553139314: Tournament #156543396, Bounty Hunters Special $1.08 Hold'em No Limit - Level37(50,000/100,000) - 2024/08/05 16:09:46
Table '149' 9-max Seat #9 is the button
Seat 1: 4e9c4c34 (1,766,628 in chips)
Seat 3: fece3a3c (7,774,520 in chips)
Seat 4: c50c4803 (331,503 in chips)
Seat 5: Hero (2,786,373 in chips)
Seat 6: 45f2a4a4 (5,931,807 in chips)
Seat 8: 3d8f9953 (2,053,632 in chips)
Seat 9: 5f81cdd7 (1,605,537 in chips)
4e9c4c34: posts the ante 15,000
5f81cdd7: posts the ante 15,000
3d8f9953: posts the ante 15,000
45f2a4a4: posts the ante 15,000
fece3a3c: posts the ante 15,000
c50c4803: posts the ante 15,000
Hero: posts the ante 15,000
4e9c4c34: posts small blind 50,000
fece3a3c: posts big blind 100,000
*** HOLE CARDS ***
Dealt to 4e9c4c34 
Dealt to fece3a3c 
Dealt to c50c4803 
Dealt to Hero [Qh 6c]
Dealt to 45f2a4a4 
Dealt to 3d8f9953 
Dealt to 5f81cdd7 
c50c4803: folds
Hero: folds
45f2a4a4: raises 100,000 to 200,000
3d8f9953: calls 200,000
5f81cdd7: folds
4e9c4c34: folds
fece3a3c: folds
*** FLOP *** [6h As 8s]
45f2a4a4: bets 216,150
3d8f9953: folds
Uncalled bet (216,150) returned to 45f2a4a4
*** SHOWDOWN ***
45f2a4a4 collected 655,000 from pot
*** SUMMARY ***
Total pot 655,000 | Rake 0 | Jackpot 0 | Bingo 0 | Fortune 0 | Tax 0
Board [6h As 8s]
Seat 1: 4e9c4c34 (small blind) folded before Flop
Seat 3: fece3a3c (big blind) folded before Flop
Seat 4: c50c4803 folded before Flop
Seat 5: Hero folded before Flop
Seat 6: 45f2a4a4 won (655,000)
Seat 8: 3d8f9953 folded on the Flop
Seat 9: 5f81cdd7 (button) folded before Flop


Poker Hand #TM3553139300: Tournament #156543396, Bounty Hunters Special $1.08 Hold'em No Limit - Level37(50,000/100,000) - 2024/08/05 16:08:58
Table '149' 9-max Seat #8 is the button
Seat 1: 4e9c4c34 (1,881,628 in chips)
Seat 3: fece3a3c (7,889,520 in chips)
Seat 4: c50c4803 (346,503 in chips)
Seat 5: Hero (2,801,373 in chips)
Seat 6: 45f2a4a4 (5,591,807 in chips)
Seat 8: 3d8f9953 (2,068,632 in chips)
Seat 9: 5f81cdd7 (1,670,537 in chips)
4e9c4c34: posts the ante 15,000
3d8f9953: posts the ante 15,000
5f81cdd7: posts the ante 15,000
45f2a4a4: posts the ante 15,000
fece3a3c: posts the ante 15,000
c50c4803: posts the ante 15,000
Hero: posts the ante 15,000
5f81cdd7: posts small blind 50,000
4e9c4c34: posts big blind 100,000
*** HOLE CARDS ***
Dealt to 4e9c4c34 
Dealt to fece3a3c 
Dealt to c50c4803 
Dealt to Hero [2c 7s]
Dealt to 45f2a4a4 
Dealt to 3d8f9953 
Dealt to 5f81cdd7 
fece3a3c: calls 100,000
c50c4803: folds
Hero: folds
45f2a4a4: raises 250,000 to 350,000
3d8f9953: folds
5f81cdd7: folds
4e9c4c34: folds
fece3a3c: folds
Uncalled bet (250,000) returned to 45f2a4a4
*** SHOWDOWN ***
45f2a4a4 collected 455,000 from pot
*** SUMMARY ***
Total pot 455,000 | Rake 0 | Jackpot 0 | Bingo 0 | Fortune 0 | Tax 0
Seat 1: 4e9c4c34 (big blind) folded before Flop
Seat 3: fece3a3c folded before Flop
Seat 4: c50c4803 folded before Flop
Seat 5: Hero folded before Flop
Seat 6: 45f2a4a4 collected (455,000)
Seat 8: 3d8f9953 (button) folded before Flop
Seat 9: 5f81cdd7 (small blind) folded before Flop


Poker Hand #TM3553139269: Tournament #156543396, Bounty Hunters Special $1.08 Hold'em No Limit - Level37(50,000/100,000) - 2024/08/05 16:07:42
Table '149' 9-max Seat #6 is the button
Seat 1: 4e9c4c34 (1,719,128 in chips)
Seat 3: fece3a3c (7,727,020 in chips)
Seat 4: c50c4803 (361,503 in chips)
Seat 5: Hero (2,816,373 in chips)
Seat 6: 45f2a4a4 (5,606,807 in chips)
Seat 8: 3d8f9953 (2,133,632 in chips)
Seat 9: 5f81cdd7 (1,885,537 in chips)
4e9c4c34: posts the ante 15,000
5f81cdd7: posts the ante 15,000
3d8f9953: posts the ante 15,000
45f2a4a4: posts the ante 15,000
fece3a3c: posts the ante 15,000
c50c4803: posts the ante 15,000
Hero: posts the ante 15,000
3d8f9953: posts small blind 50,000
5f81cdd7: posts big blind 100,000
*** HOLE CARDS ***
Dealt to 4e9c4c34 
Dealt to fece3a3c 
Dealt to c50c4803 
Dealt to Hero [Js 2s]
Dealt to 45f2a4a4 
Dealt to 3d8f9953 
Dealt to 5f81cdd7 
4e9c4c34: raises 100,000 to 200,000
fece3a3c: calls 200,000
c50c4803: folds
Hero: folds
45f2a4a4: folds
3d8f9953: folds
5f81cdd7: calls 100,000
*** FLOP *** [Qd 9d Th]
5f81cdd7: checks
4e9c4c34: checks
fece3a3c: checks
*** TURN *** [Qd 9d Th] [8c]
5f81cdd7: checks
4e9c4c34: checks
fece3a3c: checks
*** RIVER *** [Qd 9d Th 8c] [Ac]
5f81cdd7: checks
4e9c4c34: checks
fece3a3c: checks
5f81cdd7: shows [6c Tc] (Pair of Tens)
4e9c4c34: shows [Kh As] (Pair of Aces)
fece3a3c: shows [Ah Kc] (Pair of Aces)
*** SHOWDOWN ***
fece3a3c collected 377,500 from pot
4e9c4c34 collected 377,500 from pot
*** SUMMARY ***
Total pot 755,000 | Rake 0 | Jackpot 0 | Bingo 0 | Fortune 0 | Tax 0
Board [Qd 9d Th 8c Ac]
Seat 1: 4e9c4c34 showed [Kh As] and won (377,500) with Pair of Aces
Seat 3: fece3a3c showed [Ah Kc] and won (377,500) with Pair of Aces
Seat 4: c50c4803 folded before Flop
Seat 5: Hero folded before Flop
Seat 6: 45f2a4a4 (button) folded before Flop
Seat 8: 3d8f9953 (small blind) folded before Flop
Seat 9: 5f81cdd7 (big blind) showed [6c Tc] and lost with Pair of Tens


Poker Hand #TM3553139248: Tournament #156543396, Bounty Hunters Special $1.08 Hold'em No Limit - Level37(50,000/100,000) - 2024/08/05 16:06:48
Table '149' 9-max Seat #5 is the button
Seat 1: 4e9c4c34 (1,734,128 in chips)
Seat 3: fece3a3c (7,742,020 in chips)
Seat 4: c50c4803 (376,503 in chips)
Seat 5: Hero (2,831,373 in chips)
Seat 6: 45f2a4a4 (5,416,807 in chips)
Seat 8: 3d8f9953 (2,248,632 in chips)
Seat 9: 5f81cdd7 (1,900,537 in chips)
4e9c4c34: posts the ante 15,000
5f81cdd7: posts the ante 15,000
3d8f9953: posts the ante 15,000
fece3a3c: posts the ante 15,000
45f2a4a4: posts the ante 15,000
c50c4803: posts the ante 15,000
Hero: posts the ante 15,000
45f2a4a4: posts small blind 50,000
3d8f9953: posts big blind 100,000
*** HOLE CARDS ***
Dealt to 4e9c4c34 
Dealt to fece3a3c 
Dealt to c50c4803 
Dealt to Hero [2d 6d]
Dealt to 45f2a4a4 
Dealt to 3d8f9953 
Dealt to 5f81cdd7 
5f81cdd7: folds
4e9c4c34: folds
fece3a3c: folds
c50c4803: folds
Hero: folds
45f2a4a4: raises 200,000 to 300,000
3d8f9953: folds
Uncalled bet (200,000) returned to 45f2a4a4
*** SHOWDOWN ***
45f2a4a4 collected 305,000 from pot
*** SUMMARY ***
Total pot 305,000 | Rake 0 | Jackpot 0 | Bingo 0 | Fortune 0 | Tax 0
Seat 1: 4e9c4c34 folded before Flop
Seat 3: fece3a3c folded before Flop
Seat 4: c50c4803 folded before Flop
Seat 5: Hero (button) folded before Flop
Seat 6: 45f2a4a4 (small blind) collected (305,000)
Seat 8: 3d8f9953 (big blind) folded before Flop
Seat 9: 5f81cdd7 folded before Flop


Poker Hand #TM3553139220: Tournament #156543396, Bounty Hunters Special $1.08 Hold'em No Limit - Level37(50,000/100,000) - 2024/08/05 16:05:31
Table '149' 9-max Seat #4 is the button
Seat 1: 4e9c4c34 (1,749,128 in chips)
Seat 3: fece3a3c (7,654,520 in chips)
Seat 4: c50c4803 (391,503 in chips)
Seat 5: Hero (2,743,873 in chips)
Seat 6: 45f2a4a4 (5,531,807 in chips)
Seat 8: 3d8f9953 (2,263,632 in chips)
Seat 9: 5f81cdd7 (1,915,537 in chips)
4e9c4c34: posts the ante 15,000
5f81cdd7: posts the ante 15,000
3d8f9953: posts the ante 15,000
fece3a3c: posts the ante 15,000
45f2a4a4: posts the ante 15,000
c50c4803: posts the ante 15,000
Hero: posts the ante 15,000
Hero: posts small blind 50,000
45f2a4a4: posts big blind 100,000
*** HOLE CARDS ***
Dealt to 4e9c4c34 
Dealt to fece3a3c 
Dealt to c50c4803 
Dealt to Hero [Ad 3s]
Dealt to 45f2a4a4 
Dealt to 3d8f9953 
Dealt to 5f81cdd7 
3d8f9953: folds
5f81cdd7: folds
4e9c4c34: folds
fece3a3c: calls 100,000
c50c4803: folds
Hero: calls 50,000
45f2a4a4: checks
*** FLOP *** [Td 9s Ks]
Hero: checks
45f2a4a4: checks
fece3a3c: checks
*** TURN *** [Td 9s Ks] [6c]
Hero: checks
45f2a4a4: checks
fece3a3c: checks
*** RIVER *** [Td 9s Ks 6c] [2c]
Hero: checks
45f2a4a4: checks
fece3a3c: checks
Hero: shows [Ad 3s] (Ace-High)
45f2a4a4: shows [7c Jh] (King-High)
fece3a3c: shows [Ah 5d] (Ace-High)
*** SHOWDOWN ***
fece3a3c collected 202,500 from pot
Hero collected 202,500 from pot
*** SUMMARY ***
Total pot 405,000 | Rake 0 | Jackpot 0 | Bingo 0 | Fortune 0 | Tax 0
Board [Td 9s Ks 6c 2c]
Seat 1: 4e9c4c34 folded before Flop
Seat 3: fece3a3c showed [Ah 5d] and won (202,500) with Ace-High
Seat 4: c50c4803 (button) folded before Flop
Seat 5: Hero (small blind) showed [Ad 3s] and won (202,500) with Ace-High
Seat 6: 45f2a4a4 (big blind) showed [7c Jh] and lost with King-High
Seat 8: 3d8f9953 folded before Flop
Seat 9: 5f81cdd7 folded before Flop


Poker Hand #TM3553139202: Tournament #156543396, Bounty Hunters Special $1.08 Hold'em No Limit - Level36(40,000/80,000) - 2024/08/05 16:04:59
Table '149' 9-max Seat #3 is the button
Seat 1: 4e9c4c34 (1,761,128 in chips)
Seat 3: fece3a3c (7,462,520 in chips)
Seat 4: c50c4803 (443,503 in chips)
Seat 5: Hero (2,835,873 in chips)
Seat 6: 45f2a4a4 (5,543,807 in chips)
Seat 8: 3d8f9953 (2,275,632 in chips)
Seat 9: 5f81cdd7 (1,927,537 in chips)
4e9c4c34: posts the ante 12,000
5f81cdd7: posts the ante 12,000
3d8f9953: posts the ante 12,000
fece3a3c: posts the ante 12,000
45f2a4a4: posts the ante 12,000
c50c4803: posts the ante 12,000
Hero: posts the ante 12,000
c50c4803: posts small blind 40,000
Hero: posts big blind 80,000
*** HOLE CARDS ***
Dealt to 4e9c4c34 
Dealt to fece3a3c 
Dealt to c50c4803 
Dealt to Hero [4s Qc]
Dealt to 45f2a4a4 
Dealt to 3d8f9953 
Dealt to 5f81cdd7 
45f2a4a4: folds
3d8f9953: folds
5f81cdd7: folds
4e9c4c34: folds
fece3a3c: raises 80,000 to 160,000
c50c4803: folds
Hero: folds
Uncalled bet (80,000) returned to fece3a3c
*** SHOWDOWN ***
fece3a3c collected 284,000 from pot
*** SUMMARY ***
Total pot 284,000 | Rake 0 | Jackpot 0 | Bingo 0 | Fortune 0 | Tax 0
Seat 1: 4e9c4c34 folded before Flop
Seat 3: fece3a3c (button) collected (284,000)
Seat 4: c50c4803 (small blind) folded before Flop
Seat 5: Hero (big blind) folded before Flop
Seat 6: 45f2a4a4 folded before Flop
Seat 8: 3d8f9953 folded before Flop
Seat 9: 5f81cdd7 folded before Flop


Poker Hand #TM3553139186: Tournament #156543396, Bounty Hunters Special $1.08 Hold'em No Limit - Level36(40,000/80,000) - 2024/08/05 16:04:20
Table '149' 9-max Seat #1 is the button
Seat 1: 4e9c4c34 (1,773,128 in chips)
Seat 3: fece3a3c (7,514,520 in chips)
Seat 4: c50c4803 (615,503 in chips)
Seat 5: Hero (2,847,873 in chips)
Seat 6: 45f2a4a4 (5,555,807 in chips)
Seat 8: 3d8f9953 (2,287,632 in chips)
Seat 9: 5f81cdd7 (1,655,537 in chips)
4e9c4c34: posts the ante 12,000
5f81cdd7: posts the ante 12,000
3d8f9953: posts the ante 12,000
45f2a4a4: posts the ante 12,000
fece3a3c: posts the ante 12,000
c50c4803: posts the ante 12,000
Hero: posts the ante 12,000
fece3a3c: posts small blind 40,000
c50c4803: posts big blind 80,000
*** HOLE CARDS ***
Dealt to 4e9c4c34 
Dealt to fece3a3c 
Dealt to c50c4803 
Dealt to Hero [2c 7c]
Dealt to 45f2a4a4 
Dealt to 3d8f9953 
Dealt to 5f81cdd7 
Hero: folds
45f2a4a4: folds
3d8f9953: folds
5f81cdd7: calls 80,000
4e9c4c34: folds
fece3a3c: folds
c50c4803: checks
*** FLOP *** [6h 7h 8d]
c50c4803: checks
5f81cdd7: bets 80,000
c50c4803: calls 80,000
*** TURN *** [6h 7h 8d] [6d]
c50c4803: checks
5f81cdd7: bets 80,000
c50c4803: folds
Uncalled bet (80,000) returned to 5f81cdd7
*** SHOWDOWN ***
5f81cdd7 collected 444,000 from pot
*** SUMMARY ***
Total pot 444,000 | Rake 0 | Jackpot 0 | Bingo 0 | Fortune 0 | Tax 0
Board [6h 7h 8d 6d]
Seat 1: 4e9c4c34 (button) folded before Flop
Seat 3: fece3a3c (small blind) folded before Flop
Seat 4: c50c4803 (big blind) folded on the Turn
Seat 5: Hero folded before Flop
Seat 6: 45f2a4a4 folded before Flop
Seat 8: 3d8f9953 folded before Flop
Seat 9: 5f81cdd7 won (444,000)


Poker Hand #TM3553139173: Tournament #156543396, Bounty Hunters Special $1.08 Hold'em No Limit - Level36(40,000/80,000) - 2024/08/05 16:03:52
Table '149' 9-max Seat #9 is the button
Seat 1: 4e9c4c34 (1,825,128 in chips)
Seat 3: fece3a3c (7,606,520 in chips)
Seat 4: c50c4803 (627,503 in chips)
Seat 5: Hero (2,859,873 in chips)
Seat 6: 45f2a4a4 (5,567,807 in chips)
Seat 8: 3d8f9953 (2,095,632 in chips)
Seat 9: 5f81cdd7 (1,667,537 in chips)
4e9c4c34: posts the ante 12,000
5f81cdd7: posts the ante 12,000
3d8f9953: posts the ante 12,000
45f2a4a4: posts the ante 12,000
fece3a3c: posts the ante 12,000
c50c4803: posts the ante 12,000
Hero: posts the ante 12,000
4e9c4c34: posts small blind 40,000
fece3a3c: posts big blind 80,000
*** HOLE CARDS ***
Dealt to 4e9c4c34 
Dealt to fece3a3c 
Dealt to c50c4803 
Dealt to Hero [5h Ts]
Dealt to 45f2a4a4 
Dealt to 3d8f9953 
Dealt to 5f81cdd7 
c50c4803: folds
Hero: folds
45f2a4a4: folds
3d8f9953: raises 80,000 to 160,000
5f81cdd7: folds
4e9c4c34: folds
fece3a3c: folds
Uncalled bet (80,000) returned to 3d8f9953
*** SHOWDOWN ***
3d8f9953 collected 284,000 from pot
*** SUMMARY ***
Total pot 284,000 | Rake 0 | Jackpot 0 | Bingo 0 | Fortune 0 | Tax 0
Seat 1: 4e9c4c34 (small blind) folded before Flop
Seat 3: fece3a3c (big blind) folded before Flop
Seat 4: c50c4803 folded before Flop
Seat 5: Hero folded before Flop
Seat 6: 45f2a4a4 folded before Flop
Seat 8: 3d8f9953 collected (284,000)
Seat 9: 5f81cdd7 (button) folded before Flop


Poker Hand #TM3553139160: Tournament #156543396, Bounty Hunters Special $1.08 Hold'em No Limit - Level36(40,000/80,000) - 2024/08/05 16:03:17
Table '149' 9-max Seat #8 is the button
Seat 1: 4e9c4c34 (1,673,128 in chips)
Seat 3: fece3a3c (7,618,520 in chips)
Seat 4: c50c4803 (639,503 in chips)
Seat 5: Hero (2,871,873 in chips)
Seat 6: 45f2a4a4 (5,579,807 in chips)
Seat 8: 3d8f9953 (2,107,632 in chips)
Seat 9: 5f81cdd7 (1,759,537 in chips)
4e9c4c34: posts the ante 12,000
3d8f9953: posts the ante 12,000
5f81cdd7: posts the ante 12,000
45f2a4a4: posts the ante 12,000
fece3a3c: posts the ante 12,000
c50c4803: posts the ante 12,000
Hero: posts the ante 12,000
5f81cdd7: posts small blind 40,000
4e9c4c34: posts big blind 80,000
*** HOLE CARDS ***
Dealt to 4e9c4c34 
Dealt to fece3a3c 
Dealt to c50c4803 
Dealt to Hero [As 8c]
Dealt to 45f2a4a4 
Dealt to 3d8f9953 
Dealt to 5f81cdd7 
fece3a3c: folds
c50c4803: folds
Hero: folds
45f2a4a4: folds
3d8f9953: folds
5f81cdd7: calls 40,000
4e9c4c34: checks
*** FLOP *** [4h Ts 3h]
5f81cdd7: checks
4e9c4c34: bets 80,000
5f81cdd7: folds
Uncalled bet (80,000) returned to 4e9c4c34
*** SHOWDOWN ***
4e9c4c34 collected 244,000 from pot
*** SUMMARY ***
Total pot 244,000 | Rake 0 | Jackpot 0 | Bingo 0 | Fortune 0 | Tax 0
Board [4h Ts 3h]
Seat 1: 4e9c4c34 (big blind) won (244,000)
Seat 3: fece3a3c folded before Flop
Seat 4: c50c4803 folded before Flop
Seat 5: Hero folded before Flop
Seat 6: 45f2a4a4 folded before Flop
Seat 8: 3d8f9953 (button) folded before Flop
Seat 9: 5f81cdd7 (small blind) folded on the Flop


Poker Hand #TM3553139139: Tournament #156543396, Bounty Hunters Special $1.08 Hold'em No Limit - Level36(40,000/80,000) - 2024/08/05 16:02:38
Table '149' 9-max Seat #6 is the button
Seat 1: 4e9c4c34 (1,685,128 in chips)
Seat 3: fece3a3c (7,630,520 in chips)
Seat 4: c50c4803 (891,503 in chips)
Seat 5: Hero (2,883,873 in chips)
Seat 6: 45f2a4a4 (5,147,807 in chips)
Seat 8: 3d8f9953 (2,159,632 in chips)
Seat 9: 5f81cdd7 (1,851,537 in chips)
4e9c4c34: posts the ante 12,000
5f81cdd7: posts the ante 12,000
3d8f9953: posts the ante 12,000
45f2a4a4: posts the ante 12,000
fece3a3c: posts the ante 12,000
c50c4803: posts the ante 12,000
Hero: posts the ante 12,000
3d8f9953: posts small blind 40,000
5f81cdd7: posts big blind 80,000
*** HOLE CARDS ***
Dealt to 4e9c4c34 
Dealt to fece3a3c 
Dealt to c50c4803 
Dealt to Hero [9h 2c]
Dealt to 45f2a4a4 
Dealt to 3d8f9953 
Dealt to 5f81cdd7 
4e9c4c34: folds
fece3a3c: folds
c50c4803: calls 80,000
Hero: folds
45f2a4a4: raises 160,000 to 240,000
3d8f9953: folds
5f81cdd7: folds
c50c4803: calls 160,000
*** FLOP *** [Jh 8c 8d]
c50c4803: checks
45f2a4a4: bets 171,000
c50c4803: folds
Uncalled bet (171,000) returned to 45f2a4a4
*** SHOWDOWN ***
45f2a4a4 collected 684,000 from pot
*** SUMMARY ***
Total pot 684,000 | Rake 0 | Jackpot 0 | Bingo 0 | Fortune 0 | Tax 0
Board [Jh 8c 8d]
Seat 1: 4e9c4c34 folded before Flop
Seat 3: fece3a3c folded before Flop
Seat 4: c50c4803 folded on the Flop
Seat 5: Hero folded before Flop
Seat 6: 45f2a4a4 (button) won (684,000)
Seat 8: 3d8f9953 (small blind) folded before Flop
Seat 9: 5f81cdd7 (big blind) folded before Flop


Poker Hand #TM3553139126: Tournament #156543396, Bounty Hunters Special $1.08 Hold'em No Limit - Level36(40,000/80,000) - 2024/08/05 16:01:44
Table '149' 9-max Seat #5 is the button
Seat 1: 4e9c4c34 (1,697,128 in chips)
Seat 3: fece3a3c (7,722,520 in chips)
Seat 4: c50c4803 (903,503 in chips)
Seat 5: Hero (2,895,873 in chips)
Seat 6: 45f2a4a4 (5,199,807 in chips)
Seat 8: 3d8f9953 (1,967,632 in chips)
Seat 9: 5f81cdd7 (1,863,537 in chips)
4e9c4c34: posts the ante 12,000
5f81cdd7: posts the ante 12,000
3d8f9953: posts the ante 12,000
fece3a3c: posts the ante 12,000
45f2a4a4: posts the ante 12,000
c50c4803: posts the ante 12,000
Hero: posts the ante 12,000
45f2a4a4: posts small blind 40,000
3d8f9953: posts big blind 80,000
*** HOLE CARDS ***
Dealt to 4e9c4c34 
Dealt to fece3a3c 
Dealt to c50c4803 
Dealt to Hero [2c 9c]
Dealt to 45f2a4a4 
Dealt to 3d8f9953 
Dealt to 5f81cdd7 
5f81cdd7: folds
4e9c4c34: folds
fece3a3c: calls 80,000
c50c4803: folds
Hero: folds
45f2a4a4: folds
3d8f9953: checks
*** FLOP *** [Tc 2d 4c]
3d8f9953: checks
fece3a3c: checks
*** TURN *** [Tc 2d 4c] [8h]
3d8f9953: checks
fece3a3c: checks
*** RIVER *** [Tc 2d 4c 8h] [9h]
3d8f9953: checks
fece3a3c: checks
3d8f9953: shows [4s 6d] (Pair of Fours)
fece3a3c: shows [7h Kh] (King-High)
*** SHOWDOWN ***
3d8f9953 collected 284,000 from pot
*** SUMMARY ***
Total pot 284,000 | Rake 0 | Jackpot 0 | Bingo 0 | Fortune 0 | Tax 0
Board [Tc 2d 4c 8h 9h]
Seat 1: 4e9c4c34 folded before Flop
Seat 3: fece3a3c showed [7h Kh] and lost with King-High
Seat 4: c50c4803 folded before Flop
Seat 5: Hero (button) folded before Flop
Seat 6: 45f2a4a4 (small blind) folded before Flop
Seat 8: 3d8f9953 (big blind) showed [4s 6d] and won (284,000) with Pair of Fours
Seat 9: 5f81cdd7 folded before Flop


Poker Hand #TM3553139118: Tournament #156543396, Bounty Hunters Special $1.08 Hold'em No Limit - Level36(40,000/80,000) - 2024/08/05 16:00:41
Table '149' 9-max Seat #4 is the button
Seat 1: 4e9c4c34 (1,709,128 in chips)
Seat 3: fece3a3c (7,734,520 in chips)
Seat 4: c50c4803 (915,503 in chips)
Seat 5: Hero (2,947,873 in chips)
Seat 6: 45f2a4a4 (6,133,623 in chips)
Seat 8: 3d8f9953 (933,816 in chips)
Seat 9: 5f81cdd7 (1,875,537 in chips)
4e9c4c34: posts the ante 12,000
5f81cdd7: posts the ante 12,000
3d8f9953: posts the ante 12,000
fece3a3c: posts the ante 12,000
45f2a4a4: posts the ante 12,000
c50c4803: posts the ante 12,000
Hero: posts the ante 12,000
Hero: posts small blind 40,000
45f2a4a4: posts big blind 80,000
*** HOLE CARDS ***
Dealt to 4e9c4c34 
Dealt to fece3a3c 
Dealt to c50c4803 
Dealt to Hero [6c 2c]
Dealt to 45f2a4a4 
Dealt to 3d8f9953 
Dealt to 5f81cdd7 
3d8f9953: raises 80,000 to 160,000
5f81cdd7: folds
4e9c4c34: folds
fece3a3c: folds
c50c4803: folds
Hero: folds
45f2a4a4: calls 80,000
*** FLOP *** [4h 5h Tc]
45f2a4a4: checks
3d8f9953: bets 761,816 and is all-in
45f2a4a4: calls 761,816
3d8f9953: shows [Js Jd] (Pair of Jacks)
45f2a4a4: shows [Th 9d] (Pair of Tens)
*** TURN *** [4h 5h Tc] [7s]
*** RIVER *** [4h 5h Tc 7s] [8h]
Hero: shows [6c 2c] (Eights-High Straight)
*** SHOWDOWN ***
3d8f9953 collected 1,967,632 from pot
*** SUMMARY ***
Total pot 1,967,632 | Rake 0 | Jackpot 0 | Bingo 0 | Fortune 0 | Tax 0
Board [4h 5h Tc 7s 8h]
Seat 1: 4e9c4c34 folded before Flop
Seat 3: fece3a3c folded before Flop
Seat 4: c50c4803 (button) folded before Flop
Seat 5: Hero (small blind) folded before Flop
Seat 6: 45f2a4a4 (big blind) showed [Th 9d] and lost with Pair of Tens
Seat 8: 3d8f9953 showed [Js Jd] and won (1,967,632) with Pair of Jacks
Seat 9: 5f81cdd7 folded before Flop


Poker Hand #TM3553139103: Tournament #156543396, Bounty Hunters Special $1.08 Hold'em No Limit - Level36(40,000/80,000) - 2024/08/05 15:54:26
Table '149' 9-max Seat #3 is the button
Seat 1: 4e9c4c34 (1,277,128 in chips)
Seat 3: fece3a3c (7,906,520 in chips)
Seat 4: c50c4803 (967,503 in chips)
Seat 5: Hero (3,119,873 in chips)
Seat 6: 45f2a4a4 (6,145,623 in chips)
Seat 8: 3d8f9953 (945,816 in chips)
Seat 9: 5f81cdd7 (1,887,537 in chips)
4e9c4c34: posts the ante 12,000
5f81cdd7: posts the ante 12,000
3d8f9953: posts the ante 12,000
fece3a3c: posts the ante 12,000
45f2a4a4: posts the ante 12,000
c50c4803: posts the ante 12,000
Hero: posts the ante 12,000
c50c4803: posts small blind 40,000
Hero: posts big blind 80,000
*** HOLE CARDS ***
Dealt to 4e9c4c34 
Dealt to fece3a3c 
Dealt to c50c4803 
Dealt to Hero [Qc 9c]
Dealt to 45f2a4a4 
Dealt to 3d8f9953 
Dealt to 5f81cdd7 
45f2a4a4: folds
3d8f9953: folds
5f81cdd7: folds
4e9c4c34: raises 80,000 to 160,000
fece3a3c: calls 160,000
c50c4803: folds
Hero: calls 80,000
*** FLOP *** [8h Jd 8d]
Hero: checks
4e9c4c34: checks
fece3a3c: checks
*** TURN *** [8h Jd 8d] [Js]
Hero: checks
4e9c4c34: checks
fece3a3c: checks
*** RIVER *** [8h Jd 8d Js] [2d]
Hero: checks
4e9c4c34: checks
fece3a3c: checks
Hero: shows [Qc 9c] (Pair of Jacks and Pair of Eights)
4e9c4c34: shows [Ac 4c] (Pair of Jacks and Pair of Eights)
fece3a3c: shows [7s Ts] (Pair of Jacks and Pair of Eights)
*** SHOWDOWN ***
4e9c4c34 collected 604,000 from pot
*** SUMMARY ***
Total pot 604,000 | Rake 0 | Jackpot 0 | Bingo 0 | Fortune 0 | Tax 0
Board [8h Jd 8d Js 2d]
Seat 1: 4e9c4c34 showed [Ac 4c] and won (604,000) with Pair of Jacks and Pair of Eights
Seat 3: fece3a3c (button) showed [7s Ts] and lost with Pair of Jacks and Pair of Eights
Seat 4: c50c4803 (small blind) folded before Flop
Seat 5: Hero (big blind) showed [Qc 9c] and lost with Pair of Jacks and Pair of Eights
Seat 6: 45f2a4a4 folded before Flop
Seat 8: 3d8f9953 folded before Flop
Seat 9: 5f81cdd7 folded before Flop


Poker Hand #TM3553139083: Tournament #156543396, Bounty Hunters Special $1.08 Hold'em No Limit - Level36(40,000/80,000) - 2024/08/05 15:53:45
Table '149' 9-max Seat #2 is the button
Seat 1: 4e9c4c34 (1,289,128 in chips)
Seat 2: 793d53d4 (1,560,068 in chips)
Seat 3: fece3a3c (6,194,452 in chips)
Seat 4: c50c4803 (1,059,503 in chips)
Seat 5: Hero (3,131,873 in chips)
Seat 6: 45f2a4a4 (6,157,623 in chips)
Seat 8: 3d8f9953 (957,816 in chips)
Seat 9: 5f81cdd7 (1,899,537 in chips)
4e9c4c34: posts the ante 12,000
5f81cdd7: posts the ante 12,000
3d8f9953: posts the ante 12,000
45f2a4a4: posts the ante 12,000
fece3a3c: posts the ante 12,000
c50c4803: posts the ante 12,000
793d53d4: posts the ante 12,000
Hero: posts the ante 12,000
fece3a3c: posts small blind 40,000
c50c4803: posts big blind 80,000
*** HOLE CARDS ***
Dealt to 4e9c4c34 
Dealt to 793d53d4 
Dealt to fece3a3c 
Dealt to c50c4803 
Dealt to Hero [7d Jh]
Dealt to 45f2a4a4 
Dealt to 3d8f9953 
Dealt to 5f81cdd7 
Hero: folds
45f2a4a4: folds
3d8f9953: folds
5f81cdd7: folds
4e9c4c34: folds
793d53d4: raises 1,468,068 to 1,548,068 and is all-in
fece3a3c: calls 1,508,068
c50c4803: folds
793d53d4: shows [9h Ah]
fece3a3c: shows [Ts Td]
*** FLOP *** [3d 2d Qd]
*** TURN *** [3d 2d Qd] [Ks]
*** RIVER *** [3d 2d Qd Ks] [Kd]
*** SHOWDOWN ***
fece3a3c collected 3,272,136 from pot
*** SUMMARY ***
Total pot 3,272,136 | Rake 0 | Jackpot 0 | Bingo 0 | Fortune 0 | Tax 0
Board [3d 2d Qd Ks Kd]
Seat 1: 4e9c4c34 folded before Flop
Seat 2: 793d53d4 (button) showed [9h Ah] and lost with Pair of Kings
Seat 3: fece3a3c (small blind) showed [Ts Td] and won (3,272,136) with King High Flush
Seat 4: c50c4803 (big blind) folded before Flop
Seat 5: Hero folded before Flop
Seat 6: 45f2a4a4 folded before Flop
Seat 8: 3d8f9953 folded before Flop
Seat 9: 5f81cdd7 folded before Flop


Poker Hand #TM3552299069: Tournament #156543396, Bounty Hunters Special $1.08 Hold'em No Limit - Level36(40,000/80,000) - 2024/08/05 15:53:07
Table '149' 9-max Seat #1 is the button
Seat 1: 4e9c4c34 (1,301,128 in chips)
Seat 2: 793d53d4 (1,612,068 in chips)
Seat 3: fece3a3c (6,366,452 in chips)
Seat 4: c50c4803 (1,071,503 in chips)
Seat 5: Hero (3,143,873 in chips)
Seat 6: 45f2a4a4 (5,873,623 in chips)
Seat 8: 3d8f9953 (969,816 in chips)
Seat 9: 5f81cdd7 (1,911,537 in chips)
4e9c4c34: posts the ante 12,000
5f81cdd7: posts the ante 12,000
3d8f9953: posts the ante 12,000
45f2a4a4: posts the ante 12,000
fece3a3c: posts the ante 12,000
c50c4803: posts the ante 12,000
793d53d4: posts the ante 12,000
Hero: posts the ante 12,000
793d53d4: posts small blind 40,000
fece3a3c: posts big blind 80,000
*** HOLE CARDS ***
Dealt to 4e9c4c34 
Dealt to 793d53d4 
Dealt to fece3a3c 
Dealt to c50c4803 
Dealt to Hero [Td 8h]
Dealt to 45f2a4a4 
Dealt to 3d8f9953 
Dealt to 5f81cdd7 
c50c4803: folds
Hero: folds
45f2a4a4: raises 80,000 to 160,000
3d8f9953: folds
5f81cdd7: folds
4e9c4c34: folds
793d53d4: folds
fece3a3c: calls 80,000
*** FLOP *** [3s 8c 6s]
fece3a3c: checks
45f2a4a4: bets 300,960
fece3a3c: folds
Uncalled bet (300,960) returned to 45f2a4a4
*** SHOWDOWN ***
45f2a4a4 collected 456,000 from pot
*** SUMMARY ***
Total pot 456,000 | Rake 0 | Jackpot 0 | Bingo 0 | Fortune 0 | Tax 0
Board [3s 8c 6s]
Seat 1: 4e9c4c34 (button) folded before Flop
Seat 2: 793d53d4 (small blind) folded before Flop
Seat 3: fece3a3c (big blind) folded on the Flop
Seat 4: c50c4803 folded before Flop
Seat 5: Hero folded before Flop
Seat 6: 45f2a4a4 won (456,000)
Seat 8: 3d8f9953 folded before Flop
Seat 9: 5f81cdd7 folded before Flop


Poker Hand #TM3552299055: Tournament #156543396, Bounty Hunters Special $1.08 Hold'em No Limit - Level36(40,000/80,000) - 2024/08/05 15:52:30
Table '149' 9-max Seat #9 is the button
Seat 1: 4e9c4c34 (1,353,128 in chips)
Seat 2: 793d53d4 (1,784,068 in chips)
Seat 3: fece3a3c (5,922,452 in chips)
Seat 4: c50c4803 (1,083,503 in chips)
Seat 5: Hero (3,315,873 in chips)
Seat 6: 45f2a4a4 (5,885,623 in chips)
Seat 8: 3d8f9953 (981,816 in chips)
Seat 9: 5f81cdd7 (1,923,537 in chips)
4e9c4c34: posts the ante 12,000
5f81cdd7: posts the ante 12,000
3d8f9953: posts the ante 12,000
45f2a4a4: posts the ante 12,000
fece3a3c: posts the ante 12,000
c50c4803: posts the ante 12,000
793d53d4: posts the ante 12,000
Hero: posts the ante 12,000
4e9c4c34: posts small blind 40,000
793d53d4: posts big blind 80,000
*** HOLE CARDS ***
Dealt to 4e9c4c34 
Dealt to 793d53d4 
Dealt to fece3a3c 
Dealt to c50c4803 
Dealt to Hero [Ah Qh]
Dealt to 45f2a4a4 
Dealt to 3d8f9953 
Dealt to 5f81cdd7 
fece3a3c: raises 80,000 to 160,000
c50c4803: folds
Hero: calls 160,000
45f2a4a4: folds
3d8f9953: folds
5f81cdd7: folds
4e9c4c34: folds
793d53d4: calls 80,000
*** FLOP *** [7s 4c Js]
793d53d4: checks
fece3a3c: checks
Hero: checks
*** TURN *** [7s 4c Js] [9d]
793d53d4: checks
fece3a3c: bets 308,000
Hero: folds
793d53d4: folds
Uncalled bet (308,000) returned to fece3a3c
*** SHOWDOWN ***
fece3a3c collected 616,000 from pot
*** SUMMARY ***
Total pot 616,000 | Rake 0 | Jackpot 0 | Bingo 0 | Fortune 0 | Tax 0
Board [7s 4c Js 9d]
Seat 1: 4e9c4c34 (small blind) folded before Flop
Seat 2: 793d53d4 (big blind) folded on the Turn
Seat 3: fece3a3c won (616,000)
Seat 4: c50c4803 folded before Flop
Seat 5: Hero folded on the Turn
Seat 6: 45f2a4a4 folded before Flop
Seat 8: 3d8f9953 folded before Flop
Seat 9: 5f81cdd7 (button) folded before Flop


Poker Hand #TM3552299032: Tournament #156543396, Bounty Hunters Special $1.08 Hold'em No Limit - Level36(40,000/80,000) - 2024/08/05 15:51:42
Table '149' 9-max Seat #8 is the button
Seat 1: 4e9c4c34 (1,445,128 in chips)
Seat 2: 793d53d4 (1,396,068 in chips)
Seat 3: fece3a3c (5,934,452 in chips)
Seat 4: c50c4803 (1,095,503 in chips)
Seat 5: Hero (3,327,873 in chips)
Seat 6: 45f2a4a4 (6,081,623 in chips)
Seat 8: 3d8f9953 (993,816 in chips)
Seat 9: 5f81cdd7 (1,975,537 in chips)
4e9c4c34: posts the ante 12,000
3d8f9953: posts the ante 12,000
5f81cdd7: posts the ante 12,000
45f2a4a4: posts the ante 12,000
fece3a3c: posts the ante 12,000
c50c4803: posts the ante 12,000
793d53d4: posts the ante 12,000
Hero: posts the ante 12,000
5f81cdd7: posts small blind 40,000
4e9c4c34: posts big blind 80,000
*** HOLE CARDS ***
Dealt to 4e9c4c34 
Dealt to 793d53d4 
Dealt to fece3a3c 
Dealt to c50c4803 
Dealt to Hero [Kd 9h]
Dealt to 45f2a4a4 
Dealt to 3d8f9953 
Dealt to 5f81cdd7 
793d53d4: raises 104,000 to 184,000
fece3a3c: folds
c50c4803: folds
Hero: folds
45f2a4a4: calls 184,000
3d8f9953: folds
5f81cdd7: folds
4e9c4c34: folds
*** FLOP *** [7s Qs 6h]
793d53d4: bets 292,000
45f2a4a4: folds
Uncalled bet (292,000) returned to 793d53d4
*** SHOWDOWN ***
793d53d4 collected 584,000 from pot
*** SUMMARY ***
Total pot 584,000 | Rake 0 | Jackpot 0 | Bingo 0 | Fortune 0 | Tax 0
Board [7s Qs 6h]
Seat 1: 4e9c4c34 (big blind) folded before Flop
Seat 2: 793d53d4 won (584,000)
Seat 3: fece3a3c folded before Flop
Seat 4: c50c4803 folded before Flop
Seat 5: Hero folded before Flop
Seat 6: 45f2a4a4 folded on the Flop
Seat 8: 3d8f9953 (button) folded before Flop
Seat 9: 5f81cdd7 (small blind) folded before Flop


Poker Hand #TM3552299016: Tournament #156543396, Bounty Hunters Special $1.08 Hold'em No Limit - Level35(35,000/70,000) - 2024/08/05 15:50:41
Table '149' 9-max Seat #6 is the button
Seat 1: 4e9c4c34 (1,455,128 in chips)
Seat 2: 793d53d4 (1,406,068 in chips)
Seat 3: fece3a3c (6,014,452 in chips)
Seat 4: c50c4803 (1,105,503 in chips)
Seat 5: Hero (3,407,873 in chips)
Seat 6: 45f2a4a4 (6,091,623 in chips)
Seat 8: 3d8f9953 (1,038,816 in chips)
Seat 9: 5f81cdd7 (1,730,537 in chips)
4e9c4c34: posts the ante 10,000
5f81cdd7: posts the ante 10,000
3d8f9953: posts the ante 10,000
45f2a4a4: posts the ante 10,000
fece3a3c: posts the ante 10,000
c50c4803: posts the ante 10,000
793d53d4: posts the ante 10,000
Hero: posts the ante 10,000
3d8f9953: posts small blind 35,000
5f81cdd7: posts big blind 70,000
*** HOLE CARDS ***
Dealt to 4e9c4c34 
Dealt to 793d53d4 
Dealt to fece3a3c 
Dealt to c50c4803 
Dealt to Hero [4d 4c]
Dealt to 45f2a4a4 
Dealt to 3d8f9953 
Dealt to 5f81cdd7 
4e9c4c34: folds
793d53d4: folds
fece3a3c: calls 70,000
c50c4803: folds
Hero: calls 70,000
45f2a4a4: folds
3d8f9953: folds
5f81cdd7: checks
*** FLOP *** [6s Qc 9s]
5f81cdd7: checks
fece3a3c: checks
Hero: checks
*** TURN *** [6s Qc 9s] [2h]
5f81cdd7: bets 107,250
fece3a3c: folds
Hero: folds
Uncalled bet (107,250) returned to 5f81cdd7
*** SHOWDOWN ***
5f81cdd7 collected 325,000 from pot
*** SUMMARY ***
Total pot 325,000 | Rake 0 | Jackpot 0 | Bingo 0 | Fortune 0 | Tax 0
Board [6s Qc 9s 2h]
Seat 1: 4e9c4c34 folded before Flop
Seat 2: 793d53d4 folded before Flop
Seat 3: fece3a3c folded on the Turn
Seat 4: c50c4803 folded before Flop
Seat 5: Hero folded on the Turn
Seat 6: 45f2a4a4 (button) folded before Flop
Seat 8: 3d8f9953 (small blind) folded before Flop
Seat 9: 5f81cdd7 (big blind) won (325,000)


Poker Hand #TM3552298999: Tournament #156543396, Bounty Hunters Special $1.08 Hold'em No Limit - Level35(35,000/70,000) - 2024/08/05 15:50:05
Table '149' 9-max Seat #5 is the button
Seat 1: 4e9c4c34 (1,465,128 in chips)
Seat 2: 793d53d4 (1,231,068 in chips)
Seat 3: fece3a3c (6,024,452 in chips)
Seat 4: c50c4803 (1,115,503 in chips)
Seat 5: Hero (3,417,873 in chips)
Seat 6: 45f2a4a4 (6,136,623 in chips)
Seat 8: 3d8f9953 (1,118,816 in chips)
Seat 9: 5f81cdd7 (1,740,537 in chips)
4e9c4c34: posts the ante 10,000
5f81cdd7: posts the ante 10,000
3d8f9953: posts the ante 10,000
fece3a3c: posts the ante 10,000
45f2a4a4: posts the ante 10,000
c50c4803: posts the ante 10,000
793d53d4: posts the ante 10,000
Hero: posts the ante 10,000
45f2a4a4: posts small blind 35,000
3d8f9953: posts big blind 70,000
*** HOLE CARDS ***
Dealt to 4e9c4c34 
Dealt to 793d53d4 
Dealt to fece3a3c 
Dealt to c50c4803 
Dealt to Hero [Kh 3h]
Dealt to 45f2a4a4 
Dealt to 3d8f9953 
Dealt to 5f81cdd7 
5f81cdd7: folds
4e9c4c34: folds
793d53d4: raises 1,151,068 to 1,221,068 and is all-in
fece3a3c: folds
c50c4803: folds
Hero: folds
45f2a4a4: folds
3d8f9953: folds
Uncalled bet (1,151,068) returned to 793d53d4
*** SHOWDOWN ***
793d53d4 collected 255,000 from pot
*** SUMMARY ***
Total pot 255,000 | Rake 0 | Jackpot 0 | Bingo 0 | Fortune 0 | Tax 0
Seat 1: 4e9c4c34 folded before Flop
Seat 2: 793d53d4 collected (255,000)
Seat 3: fece3a3c folded before Flop
Seat 4: c50c4803 folded before Flop
Seat 5: Hero (button) folded before Flop
Seat 6: 45f2a4a4 (small blind) folded before Flop
Seat 8: 3d8f9953 (big blind) folded before Flop
Seat 9: 5f81cdd7 folded before Flop


Poker Hand #TM3552298982: Tournament #156543396, Bounty Hunters Special $1.08 Hold'em No Limit - Level35(35,000/70,000) - 2024/08/05 15:49:20
Table '149' 9-max Seat #4 is the button
Seat 1: 4e9c4c34 (1,475,128 in chips)
Seat 2: 793d53d4 (1,241,068 in chips)
Seat 3: fece3a3c (6,034,452 in chips)
Seat 4: c50c4803 (1,265,503 in chips)
Seat 5: Hero (3,462,873 in chips)
Seat 6: 45f2a4a4 (5,891,623 in chips)
Seat 8: 3d8f9953 (1,128,816 in chips)
Seat 9: 5f81cdd7 (1,750,537 in chips)
4e9c4c34: posts the ante 10,000
5f81cdd7: posts the ante 10,000
3d8f9953: posts the ante 10,000
fece3a3c: posts the ante 10,000
45f2a4a4: posts the ante 10,000
c50c4803: posts the ante 10,000
793d53d4: posts the ante 10,000
Hero: posts the ante 10,000
Hero: posts small blind 35,000
45f2a4a4: posts big blind 70,000
*** HOLE CARDS ***
Dealt to 4e9c4c34 
Dealt to 793d53d4 
Dealt to fece3a3c 
Dealt to c50c4803 
Dealt to Hero [Jd 4s]
Dealt to 45f2a4a4 
Dealt to 3d8f9953 
Dealt to 5f81cdd7 
3d8f9953: folds
5f81cdd7: folds
4e9c4c34: folds
793d53d4: folds
fece3a3c: folds
c50c4803: raises 70,000 to 140,000
Hero: folds
45f2a4a4: calls 70,000
*** FLOP *** [8c Ac Th]
45f2a4a4: checks
c50c4803: checks
*** TURN *** [8c Ac Th] [6c]
45f2a4a4: bets 260,700
c50c4803: folds
Uncalled bet (260,700) returned to 45f2a4a4
*** SHOWDOWN ***
45f2a4a4 collected 395,000 from pot
*** SUMMARY ***
Total pot 395,000 | Rake 0 | Jackpot 0 | Bingo 0 | Fortune 0 | Tax 0
Board [8c Ac Th 6c]
Seat 1: 4e9c4c34 folded before Flop
Seat 2: 793d53d4 folded before Flop
Seat 3: fece3a3c folded before Flop
Seat 4: c50c4803 (button) folded on the Turn
Seat 5: Hero (small blind) folded before Flop
Seat 6: 45f2a4a4 (big blind) won (395,000)
Seat 8: 3d8f9953 folded before Flop
Seat 9: 5f81cdd7 folded before Flop


Poker Hand #TM3552298960: Tournament #156543396, Bounty Hunters Special $1.08 Hold'em No Limit - Level35(35,000/70,000) - 2024/08/05 15:48:27
Table '149' 9-max Seat #3 is the button
Seat 1: 4e9c4c34 (1,485,128 in chips)
Seat 2: 793d53d4 (1,251,068 in chips)
Seat 3: fece3a3c (5,728,752 in chips)
Seat 4: c50c4803 (1,345,503 in chips)
Seat 5: Hero (3,638,573 in chips)
Seat 6: 45f2a4a4 (5,901,623 in chips)
Seat 8: 3d8f9953 (1,138,816 in chips)
Seat 9: 5f81cdd7 (1,760,537 in chips)
4e9c4c34: posts the ante 10,000
5f81cdd7: posts the ante 10,000
3d8f9953: posts the ante 10,000
fece3a3c: posts the ante 10,000
45f2a4a4: posts the ante 10,000
c50c4803: posts the ante 10,000
793d53d4: posts the ante 10,000
Hero: posts the ante 10,000
c50c4803: posts small blind 35,000
Hero: posts big blind 70,000
*** HOLE CARDS ***
Dealt to 4e9c4c34 
Dealt to 793d53d4 
Dealt to fece3a3c 
Dealt to c50c4803 
Dealt to Hero [5d Ah]
Dealt to 45f2a4a4 
Dealt to 3d8f9953 
Dealt to 5f81cdd7 
45f2a4a4: folds
3d8f9953: folds
5f81cdd7: folds
4e9c4c34: folds
793d53d4: folds
fece3a3c: calls 70,000
c50c4803: calls 35,000
Hero: checks
*** FLOP *** [7c 5h 8h]
c50c4803: checks
Hero: bets 95,700
fece3a3c: calls 95,700
c50c4803: folds
*** TURN *** [7c 5h 8h] [Jc]
Hero: checks
fece3a3c: bets 361,050
Hero: folds
Uncalled bet (361,050) returned to fece3a3c
*** SHOWDOWN ***
fece3a3c collected 481,400 from pot
*** SUMMARY ***
Total pot 481,400 | Rake 0 | Jackpot 0 | Bingo 0 | Fortune 0 | Tax 0
Board [7c 5h 8h Jc]
Seat 1: 4e9c4c34 folded before Flop
Seat 2: 793d53d4 folded before Flop
Seat 3: fece3a3c (button) won (481,400)
Seat 4: c50c4803 (small blind) folded on the Flop
Seat 5: Hero (big blind) folded on the Turn
Seat 6: 45f2a4a4 folded before Flop
Seat 8: 3d8f9953 folded before Flop
Seat 9: 5f81cdd7 folded before Flop


Poker Hand #TM3552298948: Tournament #156543396, Bounty Hunters Special $1.08 Hold'em No Limit - Level35(35,000/70,000) - 2024/08/05 15:48:05
Table '149' 9-max Seat #2 is the button
Seat 1: 4e9c4c34 (1,495,128 in chips)
Seat 2: 793d53d4 (1,076,068 in chips)
Seat 3: fece3a3c (5,773,752 in chips)
Seat 4: c50c4803 (1,425,503 in chips)
Seat 5: Hero (3,648,573 in chips)
Seat 6: 45f2a4a4 (5,911,623 in chips)
Seat 8: 3d8f9953 (1,148,816 in chips)
Seat 9: 5f81cdd7 (1,770,537 in chips)
4e9c4c34: posts the ante 10,000
5f81cdd7: posts the ante 10,000
3d8f9953: posts the ante 10,000
45f2a4a4: posts the ante 10,000
fece3a3c: posts the ante 10,000
c50c4803: posts the ante 10,000
793d53d4: posts the ante 10,000
Hero: posts the ante 10,000
fece3a3c: posts small blind 35,000
c50c4803: posts big blind 70,000
*** HOLE CARDS ***
Dealt to 4e9c4c34 
Dealt to 793d53d4 
Dealt to fece3a3c 
Dealt to c50c4803 
Dealt to Hero [8h 6c]
Dealt to 45f2a4a4 
Dealt to 3d8f9953 
Dealt to 5f81cdd7 
Hero: folds
45f2a4a4: folds
3d8f9953: folds
5f81cdd7: folds
4e9c4c34: folds
793d53d4: raises 70,000 to 140,000
fece3a3c: folds
c50c4803: folds
Uncalled bet (70,000) returned to 793d53d4
*** SHOWDOWN ***
793d53d4 collected 255,000 from pot
*** SUMMARY ***
Total pot 255,000 | Rake 0 | Jackpot 0 | Bingo 0 | Fortune 0 | Tax 0
Seat 1: 4e9c4c34 folded before Flop
Seat 2: 793d53d4 (button) collected (255,000)
Seat 3: fece3a3c (small blind) folded before Flop
Seat 4: c50c4803 (big blind) folded before Flop
Seat 5: Hero folded before Flop
Seat 6: 45f2a4a4 folded before Flop
Seat 8: 3d8f9953 folded before Flop
Seat 9: 5f81cdd7 folded before Flop


Poker Hand #TM3552298916: Tournament #156543396, Bounty Hunters Special $1.08 Hold'em No Limit - Level35(35,000/70,000) - 2024/08/05 15:46:49
Table '149' 9-max Seat #1 is the button
Seat 1: 4e9c4c34 (1,505,128 in chips)
Seat 2: 793d53d4 (1,121,068 in chips)
Seat 3: fece3a3c (6,642,652 in chips)
Seat 4: c50c4803 (1,435,503 in chips)
Seat 5: Hero (3,658,573 in chips)
Seat 6: 45f2a4a4 (4,947,723 in chips)
Seat 8: 3d8f9953 (1,158,816 in chips)
Seat 9: 5f81cdd7 (1,780,537 in chips)
4e9c4c34: posts the ante 10,000
5f81cdd7: posts the ante 10,000
3d8f9953: posts the ante 10,000
45f2a4a4: posts the ante 10,000
fece3a3c: posts the ante 10,000
c50c4803: posts the ante 10,000
793d53d4: posts the ante 10,000
Hero: posts the ante 10,000
793d53d4: posts small blind 35,000
fece3a3c: posts big blind 70,000
*** HOLE CARDS ***
Dealt to 4e9c4c34 
Dealt to 793d53d4 
Dealt to fece3a3c 
Dealt to c50c4803 
Dealt to Hero [5h Kh]
Dealt to 45f2a4a4 
Dealt to 3d8f9953 
Dealt to 5f81cdd7 
c50c4803: folds
Hero: folds
45f2a4a4: raises 70,000 to 140,000
3d8f9953: folds
5f81cdd7: folds
4e9c4c34: folds
793d53d4: folds
fece3a3c: calls 70,000
*** FLOP *** [4h 8h 5s]
fece3a3c: checks
45f2a4a4: bets 260,700
fece3a3c: calls 260,700
*** TURN *** [4h 8h 5s] [3h]
fece3a3c: checks
45f2a4a4: checks
*** RIVER *** [4h 8h 5s 3h] [3c]
fece3a3c: bets 458,200
45f2a4a4: calls 458,200
fece3a3c: shows [Kc 7s] (Pair of Treys)
45f2a4a4: shows [Ad Ah] (Pair of Aces and Pair of Treys)
*** SHOWDOWN ***
45f2a4a4 collected 1,832,800 from pot
*** SUMMARY ***
Total pot 1,832,800 | Rake 0 | Jackpot 0 | Bingo 0 | Fortune 0 | Tax 0
Board [4h 8h 5s 3h 3c]
Seat 1: 4e9c4c34 (button) folded before Flop
Seat 2: 793d53d4 (small blind) folded before Flop
Seat 3: fece3a3c (big blind) showed [Kc 7s] and lost with Pair of Treys
Seat 4: c50c4803 folded before Flop
Seat 5: Hero folded before Flop
Seat 6: 45f2a4a4 showed [Ad Ah] and won (1,832,800) with Pair of Aces and Pair of Treys
Seat 8: 3d8f9953 folded before Flop
Seat 9: 5f81cdd7 folded before Flop


Poker Hand #TM3552298899: Tournament #156543396, Bounty Hunters Special $1.08 Hold'em No Limit - Level35(35,000/70,000) - 2024/08/05 15:45:57
Table '149' 9-max Seat #9 is the button
Seat 1: 4e9c4c34 (1,550,128 in chips)
Seat 2: 793d53d4 (1,073,568 in chips)
Seat 3: fece3a3c (6,595,152 in chips)
Seat 4: c50c4803 (1,445,503 in chips)
Seat 5: Hero (3,668,573 in chips)
Seat 6: 45f2a4a4 (4,957,723 in chips)
Seat 8: 3d8f9953 (1,168,816 in chips)
Seat 9: 5f81cdd7 (1,790,537 in chips)
4e9c4c34: posts the ante 10,000
5f81cdd7: posts the ante 10,000
3d8f9953: posts the ante 10,000
45f2a4a4: posts the ante 10,000
fece3a3c: posts the ante 10,000
c50c4803: posts the ante 10,000
793d53d4: posts the ante 10,000
Hero: posts the ante 10,000
4e9c4c34: posts small blind 35,000
793d53d4: posts big blind 70,000
*** HOLE CARDS ***
Dealt to 4e9c4c34 
Dealt to 793d53d4 
Dealt to fece3a3c 
Dealt to c50c4803 
Dealt to Hero [3h 5d]
Dealt to 45f2a4a4 
Dealt to 3d8f9953 
Dealt to 5f81cdd7 
fece3a3c: calls 70,000
c50c4803: folds
Hero: folds
45f2a4a4: folds
3d8f9953: folds
5f81cdd7: folds
4e9c4c34: folds
793d53d4: checks
*** FLOP *** [4d 2h Kd]
793d53d4: checks
fece3a3c: checks
*** TURN *** [4d 2h Kd] [Ad]
793d53d4: checks
fece3a3c: bets 84,150
793d53d4: calls 84,150
*** RIVER *** [4d 2h Kd Ad] [2s]
793d53d4: checks
fece3a3c: checks
793d53d4: shows [9h As] (Pair of Aces and Pair of Twos)
fece3a3c: shows [8c Ac] (Pair of Aces and Pair of Twos)
Hero: shows [3h 5d] (Fives-High Straight)
*** SHOWDOWN ***
fece3a3c collected 211,650 from pot
793d53d4 collected 211,650 from pot
*** SUMMARY ***
Total pot 423,300 | Rake 0 | Jackpot 0 | Bingo 0 | Fortune 0 | Tax 0
Board [4d 2h Kd Ad 2s]
Seat 1: 4e9c4c34 (small blind) folded before Flop
Seat 2: 793d53d4 (big blind) showed [9h As] and won (211,650) with Pair of Aces and Pair of Twos
Seat 3: fece3a3c showed [8c Ac] and won (211,650) with Pair of Aces and Pair of Twos
Seat 4: c50c4803 folded before Flop
Seat 5: Hero folded before Flop
Seat 6: 45f2a4a4 folded before Flop
Seat 8: 3d8f9953 folded before Flop
Seat 9: 5f81cdd7 (button) folded before Flop


Poker Hand #TM3552298886: Tournament #156543396, Bounty Hunters Special $1.08 Hold'em No Limit - Level35(35,000/70,000) - 2024/08/05 15:45:18
Table '149' 9-max Seat #8 is the button
Seat 1: 4e9c4c34 (1,630,128 in chips)
Seat 2: 793d53d4 (1,083,568 in chips)
Seat 3: fece3a3c (6,420,152 in chips)
Seat 4: c50c4803 (1,455,503 in chips)
Seat 5: Hero (3,678,573 in chips)
Seat 6: 45f2a4a4 (4,967,723 in chips)
Seat 8: 3d8f9953 (1,178,816 in chips)
Seat 9: 5f81cdd7 (1,835,537 in chips)
4e9c4c34: posts the ante 10,000
3d8f9953: posts the ante 10,000
5f81cdd7: posts the ante 10,000
45f2a4a4: posts the ante 10,000
fece3a3c: posts the ante 10,000
c50c4803: posts the ante 10,000
793d53d4: posts the ante 10,000
Hero: posts the ante 10,000
5f81cdd7: posts small blind 35,000
4e9c4c34: posts big blind 70,000
*** HOLE CARDS ***
Dealt to 4e9c4c34 
Dealt to 793d53d4 
Dealt to fece3a3c 
Dealt to c50c4803 
Dealt to Hero [5s 2h]
Dealt to 45f2a4a4 
Dealt to 3d8f9953 
Dealt to 5f81cdd7 
793d53d4: folds
fece3a3c: calls 70,000
c50c4803: folds
Hero: folds
45f2a4a4: folds
3d8f9953: folds
5f81cdd7: folds
4e9c4c34: checks
*** FLOP *** [4c Jc Ad]
4e9c4c34: checks
fece3a3c: bets 84,150
4e9c4c34: folds
Uncalled bet (84,150) returned to fece3a3c
*** SHOWDOWN ***
fece3a3c collected 255,000 from pot
*** SUMMARY ***
Total pot 255,000 | Rake 0 | Jackpot 0 | Bingo 0 | Fortune 0 | Tax 0
Board [4c Jc Ad]
Seat 1: 4e9c4c34 (big blind) folded on the Flop
Seat 2: 793d53d4 folded before Flop
Seat 3: fece3a3c won (255,000)
Seat 4: c50c4803 folded before Flop
Seat 5: Hero folded before Flop
Seat 6: 45f2a4a4 folded before Flop
Seat 8: 3d8f9953 (button) folded before Flop
Seat 9: 5f81cdd7 (small blind) folded before Flop


Poker Hand #TM3552298870: Tournament #156543396, Bounty Hunters Special $1.08 Hold'em No Limit - Level35(35,000/70,000) - 2024/08/05 15:44:20
Table '149' 9-max Seat #7 is the button
Seat 1: 4e9c4c34 (1,640,128 in chips)
Seat 2: 793d53d4 (1,093,568 in chips)
Seat 3: fece3a3c (6,430,152 in chips)
Seat 4: c50c4803 (1,465,503 in chips)
Seat 5: Hero (3,688,573 in chips)
Seat 6: 45f2a4a4 (4,977,723 in chips)
Seat 7: 319dcc00 (140,796 in chips)
Seat 8: 3d8f9953 (1,223,816 in chips)
Seat 9: 5f81cdd7 (1,589,741 in chips)
4e9c4c34: posts the ante 10,000
5f81cdd7: posts the ante 10,000
3d8f9953: posts the ante 10,000
319dcc00: posts the ante 10,000
45f2a4a4: posts the ante 10,000
fece3a3c: posts the ante 10,000
c50c4803: posts the ante 10,000
793d53d4: posts the ante 10,000
Hero: posts the ante 10,000
3d8f9953: posts small blind 35,000
5f81cdd7: posts big blind 70,000
*** HOLE CARDS ***
Dealt to 4e9c4c34 
Dealt to 793d53d4 
Dealt to fece3a3c 
Dealt to c50c4803 
Dealt to Hero [5d Jh]
Dealt to 45f2a4a4 
Dealt to 319dcc00 
Dealt to 3d8f9953 
Dealt to 5f81cdd7 
4e9c4c34: folds
793d53d4: folds
fece3a3c: folds
c50c4803: folds
Hero: folds
45f2a4a4: folds
319dcc00: raises 60,796 to 130,796 and is all-in
3d8f9953: folds
5f81cdd7: calls 60,796
319dcc00: shows [Qd As]
5f81cdd7: shows [2h 4s]
*** FLOP *** [2c Jd Ad]
*** TURN *** [2c Jd Ad] [4h]
*** RIVER *** [2c Jd Ad 4h] [6d]
*** SHOWDOWN ***
5f81cdd7 collected 386,592 from pot
*** SUMMARY ***
Total pot 386,592 | Rake 0 | Jackpot 0 | Bingo 0 | Fortune 0 | Tax 0
Board [2c Jd Ad 4h 6d]
Seat 1: 4e9c4c34 folded before Flop
Seat 2: 793d53d4 folded before Flop
Seat 3: fece3a3c folded before Flop
Seat 4: c50c4803 folded before Flop
Seat 5: Hero folded before Flop
Seat 6: 45f2a4a4 folded before Flop
Seat 7: 319dcc00 (button) showed [Qd As] and lost with Pair of Aces
Seat 8: 3d8f9953 (small blind) folded before Flop
Seat 9: 5f81cdd7 (big blind) showed [2h 4s] and won (386,592) with Pair of Fours and Pair of Twos


Poker Hand #TM3552298850: Tournament #156543396, Bounty Hunters Special $1.08 Hold'em No Limit - Level35(35,000/70,000) - 2024/08/05 15:43:22
Table '149' 9-max Seat #6 is the button
Seat 1: 4e9c4c34 (1,650,128 in chips)
Seat 2: 793d53d4 (1,103,568 in chips)
Seat 3: fece3a3c (5,392,652 in chips)
Seat 4: c50c4803 (1,475,503 in chips)
Seat 5: Hero (4,551,073 in chips)
Seat 6: 45f2a4a4 (4,987,723 in chips)
Seat 7: 319dcc00 (185,796 in chips)
Seat 8: 3d8f9953 (1,303,816 in chips)
Seat 9: 5f81cdd7 (1,599,741 in chips)
4e9c4c34: posts the ante 10,000
5f81cdd7: posts the ante 10,000
3d8f9953: posts the ante 10,000
319dcc00: posts the ante 10,000
45f2a4a4: posts the ante 10,000
fece3a3c: posts the ante 10,000
c50c4803: posts the ante 10,000
793d53d4: posts the ante 10,000
Hero: posts the ante 10,000
319dcc00: posts small blind 35,000
3d8f9953: posts big blind 70,000
*** HOLE CARDS ***
Dealt to 4e9c4c34 
Dealt to 793d53d4 
Dealt to fece3a3c 
Dealt to c50c4803 
Dealt to Hero [As 5s]
Dealt to 45f2a4a4 
Dealt to 319dcc00 
Dealt to 3d8f9953 
Dealt to 5f81cdd7 
5f81cdd7: folds
4e9c4c34: folds
793d53d4: folds
fece3a3c: raises 70,000 to 140,000
c50c4803: folds
Hero: calls 140,000
45f2a4a4: folds
319dcc00: folds
3d8f9953: folds
*** FLOP *** [4c 6h 3d]
fece3a3c: checks
Hero: bets 237,500
fece3a3c: calls 237,500
*** TURN *** [4c 6h 3d] [Qs]
fece3a3c: checks
Hero: bets 475,000
fece3a3c: calls 475,000
*** RIVER *** [4c 6h 3d Qs] [Qc]
fece3a3c: checks
Hero: checks
fece3a3c: shows [Qd Kd] (Three Queens)
Hero: shows [As 5s] (Pair of Queens)
*** SHOWDOWN ***
fece3a3c collected 1,900,000 from pot
*** SUMMARY ***
Total pot 1,900,000 | Rake 0 | Jackpot 0 | Bingo 0 | Fortune 0 | Tax 0
Board [4c 6h 3d Qs Qc]
Seat 1: 4e9c4c34 folded before Flop
Seat 2: 793d53d4 folded before Flop
Seat 3: fece3a3c showed [Qd Kd] and won (1,900,000) with Three Queens
Seat 4: c50c4803 folded before Flop
Seat 5: Hero showed [As 5s] and lost with Pair of Queens
Seat 6: 45f2a4a4 (button) folded before Flop
Seat 7: 319dcc00 (small blind) folded before Flop
Seat 8: 3d8f9953 (big blind) folded before Flop
Seat 9: 5f81cdd7 folded before Flop


Poker Hand #TM3552298823: Tournament #156543396, Bounty Hunters Special $1.08 Hold'em No Limit - Level35(35,000/70,000) - 2024/08/05 15:42:22
Table '149' 9-max Seat #5 is the button
Seat 1: 4e9c4c34 (1,660,128 in chips)
Seat 2: 793d53d4 (1,183,568 in chips)
Seat 3: fece3a3c (4,857,652 in chips)
Seat 4: c50c4803 (1,765,503 in chips)
Seat 5: Hero (4,561,073 in chips)
Seat 6: 45f2a4a4 (5,032,723 in chips)
Seat 7: 319dcc00 (265,796 in chips)
Seat 8: 3d8f9953 (1,313,816 in chips)
Seat 9: 5f81cdd7 (1,609,741 in chips)
4e9c4c34: posts the ante 10,000
5f81cdd7: posts the ante 10,000
3d8f9953: posts the ante 10,000
319dcc00: posts the ante 10,000
fece3a3c: posts the ante 10,000
45f2a4a4: posts the ante 10,000
c50c4803: posts the ante 10,000
793d53d4: posts the ante 10,000
Hero: posts the ante 10,000
45f2a4a4: posts small blind 35,000
319dcc00: posts big blind 70,000
*** HOLE CARDS ***
Dealt to 4e9c4c34 
Dealt to 793d53d4 
Dealt to fece3a3c 
Dealt to c50c4803 
Dealt to Hero [8h 3c]
Dealt to 45f2a4a4 
Dealt to 319dcc00 
Dealt to 3d8f9953 
Dealt to 5f81cdd7 
3d8f9953: folds
5f81cdd7: folds
4e9c4c34: folds
793d53d4: calls 70,000
fece3a3c: calls 70,000
c50c4803: raises 210,000 to 280,000
Hero: folds
45f2a4a4: folds
319dcc00: folds
793d53d4: folds
fece3a3c: raises 4,567,652 to 4,847,652 and is all-in
c50c4803: folds
Uncalled bet (4,567,652) returned to fece3a3c
c50c4803: shows [Kc Ad]
*** SHOWDOWN ***
fece3a3c collected 825,000 from pot
*** SUMMARY ***
Total pot 825,000 | Rake 0 | Jackpot 0 | Bingo 0 | Fortune 0 | Tax 0
Seat 1: 4e9c4c34 folded before Flop
Seat 2: 793d53d4 folded before Flop
Seat 3: fece3a3c collected (825,000)
Seat 4: c50c4803 folded before Flop
Seat 5: Hero (button) folded before Flop
Seat 6: 45f2a4a4 (small blind) folded before Flop
Seat 7: 319dcc00 (big blind) folded before Flop
Seat 8: 3d8f9953 folded before Flop
Seat 9: 5f81cdd7 folded before Flop


Poker Hand #TM3552298810: Tournament #156543396, Bounty Hunters Special $1.08 Hold'em No Limit - Level35(35,000/70,000) - 2024/08/05 15:41:55
Table '149' 9-max Seat #4 is the button
Seat 1: 4e9c4c34 (1,670,128 in chips)
Seat 2: 793d53d4 (1,193,568 in chips)
Seat 3: fece3a3c (4,867,652 in chips)
Seat 4: c50c4803 (1,775,503 in chips)
Seat 5: Hero (4,606,073 in chips)
Seat 6: 45f2a4a4 (5,112,723 in chips)
Seat 7: 319dcc00 (275,796 in chips)
Seat 8: 3d8f9953 (1,128,816 in chips)
Seat 9: 5f81cdd7 (1,619,741 in chips)
4e9c4c34: posts the ante 10,000
5f81cdd7: posts the ante 10,000
3d8f9953: posts the ante 10,000
319dcc00: posts the ante 10,000
fece3a3c: posts the ante 10,000
45f2a4a4: posts the ante 10,000
c50c4803: posts the ante 10,000
793d53d4: posts the ante 10,000
Hero: posts the ante 10,000
Hero: posts small blind 35,000
45f2a4a4: posts big blind 70,000
*** HOLE CARDS ***
Dealt to 4e9c4c34 
Dealt to 793d53d4 
Dealt to fece3a3c 
Dealt to c50c4803 
Dealt to Hero [3d 5h]
Dealt to 45f2a4a4 
Dealt to 319dcc00 
Dealt to 3d8f9953 
Dealt to 5f81cdd7 
319dcc00: folds
3d8f9953: raises 70,000 to 140,000
5f81cdd7: folds
4e9c4c34: folds
793d53d4: folds
fece3a3c: folds
c50c4803: folds
Hero: folds
45f2a4a4: folds
Uncalled bet (70,000) returned to 3d8f9953
*** SHOWDOWN ***
3d8f9953 collected 265,000 from pot
*** SUMMARY ***
Total pot 265,000 | Rake 0 | Jackpot 0 | Bingo 0 | Fortune 0 | Tax 0
Seat 1: 4e9c4c34 folded before Flop
Seat 2: 793d53d4 folded before Flop
Seat 3: fece3a3c folded before Flop
Seat 4: c50c4803 (button) folded before Flop
Seat 5: Hero (small blind) folded before Flop
Seat 6: 45f2a4a4 (big blind) folded before Flop
Seat 7: 319dcc00 folded before Flop
Seat 8: 3d8f9953 collected (265,000)
Seat 9: 5f81cdd7 folded before Flop


Poker Hand #TM3552298793: Tournament #156543396, Bounty Hunters Special $1.08 Hold'em No Limit - Level34(30,000/60,000) - 2024/08/05 15:41:06
Table '149' 9-max Seat #3 is the button
Seat 1: 4e9c4c34 (1,679,128 in chips)
Seat 2: 793d53d4 (1,322,568 in chips)
Seat 3: fece3a3c (4,876,652 in chips)
Seat 4: c50c4803 (1,814,503 in chips)
Seat 5: Hero (4,384,073 in chips)
Seat 6: 45f2a4a4 (5,121,723 in chips)
Seat 7: 319dcc00 (284,796 in chips)
Seat 8: 3d8f9953 (1,137,816 in chips)
Seat 9: 5f81cdd7 (1,628,741 in chips)
4e9c4c34: posts the ante 9,000
5f81cdd7: posts the ante 9,000
3d8f9953: posts the ante 9,000
319dcc00: posts the ante 9,000
fece3a3c: posts the ante 9,000
45f2a4a4: posts the ante 9,000
c50c4803: posts the ante 9,000
793d53d4: posts the ante 9,000
Hero: posts the ante 9,000
c50c4803: posts small blind 30,000
Hero: posts big blind 60,000
*** HOLE CARDS ***
Dealt to 4e9c4c34 
Dealt to 793d53d4 
Dealt to fece3a3c 
Dealt to c50c4803 
Dealt to Hero [Ah 9h]
Dealt to 45f2a4a4 
Dealt to 319dcc00 
Dealt to 3d8f9953 
Dealt to 5f81cdd7 
45f2a4a4: folds
319dcc00: folds
3d8f9953: folds
5f81cdd7: folds
4e9c4c34: folds
793d53d4: raises 60,000 to 120,000
fece3a3c: folds
c50c4803: folds
Hero: calls 60,000
*** FLOP *** [8s 6s 7c]
Hero: checks
793d53d4: checks
*** TURN *** [8s 6s 7c] [8d]
Hero: bets 175,500
793d53d4: folds
Uncalled bet (175,500) returned to Hero
*** SHOWDOWN ***
Hero collected 351,000 from pot
*** SUMMARY ***
Total pot 351,000 | Rake 0 | Jackpot 0 | Bingo 0 | Fortune 0 | Tax 0
Board [8s 6s 7c 8d]
Seat 1: 4e9c4c34 folded before Flop
Seat 2: 793d53d4 folded on the Turn
Seat 3: fece3a3c (button) folded before Flop
Seat 4: c50c4803 (small blind) folded before Flop
Seat 5: Hero (big blind) won (351,000)
Seat 6: 45f2a4a4 folded before Flop
Seat 7: 319dcc00 folded before Flop
Seat 8: 3d8f9953 folded before Flop
Seat 9: 5f81cdd7 folded before Flop


Poker Hand #TM3552298783: Tournament #156543396, Bounty Hunters Special $1.08 Hold'em No Limit - Level34(30,000/60,000) - 2024/08/05 15:40:38
Table '149' 9-max Seat #2 is the button
Seat 1: 4e9c4c34 (1,688,128 in chips)
Seat 2: 793d53d4 (1,331,568 in chips)
Seat 3: fece3a3c (4,945,652 in chips)
Seat 4: c50c4803 (1,682,503 in chips)
Seat 5: Hero (4,393,073 in chips)
Seat 6: 45f2a4a4 (5,130,723 in chips)
Seat 7: 319dcc00 (293,796 in chips)
Seat 8: 3d8f9953 (1,146,816 in chips)
Seat 9: 5f81cdd7 (1,637,741 in chips)
4e9c4c34: posts the ante 9,000
5f81cdd7: posts the ante 9,000
3d8f9953: posts the ante 9,000
319dcc00: posts the ante 9,000
45f2a4a4: posts the ante 9,000
fece3a3c: posts the ante 9,000
c50c4803: posts the ante 9,000
793d53d4: posts the ante 9,000
Hero: posts the ante 9,000
fece3a3c: posts small blind 30,000
c50c4803: posts big blind 60,000
*** HOLE CARDS ***
Dealt to 4e9c4c34 
Dealt to 793d53d4 
Dealt to fece3a3c 
Dealt to c50c4803 
Dealt to Hero [2d 5h]
Dealt to 45f2a4a4 
Dealt to 319dcc00 
Dealt to 3d8f9953 
Dealt to 5f81cdd7 
Hero: folds
45f2a4a4: folds
319dcc00: folds
3d8f9953: folds
5f81cdd7: folds
4e9c4c34: folds
793d53d4: folds
fece3a3c: calls 30,000
c50c4803: raises 300,000 to 360,000
fece3a3c: folds
Uncalled bet (300,000) returned to c50c4803
*** SHOWDOWN ***
c50c4803 collected 201,000 from pot
*** SUMMARY ***
Total pot 201,000 | Rake 0 | Jackpot 0 | Bingo 0 | Fortune 0 | Tax 0
Seat 1: 4e9c4c34 folded before Flop
Seat 2: 793d53d4 (button) folded before Flop
Seat 3: fece3a3c (small blind) folded before Flop
Seat 4: c50c4803 (big blind) collected (201,000)
Seat 5: Hero folded before Flop
Seat 6: 45f2a4a4 folded before Flop
Seat 7: 319dcc00 folded before Flop
Seat 8: 3d8f9953 folded before Flop
Seat 9: 5f81cdd7 folded before Flop


Poker Hand #TM3552298764: Tournament #156543396, Bounty Hunters Special $1.08 Hold'em No Limit - Level34(30,000/60,000) - 2024/08/05 15:39:55
Table '149' 9-max Seat #1 is the button
Seat 1: 4e9c4c34 (1,526,128 in chips)
Seat 2: 793d53d4 (1,370,568 in chips)
Seat 3: fece3a3c (5,014,652 in chips)
Seat 4: c50c4803 (1,691,503 in chips)
Seat 5: Hero (4,402,073 in chips)
Seat 6: 45f2a4a4 (5,139,723 in chips)
Seat 7: 319dcc00 (302,796 in chips)
Seat 8: 3d8f9953 (1,155,816 in chips)
Seat 9: 5f81cdd7 (1,646,741 in chips)
4e9c4c34: posts the ante 9,000
5f81cdd7: posts the ante 9,000
3d8f9953: posts the ante 9,000
319dcc00: posts the ante 9,000
45f2a4a4: posts the ante 9,000
fece3a3c: posts the ante 9,000
c50c4803: posts the ante 9,000
793d53d4: posts the ante 9,000
Hero: posts the ante 9,000
793d53d4: posts small blind 30,000
fece3a3c: posts big blind 60,000
*** HOLE CARDS ***
Dealt to 4e9c4c34 
Dealt to 793d53d4 
Dealt to fece3a3c 
Dealt to c50c4803 
Dealt to Hero [Qh 6c]
Dealt to 45f2a4a4 
Dealt to 319dcc00 
Dealt to 3d8f9953 
Dealt to 5f81cdd7 
c50c4803: folds
Hero: folds
45f2a4a4: folds
319dcc00: folds
3d8f9953: folds
5f81cdd7: folds
4e9c4c34: raises 60,000 to 120,000
793d53d4: folds
fece3a3c: folds
Uncalled bet (60,000) returned to 4e9c4c34
*** SHOWDOWN ***
4e9c4c34 collected 231,000 from pot
*** SUMMARY ***
Total pot 231,000 | Rake 0 | Jackpot 0 | Bingo 0 | Fortune 0 | Tax 0
Seat 1: 4e9c4c34 (button) collected (231,000)
Seat 2: 793d53d4 (small blind) folded before Flop
Seat 3: fece3a3c (big blind) folded before Flop
Seat 4: c50c4803 folded before Flop
Seat 5: Hero folded before Flop
Seat 6: 45f2a4a4 folded before Flop
Seat 7: 319dcc00 folded before Flop
Seat 8: 3d8f9953 folded before Flop
Seat 9: 5f81cdd7 folded before Flop


Poker Hand #TM3552298754: Tournament #156543396, Bounty Hunters Special $1.08 Hold'em No Limit - Level34(30,000/60,000) - 2024/08/05 15:39:33
Table '149' 9-max Seat #9 is the button
Seat 1: 4e9c4c34 (1,565,128 in chips)
Seat 2: 793d53d4 (1,439,568 in chips)
Seat 3: fece3a3c (5,023,652 in chips)
Seat 4: c50c4803 (1,700,503 in chips)
Seat 5: Hero (4,240,073 in chips)
Seat 6: 45f2a4a4 (5,148,723 in chips)
Seat 7: 319dcc00 (311,796 in chips)
Seat 8: 3d8f9953 (1,164,816 in chips)
Seat 9: 5f81cdd7 (1,655,741 in chips)
4e9c4c34: posts the ante 9,000
5f81cdd7: posts the ante 9,000
3d8f9953: posts the ante 9,000
319dcc00: posts the ante 9,000
45f2a4a4: posts the ante 9,000
fece3a3c: posts the ante 9,000
c50c4803: posts the ante 9,000
793d53d4: posts the ante 9,000
Hero: posts the ante 9,000
4e9c4c34: posts small blind 30,000
793d53d4: posts big blind 60,000
*** HOLE CARDS ***
Dealt to 4e9c4c34 
Dealt to 793d53d4 
Dealt to fece3a3c 
Dealt to c50c4803 
Dealt to Hero [7s 7d]
Dealt to 45f2a4a4 
Dealt to 319dcc00 
Dealt to 3d8f9953 
Dealt to 5f81cdd7 
fece3a3c: folds
c50c4803: folds
Hero: raises 90,000 to 150,000
45f2a4a4: folds
319dcc00: folds
3d8f9953: folds
5f81cdd7: folds
4e9c4c34: folds
793d53d4: folds
Uncalled bet (90,000) returned to Hero
*** SHOWDOWN ***
Hero collected 231,000 from pot
*** SUMMARY ***
Total pot 231,000 | Rake 0 | Jackpot 0 | Bingo 0 | Fortune 0 | Tax 0
Seat 1: 4e9c4c34 (small blind) folded before Flop
Seat 2: 793d53d4 (big blind) folded before Flop
Seat 3: fece3a3c folded before Flop
Seat 4: c50c4803 folded before Flop
Seat 5: Hero collected (231,000)
Seat 6: 45f2a4a4 folded before Flop
Seat 7: 319dcc00 folded before Flop
Seat 8: 3d8f9953 folded before Flop
Seat 9: 5f81cdd7 (button) folded before Flop


Poker Hand #TM3552298724: Tournament #156543396, Bounty Hunters Special $1.08 Hold'em No Limit - Level34(30,000/60,000) - 2024/08/05 15:38:21
Table '149' 9-max Seat #8 is the button
Seat 1: 4e9c4c34 (1,343,128 in chips)
Seat 2: 793d53d4 (1,448,568 in chips)
Seat 3: fece3a3c (5,032,652 in chips)
Seat 4: c50c4803 (1,709,503 in chips)
Seat 5: Hero (4,249,073 in chips)
Seat 6: 45f2a4a4 (5,157,723 in chips)
Seat 7: 319dcc00 (320,796 in chips)
Seat 8: 3d8f9953 (1,293,816 in chips)
Seat 9: 5f81cdd7 (1,694,741 in chips)
4e9c4c34: posts the ante 9,000
3d8f9953: posts the ante 9,000
5f81cdd7: posts the ante 9,000
319dcc00: posts the ante 9,000
45f2a4a4: posts the ante 9,000
fece3a3c: posts the ante 9,000
c50c4803: posts the ante 9,000
793d53d4: posts the ante 9,000
Hero: posts the ante 9,000
5f81cdd7: posts small blind 30,000
4e9c4c34: posts big blind 60,000
*** HOLE CARDS ***
Dealt to 4e9c4c34 
Dealt to 793d53d4 
Dealt to fece3a3c 
Dealt to c50c4803 
Dealt to Hero [Jd 6s]
Dealt to 45f2a4a4 
Dealt to 319dcc00 
Dealt to 3d8f9953 
Dealt to 5f81cdd7 
793d53d4: folds
fece3a3c: folds
c50c4803: folds
Hero: folds
45f2a4a4: folds
319dcc00: folds
3d8f9953: raises 60,000 to 120,000
5f81cdd7: folds
4e9c4c34: calls 60,000
*** FLOP *** [6c Ac 2c]
4e9c4c34: checks
3d8f9953: checks
*** TURN *** [6c Ac 2c] [Ah]
4e9c4c34: bets 96,000
3d8f9953: folds
Uncalled bet (96,000) returned to 4e9c4c34
*** SHOWDOWN ***
4e9c4c34 collected 351,000 from pot
*** SUMMARY ***
Total pot 351,000 | Rake 0 | Jackpot 0 | Bingo 0 | Fortune 0 | Tax 0
Board [6c Ac 2c Ah]
Seat 1: 4e9c4c34 (big blind) won (351,000)
Seat 2: 793d53d4 folded before Flop
Seat 3: fece3a3c folded before Flop
Seat 4: c50c4803 folded before Flop
Seat 5: Hero folded before Flop
Seat 6: 45f2a4a4 folded before Flop
Seat 7: 319dcc00 folded before Flop
Seat 8: 3d8f9953 (button) folded on the Turn
Seat 9: 5f81cdd7 (small blind) folded before Flop


Poker Hand #TM3552298703: Tournament #156543396, Bounty Hunters Special $1.08 Hold'em No Limit - Level34(30,000/60,000) - 2024/08/05 15:37:30
Table '149' 9-max Seat #7 is the button
Seat 1: 4e9c4c34 (1,352,128 in chips)
Seat 2: 793d53d4 (1,457,568 in chips)
Seat 3: fece3a3c (5,041,652 in chips)
Seat 4: c50c4803 (1,718,503 in chips)
Seat 5: Hero (4,258,073 in chips)
Seat 6: 45f2a4a4 (5,743,131 in chips)
Seat 7: 319dcc00 (329,796 in chips)
Seat 8: 3d8f9953 (585,408 in chips)
Seat 9: 5f81cdd7 (1,763,741 in chips)
4e9c4c34: posts the ante 9,000
5f81cdd7: posts the ante 9,000
3d8f9953: posts the ante 9,000
319dcc00: posts the ante 9,000
45f2a4a4: posts the ante 9,000
fece3a3c: posts the ante 9,000
c50c4803: posts the ante 9,000
793d53d4: posts the ante 9,000
Hero: posts the ante 9,000
3d8f9953: posts small blind 30,000
5f81cdd7: posts big blind 60,000
*** HOLE CARDS ***
Dealt to 4e9c4c34 
Dealt to 793d53d4 
Dealt to fece3a3c 
Dealt to c50c4803 
Dealt to Hero [8d 7h]
Dealt to 45f2a4a4 
Dealt to 319dcc00 
Dealt to 3d8f9953 
Dealt to 5f81cdd7 
4e9c4c34: folds
793d53d4: folds
fece3a3c: folds
c50c4803: folds
Hero: folds
45f2a4a4: raises 60,000 to 120,000
319dcc00: folds
3d8f9953: raises 456,408 to 576,408 and is all-in
5f81cdd7: folds
45f2a4a4: calls 456,408
3d8f9953: shows [9c Ad]
45f2a4a4: shows [As 2d]
*** FLOP *** [7c 9d Kd]
*** TURN *** [7c 9d Kd] [5h]
*** RIVER *** [7c 9d Kd 5h] [Tc]
c50c4803: shows [2h] (King-High)
*** SHOWDOWN ***
3d8f9953 collected 1,293,816 from pot
*** SUMMARY ***
Total pot 1,293,816 | Rake 0 | Jackpot 0 | Bingo 0 | Fortune 0 | Tax 0
Board [7c 9d Kd 5h Tc]
Seat 1: 4e9c4c34 folded before Flop
Seat 2: 793d53d4 folded before Flop
Seat 3: fece3a3c folded before Flop
Seat 4: c50c4803 folded before Flop
Seat 5: Hero folded before Flop
Seat 6: 45f2a4a4 showed [As 2d] and lost with Ace-High
Seat 7: 319dcc00 (button) folded before Flop
Seat 8: 3d8f9953 (small blind) showed [9c Ad] and won (1,293,816) with Pair of Nines
Seat 9: 5f81cdd7 (big blind) folded before Flop


Poker Hand #TM3552298691: Tournament #156543396, Bounty Hunters Special $1.08 Hold'em No Limit - Level34(30,000/60,000) - 2024/08/05 15:36:59
Table '149' 9-max Seat #6 is the button
Seat 1: 4e9c4c34 (1,361,128 in chips)
Seat 2: 793d53d4 (1,466,568 in chips)
Seat 3: fece3a3c (4,849,652 in chips)
Seat 4: c50c4803 (1,727,503 in chips)
Seat 5: Hero (4,267,073 in chips)
Seat 6: 45f2a4a4 (5,752,131 in chips)
Seat 7: 319dcc00 (398,796 in chips)
Seat 8: 3d8f9953 (654,408 in chips)
Seat 9: 5f81cdd7 (1,772,741 in chips)
4e9c4c34: posts the ante 9,000
5f81cdd7: posts the ante 9,000
3d8f9953: posts the ante 9,000
319dcc00: posts the ante 9,000
45f2a4a4: posts the ante 9,000
fece3a3c: posts the ante 9,000
c50c4803: posts the ante 9,000
793d53d4: posts the ante 9,000
Hero: posts the ante 9,000
319dcc00: posts small blind 30,000
3d8f9953: posts big blind 60,000
*** HOLE CARDS ***
Dealt to 4e9c4c34 
Dealt to 793d53d4 
Dealt to fece3a3c 
Dealt to c50c4803 
Dealt to Hero [9h 6h]
Dealt to 45f2a4a4 
Dealt to 319dcc00 
Dealt to 3d8f9953 
Dealt to 5f81cdd7 
5f81cdd7: folds
4e9c4c34: folds
793d53d4: folds
fece3a3c: calls 60,000
c50c4803: folds
Hero: folds
45f2a4a4: folds
319dcc00: calls 30,000
3d8f9953: checks
*** FLOP *** [9d Jh 8d]
319dcc00: checks
3d8f9953: checks
fece3a3c: bets 130,500
319dcc00: folds
3d8f9953: folds
Uncalled bet (130,500) returned to fece3a3c
*** SHOWDOWN ***
fece3a3c collected 261,000 from pot
*** SUMMARY ***
Total pot 261,000 | Rake 0 | Jackpot 0 | Bingo 0 | Fortune 0 | Tax 0
Board [9d Jh 8d]
Seat 1: 4e9c4c34 folded before Flop
Seat 2: 793d53d4 folded before Flop
Seat 3: fece3a3c won (261,000)
Seat 4: c50c4803 folded before Flop
Seat 5: Hero folded before Flop
Seat 6: 45f2a4a4 (button) folded before Flop
Seat 7: 319dcc00 (small blind) folded on the Flop
Seat 8: 3d8f9953 (big blind) folded on the Flop
Seat 9: 5f81cdd7 folded before Flop


Poker Hand #TM3552298658: Tournament #156543396, Bounty Hunters Special $1.08 Hold'em No Limit - Level34(30,000/60,000) - 2024/08/05 15:35:46
Table '149' 9-max Seat #5 is the button
Seat 1: 4e9c4c34 (1,370,128 in chips)
Seat 2: 793d53d4 (1,475,568 in chips)
Seat 3: fece3a3c (4,571,522 in chips)
Seat 4: c50c4803 (1,736,503 in chips)
Seat 5: Hero (4,276,073 in chips)
Seat 6: 45f2a4a4 (5,907,261 in chips)
Seat 7: 319dcc00 (467,796 in chips)
Seat 8: 3d8f9953 (663,408 in chips)
Seat 9: 5f81cdd7 (1,781,741 in chips)
4e9c4c34: posts the ante 9,000
5f81cdd7: posts the ante 9,000
3d8f9953: posts the ante 9,000
319dcc00: posts the ante 9,000
fece3a3c: posts the ante 9,000
45f2a4a4: posts the ante 9,000
c50c4803: posts the ante 9,000
793d53d4: posts the ante 9,000
Hero: posts the ante 9,000
45f2a4a4: posts small blind 30,000
319dcc00: posts big blind 60,000
*** HOLE CARDS ***
Dealt to 4e9c4c34 
Dealt to 793d53d4 
Dealt to fece3a3c 
Dealt to c50c4803 
Dealt to Hero [4c Kh]
Dealt to 45f2a4a4 
Dealt to 319dcc00 
Dealt to 3d8f9953 
Dealt to 5f81cdd7 
3d8f9953: folds
5f81cdd7: folds
4e9c4c34: folds
793d53d4: folds
fece3a3c: calls 60,000
c50c4803: folds
Hero: folds
45f2a4a4: calls 30,000
319dcc00: checks
*** FLOP *** [8c Ts Jd]
45f2a4a4: checks
319dcc00: checks
fece3a3c: checks
*** TURN *** [8c Ts Jd] [Ah]
45f2a4a4: checks
319dcc00: checks
fece3a3c: bets 86,130
45f2a4a4: calls 86,130
319dcc00: folds
*** RIVER *** [8c Ts Jd Ah] [7s]
45f2a4a4: checks
fece3a3c: checks
45f2a4a4: shows [2h Qh] (Ace-High)
fece3a3c: shows [Ad 3d] (Pair of Aces)
*** SHOWDOWN ***
fece3a3c collected 433,260 from pot
*** SUMMARY ***
Total pot 433,260 | Rake 0 | Jackpot 0 | Bingo 0 | Fortune 0 | Tax 0
Board [8c Ts Jd Ah 7s]
Seat 1: 4e9c4c34 folded before Flop
Seat 2: 793d53d4 folded before Flop
Seat 3: fece3a3c showed [Ad 3d] and won (433,260) with Pair of Aces
Seat 4: c50c4803 folded before Flop
Seat 5: Hero (button) folded before Flop
Seat 6: 45f2a4a4 (small blind) showed [2h Qh] and lost with Ace-High
Seat 7: 319dcc00 (big blind) folded on the Turn
Seat 8: 3d8f9953 folded before Flop
Seat 9: 5f81cdd7 folded before Flop


Poker Hand #TM3552298639: Tournament #156543396, Bounty Hunters Special $1.08 Hold'em No Limit - Level34(30,000/60,000) - 2024/08/05 15:35:03
Table '149' 9-max Seat #4 is the button
Seat 1: 4e9c4c34 (1,379,128 in chips)
Seat 2: 793d53d4 (1,313,568 in chips)
Seat 3: fece3a3c (4,580,522 in chips)
Seat 4: c50c4803 (1,745,503 in chips)
Seat 5: Hero (4,315,073 in chips)
Seat 6: 45f2a4a4 (5,976,261 in chips)
Seat 7: 319dcc00 (476,796 in chips)
Seat 8: 3d8f9953 (672,408 in chips)
Seat 9: 5f81cdd7 (1,790,741 in chips)
4e9c4c34: posts the ante 9,000
5f81cdd7: posts the ante 9,000
3d8f9953: posts the ante 9,000
319dcc00: posts the ante 9,000
fece3a3c: posts the ante 9,000
45f2a4a4: posts the ante 9,000
c50c4803: posts the ante 9,000
793d53d4: posts the ante 9,000
Hero: posts the ante 9,000
Hero: posts small blind 30,000
45f2a4a4: posts big blind 60,000
*** HOLE CARDS ***
Dealt to 4e9c4c34 
Dealt to 793d53d4 
Dealt to fece3a3c 
Dealt to c50c4803 
Dealt to Hero [Ah 2c]
Dealt to 45f2a4a4 
Dealt to 319dcc00 
Dealt to 3d8f9953 
Dealt to 5f81cdd7 
319dcc00: folds
3d8f9953: folds
5f81cdd7: folds
4e9c4c34: folds
793d53d4: raises 60,000 to 120,000
fece3a3c: folds
c50c4803: folds
Hero: folds
45f2a4a4: folds
Uncalled bet (60,000) returned to 793d53d4
*** SHOWDOWN ***
793d53d4 collected 231,000 from pot
*** SUMMARY ***
Total pot 231,000 | Rake 0 | Jackpot 0 | Bingo 0 | Fortune 0 | Tax 0
Seat 1: 4e9c4c34 folded before Flop
Seat 2: 793d53d4 collected (231,000)
Seat 3: fece3a3c folded before Flop
Seat 4: c50c4803 (button) folded before Flop
Seat 5: Hero (small blind) folded before Flop
Seat 6: 45f2a4a4 (big blind) folded before Flop
Seat 7: 319dcc00 folded before Flop
Seat 8: 3d8f9953 folded before Flop
Seat 9: 5f81cdd7 folded before Flop


Poker Hand #TM3552298618: Tournament #156543396, Bounty Hunters Special $1.08 Hold'em No Limit - Level34(30,000/60,000) - 2024/08/05 15:34:24
Table '149' 9-max Seat #3 is the button
Seat 1: 4e9c4c34 (1,388,128 in chips)
Seat 2: 793d53d4 (1,322,568 in chips)
Seat 3: fece3a3c (4,589,522 in chips)
Seat 4: c50c4803 (1,493,503 in chips)
Seat 5: Hero (4,384,073 in chips)
Seat 6: 45f2a4a4 (5,985,261 in chips)
Seat 7: 319dcc00 (485,796 in chips)
Seat 8: 3d8f9953 (681,408 in chips)
Seat 9: 5f81cdd7 (1,919,741 in chips)
4e9c4c34: posts the ante 9,000
5f81cdd7: posts the ante 9,000
3d8f9953: posts the ante 9,000
319dcc00: posts the ante 9,000
fece3a3c: posts the ante 9,000
45f2a4a4: posts the ante 9,000
c50c4803: posts the ante 9,000
793d53d4: posts the ante 9,000
Hero: posts the ante 9,000
c50c4803: posts small blind 30,000
Hero: posts big blind 60,000
*** HOLE CARDS ***
Dealt to 4e9c4c34 
Dealt to 793d53d4 
Dealt to fece3a3c 
Dealt to c50c4803 
Dealt to Hero [2h 9s]
Dealt to 45f2a4a4 
Dealt to 319dcc00 
Dealt to 3d8f9953 
Dealt to 5f81cdd7 
45f2a4a4: folds
319dcc00: folds
3d8f9953: folds
5f81cdd7: raises 60,000 to 120,000
4e9c4c34: folds
793d53d4: folds
fece3a3c: folds
c50c4803: calls 90,000
Hero: folds
*** FLOP *** [4h 8h 3h]
c50c4803: bets 120,000
5f81cdd7: folds
Uncalled bet (120,000) returned to c50c4803
*** SHOWDOWN ***
c50c4803 collected 381,000 from pot
*** SUMMARY ***
Total pot 381,000 | Rake 0 | Jackpot 0 | Bingo 0 | Fortune 0 | Tax 0
Board [4h 8h 3h]
Seat 1: 4e9c4c34 folded before Flop
Seat 2: 793d53d4 folded before Flop
Seat 3: fece3a3c (button) folded before Flop
Seat 4: c50c4803 (small blind) won (381,000)
Seat 5: Hero (big blind) folded before Flop
Seat 6: 45f2a4a4 folded before Flop
Seat 7: 319dcc00 folded before Flop
Seat 8: 3d8f9953 folded before Flop
Seat 9: 5f81cdd7 folded on the Flop


Poker Hand #TM3552298599: Tournament #156543396, Bounty Hunters Special $1.08 Hold'em No Limit - Level34(30,000/60,000) - 2024/08/05 15:33:43
Table '149' 9-max Seat #2 is the button
Seat 1: 4e9c4c34 (1,397,128 in chips)
Seat 2: 793d53d4 (1,331,568 in chips)
Seat 3: fece3a3c (4,628,522 in chips)
Seat 4: c50c4803 (1,689,901 in chips)
Seat 5: Hero (4,393,073 in chips)
Seat 6: 45f2a4a4 (5,994,261 in chips)
Seat 7: 319dcc00 (196,398 in chips)
Seat 8: 3d8f9953 (690,408 in chips)
Seat 9: 5f81cdd7 (1,928,741 in chips)
4e9c4c34: posts the ante 9,000
5f81cdd7: posts the ante 9,000
3d8f9953: posts the ante 9,000
319dcc00: posts the ante 9,000
45f2a4a4: posts the ante 9,000
fece3a3c: posts the ante 9,000
c50c4803: posts the ante 9,000
793d53d4: posts the ante 9,000
Hero: posts the ante 9,000
fece3a3c: posts small blind 30,000
c50c4803: posts big blind 60,000
*** HOLE CARDS ***
Dealt to 4e9c4c34 
Dealt to 793d53d4 
Dealt to fece3a3c 
Dealt to c50c4803 
Dealt to Hero [7c 4c]
Dealt to 45f2a4a4 
Dealt to 319dcc00 
Dealt to 3d8f9953 
Dealt to 5f81cdd7 
Hero: folds
45f2a4a4: folds
319dcc00: raises 127,398 to 187,398 and is all-in
3d8f9953: folds
5f81cdd7: folds
4e9c4c34: folds
793d53d4: folds
fece3a3c: folds
c50c4803: calls 127,398
319dcc00: shows [Kh Ac]
c50c4803: shows [Js 6s]
*** FLOP *** [Qc As 9c]
*** TURN *** [Qc As 9c] [Ah]
*** RIVER *** [Qc As 9c Ah] [6c]
*** SHOWDOWN ***
319dcc00 collected 485,796 from pot
*** SUMMARY ***
Total pot 485,796 | Rake 0 | Jackpot 0 | Bingo 0 | Fortune 0 | Tax 0
Board [Qc As 9c Ah 6c]
Seat 1: 4e9c4c34 folded before Flop
Seat 2: 793d53d4 (button) folded before Flop
Seat 3: fece3a3c (small blind) folded before Flop
Seat 4: c50c4803 (big blind) showed [Js 6s] and lost with Pair of Aces and Pair of Sixes
Seat 5: Hero folded before Flop
Seat 6: 45f2a4a4 folded before Flop
Seat 7: 319dcc00 showed [Kh Ac] and won (485,796) with Three Aces
Seat 8: 3d8f9953 folded before Flop
Seat 9: 5f81cdd7 folded before Flop


Poker Hand #TM3552298583: Tournament #156543396, Bounty Hunters Special $1.08 Hold'em No Limit - Level34(30,000/60,000) - 2024/08/05 15:33:15
Table '149' 9-max Seat #1 is the button
Seat 1: 4e9c4c34 (1,406,128 in chips)
Seat 2: 793d53d4 (1,370,568 in chips)
Seat 3: fece3a3c (4,757,522 in chips)
Seat 4: c50c4803 (1,698,901 in chips)
Seat 5: Hero (4,402,073 in chips)
Seat 6: 45f2a4a4 (5,772,261 in chips)
Seat 7: 319dcc00 (205,398 in chips)
Seat 8: 3d8f9953 (699,408 in chips)
Seat 9: 5f81cdd7 (1,937,741 in chips)
4e9c4c34: posts the ante 9,000
5f81cdd7: posts the ante 9,000
3d8f9953: posts the ante 9,000
319dcc00: posts the ante 9,000
45f2a4a4: posts the ante 9,000
fece3a3c: posts the ante 9,000
c50c4803: posts the ante 9,000
793d53d4: posts the ante 9,000
Hero: posts the ante 9,000
793d53d4: posts small blind 30,000
fece3a3c: posts big blind 60,000
*** HOLE CARDS ***
Dealt to 4e9c4c34 
Dealt to 793d53d4 
Dealt to fece3a3c 
Dealt to c50c4803 
Dealt to Hero [5c Kd]
Dealt to 45f2a4a4 
Dealt to 319dcc00 
Dealt to 3d8f9953 
Dealt to 5f81cdd7 
c50c4803: folds
Hero: folds
45f2a4a4: raises 60,000 to 120,000
319dcc00: folds
3d8f9953: folds
5f81cdd7: folds
4e9c4c34: folds
793d53d4: folds
fece3a3c: calls 60,000
*** FLOP *** [Ac 2d 5d]
fece3a3c: checks
45f2a4a4: bets 115,830
fece3a3c: folds
Uncalled bet (115,830) returned to 45f2a4a4
*** SHOWDOWN ***
45f2a4a4 collected 351,000 from pot
*** SUMMARY ***
Total pot 351,000 | Rake 0 | Jackpot 0 | Bingo 0 | Fortune 0 | Tax 0
Board [Ac 2d 5d]
Seat 1: 4e9c4c34 (button) folded before Flop
Seat 2: 793d53d4 (small blind) folded before Flop
Seat 3: fece3a3c (big blind) folded on the Flop
Seat 4: c50c4803 folded before Flop
Seat 5: Hero folded before Flop
Seat 6: 45f2a4a4 won (351,000)
Seat 7: 319dcc00 folded before Flop
Seat 8: 3d8f9953 folded before Flop
Seat 9: 5f81cdd7 folded before Flop


Poker Hand #TM3552713104: Tournament #156543396, Bounty Hunters Special $1.08 Hold'em No Limit - Level37(50,000/100,000) - 2024/08/05 15:25:25
Table '47' 8-max Seat #6 is the button
Seat 3: Hero (4,042,073 in chips)
Seat 5: c50c4803 (1,713,901 in chips)
Seat 6: 3d8f9953 (714,408 in chips)
Seat 7: 793d53d4 (1,585,568 in chips)
Seat 8: 4e9c4c34 (1,521,128 in chips)
4e9c4c34: posts the ante 15,000
3d8f9953: posts the ante 15,000
c50c4803: posts the ante 15,000
793d53d4: posts the ante 15,000
Hero: posts the ante 15,000
793d53d4: posts small blind 50,000
4e9c4c34: posts big blind 100,000
*** HOLE CARDS ***
Dealt to Hero [Tc Qc]
Dealt to c50c4803 
Dealt to 3d8f9953 
Dealt to 793d53d4 
Dealt to 4e9c4c34 
Hero: raises 100,000 to 200,000
c50c4803: folds
3d8f9953: folds
793d53d4: calls 150,000
4e9c4c34: folds
*** FLOP *** [Js 7d Ad]
793d53d4: checks
Hero: bets 287,500
793d53d4: folds
Uncalled bet (287,500) returned to Hero
*** SHOWDOWN ***
Hero collected 575,000 from pot
*** SUMMARY ***
Total pot 575,000 | Rake 0 | Jackpot 0 | Bingo 0 | Fortune 0 | Tax 0
Board [Js 7d Ad]
Seat 3: Hero won (575,000)
Seat 5: c50c4803 folded before Flop
Seat 6: 3d8f9953 (button) folded before Flop
Seat 7: 793d53d4 (small blind) folded on the Flop
Seat 8: 4e9c4c34 (big blind) folded before Flop


Poker Hand #TM3552713067: Tournament #156543396, Bounty Hunters Special $1.08 Hold'em No Limit - Level37(50,000/100,000) - 2024/08/05 15:24:23
Table '47' 8-max Seat #5 is the button
Seat 3: Hero (2,776,573 in chips)
Seat 5: c50c4803 (1,728,901 in chips)
Seat 6: 3d8f9953 (779,408 in chips)
Seat 7: 793d53d4 (2,756,068 in chips)
Seat 8: 4e9c4c34 (1,536,128 in chips)
4e9c4c34: posts the ante 15,000
3d8f9953: posts the ante 15,000
c50c4803: posts the ante 15,000
793d53d4: posts the ante 15,000
Hero: posts the ante 15,000
3d8f9953: posts small blind 50,000
793d53d4: posts big blind 100,000
*** HOLE CARDS ***
Dealt to Hero [As Ah]
Dealt to c50c4803 
Dealt to 3d8f9953 
Dealt to 793d53d4 
Dealt to 4e9c4c34 
4e9c4c34: folds
Hero: raises 100,000 to 200,000
c50c4803: folds
3d8f9953: folds
793d53d4: calls 100,000
*** FLOP *** [Ks 8c Qc]
793d53d4: checks
Hero: checks
*** TURN *** [Ks 8c Qc] [Tc]
793d53d4: bets 173,250
Hero: raises 173,250 to 346,500
793d53d4: calls 173,250
*** RIVER *** [Ks 8c Qc Tc] [4h]
793d53d4: checks
Hero: bets 609,000
793d53d4: calls 609,000
Hero: shows [As Ah] (Pair of Aces)
793d53d4: shows [Kh 3h] (Pair of Kings)
*** SHOWDOWN ***
Hero collected 2,436,000 from pot
*** SUMMARY ***
Total pot 2,436,000 | Rake 0 | Jackpot 0 | Bingo 0 | Fortune 0 | Tax 0
Board [Ks 8c Qc Tc 4h]
Seat 3: Hero showed [As Ah] and won (2,436,000) with Pair of Aces
Seat 5: c50c4803 (button) folded before Flop
Seat 6: 3d8f9953 (small blind) folded before Flop
Seat 7: 793d53d4 (big blind) showed [Kh 3h] and lost with Pair of Kings
Seat 8: 4e9c4c34 folded before Flop


Poker Hand #TM3552713035: Tournament #156543396, Bounty Hunters Special $1.08 Hold'em No Limit - Level37(50,000/100,000) - 2024/08/05 15:23:24
Table '47' 8-max Seat #3 is the button
Seat 3: Hero (2,791,573 in chips)
Seat 5: c50c4803 (1,568,901 in chips)
Seat 6: 3d8f9953 (894,408 in chips)
Seat 7: 793d53d4 (2,771,068 in chips)
Seat 8: 4e9c4c34 (1,551,128 in chips)
4e9c4c34: posts the ante 15,000
3d8f9953: posts the ante 15,000
c50c4803: posts the ante 15,000
793d53d4: posts the ante 15,000
Hero: posts the ante 15,000
c50c4803: posts small blind 50,000
3d8f9953: posts big blind 100,000
*** HOLE CARDS ***
Dealt to Hero [2s Qs]
Dealt to c50c4803 
Dealt to 3d8f9953 
Dealt to 793d53d4 
Dealt to 4e9c4c34 
793d53d4: folds
4e9c4c34: folds
Hero: folds
c50c4803: calls 50,000
3d8f9953: checks
*** FLOP *** [Qc 2c Jh]
c50c4803: checks
3d8f9953: checks
*** TURN *** [Qc 2c Jh] [8s]
c50c4803: checks
3d8f9953: checks
*** RIVER *** [Qc 2c Jh 8s] [Ad]
c50c4803: bets 100,000
3d8f9953: folds
Uncalled bet (100,000) returned to c50c4803
*** SHOWDOWN ***
c50c4803 collected 275,000 from pot
*** SUMMARY ***
Total pot 275,000 | Rake 0 | Jackpot 0 | Bingo 0 | Fortune 0 | Tax 0
Board [Qc 2c Jh 8s Ad]
Seat 3: Hero (button) folded before Flop
Seat 5: c50c4803 (small blind) won (275,000)
Seat 6: 3d8f9953 (big blind) folded on the River
Seat 7: 793d53d4 folded before Flop
Seat 8: 4e9c4c34 folded before Flop


Poker Hand #TM3552713005: Tournament #156543396, Bounty Hunters Special $1.08 Hold'em No Limit - Level37(50,000/100,000) - 2024/08/05 15:22:36
Table '47' 8-max Seat #8 is the button
Seat 3: Hero (2,631,573 in chips)
Seat 5: c50c4803 (1,683,901 in chips)
Seat 6: 3d8f9953 (909,408 in chips)
Seat 7: 793d53d4 (2,786,068 in chips)
Seat 8: 4e9c4c34 (1,566,128 in chips)
4e9c4c34: posts the ante 15,000
3d8f9953: posts the ante 15,000
c50c4803: posts the ante 15,000
793d53d4: posts the ante 15,000
Hero: posts the ante 15,000
Hero: posts small blind 50,000
c50c4803: posts big blind 100,000
*** HOLE CARDS ***
Dealt to Hero [As Th]
Dealt to c50c4803 
Dealt to 3d8f9953 
Dealt to 793d53d4 
Dealt to 4e9c4c34 
3d8f9953: folds
793d53d4: folds
4e9c4c34: folds
Hero: raises 200,000 to 300,000
c50c4803: folds
Uncalled bet (200,000) returned to Hero
Hero: shows [As Th]
*** SHOWDOWN ***
Hero collected 275,000 from pot
*** SUMMARY ***
Total pot 275,000 | Rake 0 | Jackpot 0 | Bingo 0 | Fortune 0 | Tax 0
Seat 3: Hero (small blind) showed [As Th] and collected (275,000)
Seat 5: c50c4803 (big blind) folded before Flop
Seat 6: 3d8f9953 folded before Flop
Seat 7: 793d53d4 folded before Flop
Seat 8: 4e9c4c34 (button) folded before Flop


Poker Hand #TM3552712972: Tournament #156543396, Bounty Hunters Special $1.08 Hold'em No Limit - Level37(50,000/100,000) - 2024/08/05 15:21:41
Table '47' 8-max Seat #7 is the button
Seat 3: Hero (2,521,573 in chips)
Seat 5: c50c4803 (1,698,901 in chips)
Seat 6: 3d8f9953 (924,408 in chips)
Seat 7: 793d53d4 (2,801,068 in chips)
Seat 8: 4e9c4c34 (1,631,128 in chips)
4e9c4c34: posts the ante 15,000
3d8f9953: posts the ante 15,000
c50c4803: posts the ante 15,000
793d53d4: posts the ante 15,000
Hero: posts the ante 15,000
4e9c4c34: posts small blind 50,000
Hero: posts big blind 100,000
*** HOLE CARDS ***
Dealt to Hero [Qh Ah]
Dealt to c50c4803 
Dealt to 3d8f9953 
Dealt to 793d53d4 
Dealt to 4e9c4c34 
c50c4803: folds
3d8f9953: folds
793d53d4: folds
4e9c4c34: folds
Uncalled bet (50,000) returned to Hero
*** SHOWDOWN ***
Hero collected 175,000 from pot
*** SUMMARY ***
Total pot 175,000 | Rake 0 | Jackpot 0 | Bingo 0 | Fortune 0 | Tax 0
Seat 3: Hero (big blind) collected (175,000)
Seat 5: c50c4803 folded before Flop
Seat 6: 3d8f9953 folded before Flop
Seat 7: 793d53d4 (button) folded before Flop
Seat 8: 4e9c4c34 (small blind) folded before Flop


Poker Hand #TM3552712898: Tournament #156543396, Bounty Hunters Special $1.08 Hold'em No Limit - Level36(40,000/80,000) - 2024/08/05 15:19:42
Table '47' 8-max Seat #6 is the button
Seat 3: Hero (2,533,573 in chips)
Seat 4: 5056be4e (438,580 in chips)
Seat 5: c50c4803 (1,710,901 in chips)
Seat 6: 3d8f9953 (936,408 in chips)
Seat 7: 793d53d4 (2,581,068 in chips)
Seat 8: 4e9c4c34 (1,723,128 in chips)
4e9c4c34: posts the ante 12,000
3d8f9953: posts the ante 12,000
5056be4e: posts the ante 12,000
c50c4803: posts the ante 12,000
793d53d4: posts the ante 12,000
Hero: posts the ante 12,000
793d53d4: posts small blind 40,000
4e9c4c34: posts big blind 80,000
*** HOLE CARDS ***
Dealt to Hero [6s 9d]
Dealt to 5056be4e 
Dealt to c50c4803 
Dealt to 3d8f9953 
Dealt to 793d53d4 
Dealt to 4e9c4c34 
Hero: folds
5056be4e: calls 80,000
c50c4803: folds
3d8f9953: folds
793d53d4: calls 40,000
4e9c4c34: checks
*** FLOP *** [Tc 6h 2c]
793d53d4: checks
4e9c4c34: checks
5056be4e: checks
*** TURN *** [Tc 6h 2c] [Kd]
793d53d4: checks
4e9c4c34: checks
5056be4e: checks
*** RIVER *** [Tc 6h 2c Kd] [2s]
793d53d4: bets 156,000
4e9c4c34: folds
5056be4e: folds
Uncalled bet (156,000) returned to 793d53d4
*** SHOWDOWN ***
793d53d4 collected 312,000 from pot
*** SUMMARY ***
Total pot 312,000 | Rake 0 | Jackpot 0 | Bingo 0 | Fortune 0 | Tax 0
Board [Tc 6h 2c Kd 2s]
Seat 3: Hero folded before Flop
Seat 4: 5056be4e folded on the River
Seat 5: c50c4803 folded before Flop
Seat 6: 3d8f9953 (button) folded before Flop
Seat 7: 793d53d4 (small blind) won (312,000)
Seat 8: 4e9c4c34 (big blind) folded on the River


Poker Hand #TM3552712880: Tournament #156543396, Bounty Hunters Special $1.08 Hold'em No Limit - Level36(40,000/80,000) - 2024/08/05 15:19:11
Table '47' 8-max Seat #5 is the button
Seat 3: Hero (2,545,573 in chips)
Seat 4: 5056be4e (450,580 in chips)
Seat 5: c50c4803 (1,722,901 in chips)
Seat 6: 3d8f9953 (796,408 in chips)
Seat 7: 793d53d4 (2,673,068 in chips)
Seat 8: 4e9c4c34 (1,735,128 in chips)
4e9c4c34: posts the ante 12,000
3d8f9953: posts the ante 12,000
5056be4e: posts the ante 12,000
c50c4803: posts the ante 12,000
793d53d4: posts the ante 12,000
Hero: posts the ante 12,000
3d8f9953: posts small blind 40,000
793d53d4: posts big blind 80,000
*** HOLE CARDS ***
Dealt to Hero [Ks 7s]
Dealt to 5056be4e 
Dealt to c50c4803 
Dealt to 3d8f9953 
Dealt to 793d53d4 
Dealt to 4e9c4c34 
4e9c4c34: folds
Hero: folds
5056be4e: folds
c50c4803: folds
3d8f9953: raises 704,408 to 784,408 and is all-in
793d53d4: folds
Uncalled bet (704,408) returned to 3d8f9953
*** SHOWDOWN ***
3d8f9953 collected 232,000 from pot
*** SUMMARY ***
Total pot 232,000 | Rake 0 | Jackpot 0 | Bingo 0 | Fortune 0 | Tax 0
Seat 3: Hero folded before Flop
Seat 4: 5056be4e folded before Flop
Seat 5: c50c4803 (button) folded before Flop
Seat 6: 3d8f9953 (small blind) collected (232,000)
Seat 7: 793d53d4 (big blind) folded before Flop
Seat 8: 4e9c4c34 folded before Flop


Poker Hand #TM3552712843: Tournament #156543396, Bounty Hunters Special $1.08 Hold'em No Limit - Level36(40,000/80,000) - 2024/08/05 15:17:57
Table '47' 8-max Seat #4 is the button
Seat 3: Hero (2,557,573 in chips)
Seat 4: 5056be4e (462,580 in chips)
Seat 5: c50c4803 (1,582,901 in chips)
Seat 6: 3d8f9953 (888,408 in chips)
Seat 7: 793d53d4 (2,685,068 in chips)
Seat 8: 4e9c4c34 (1,747,128 in chips)
4e9c4c34: posts the ante 12,000
3d8f9953: posts the ante 12,000
5056be4e: posts the ante 12,000
c50c4803: posts the ante 12,000
793d53d4: posts the ante 12,000
Hero: posts the ante 12,000
c50c4803: posts small blind 40,000
3d8f9953: posts big blind 80,000
*** HOLE CARDS ***
Dealt to Hero [7d 8c]
Dealt to 5056be4e 
Dealt to c50c4803 
Dealt to 3d8f9953 
Dealt to 793d53d4 
Dealt to 4e9c4c34 
793d53d4: folds
4e9c4c34: folds
Hero: folds
5056be4e: folds
c50c4803: raises 1,490,901 to 1,570,901 and is all-in
3d8f9953: folds
Uncalled bet (1,490,901) returned to c50c4803
*** SHOWDOWN ***
c50c4803 collected 232,000 from pot
*** SUMMARY ***
Total pot 232,000 | Rake 0 | Jackpot 0 | Bingo 0 | Fortune 0 | Tax 0
Seat 3: Hero folded before Flop
Seat 4: 5056be4e (button) folded before Flop
Seat 5: c50c4803 (small blind) collected (232,000)
Seat 6: 3d8f9953 (big blind) folded before Flop
Seat 7: 793d53d4 folded before Flop
Seat 8: 4e9c4c34 folded before Flop


Poker Hand #TM3552712786: Tournament #156543396, Bounty Hunters Special $1.08 Hold'em No Limit - Level36(40,000/80,000) - 2024/08/05 15:16:27
Table '47' 8-max Seat #3 is the button
Seat 3: Hero (2,569,573 in chips)
Seat 4: 5056be4e (514,580 in chips)
Seat 5: c50c4803 (1,322,901 in chips)
Seat 6: 3d8f9953 (1,060,408 in chips)
Seat 7: 793d53d4 (2,697,068 in chips)
Seat 8: 4e9c4c34 (1,759,128 in chips)
4e9c4c34: posts the ante 12,000
3d8f9953: posts the ante 12,000
5056be4e: posts the ante 12,000
c50c4803: posts the ante 12,000
793d53d4: posts the ante 12,000
Hero: posts the ante 12,000
5056be4e: posts small blind 40,000
c50c4803: posts big blind 80,000
*** HOLE CARDS ***
Dealt to Hero [5h Kd]
Dealt to 5056be4e 
Dealt to c50c4803 
Dealt to 3d8f9953 
Dealt to 793d53d4 
Dealt to 4e9c4c34 
3d8f9953: raises 80,000 to 160,000
793d53d4: folds
4e9c4c34: folds
Hero: folds
5056be4e: folds
c50c4803: calls 80,000
*** FLOP *** [3s 7s 9d]
c50c4803: checks
3d8f9953: checks
*** TURN *** [3s 7s 9d] [6c]
c50c4803: bets 240,000
3d8f9953: folds
Uncalled bet (240,000) returned to c50c4803
*** SHOWDOWN ***
c50c4803 collected 432,000 from pot
*** SUMMARY ***
Total pot 432,000 | Rake 0 | Jackpot 0 | Bingo 0 | Fortune 0 | Tax 0
Board [3s 7s 9d 6c]
Seat 3: Hero (button) folded before Flop
Seat 4: 5056be4e (small blind) folded before Flop
Seat 5: c50c4803 (big blind) won (432,000)
Seat 6: 3d8f9953 folded on the Turn
Seat 7: 793d53d4 folded before Flop
Seat 8: 4e9c4c34 folded before Flop


Poker Hand #TM3552712751: Tournament #156543396, Bounty Hunters Special $1.08 Hold'em No Limit - Level36(40,000/80,000) - 2024/08/05 15:15:32
Table '47' 8-max Seat #2 is the button
Seat 2: 45f2a4a4 (3,899,317 in chips)
Seat 3: Hero (2,621,573 in chips)
Seat 4: 5056be4e (606,580 in chips)
Seat 5: c50c4803 (1,334,901 in chips)
Seat 6: 3d8f9953 (1,072,408 in chips)
Seat 7: 793d53d4 (2,709,068 in chips)
Seat 8: 4e9c4c34 (1,931,128 in chips)
4e9c4c34: posts the ante 12,000
3d8f9953: posts the ante 12,000
45f2a4a4: posts the ante 12,000
5056be4e: posts the ante 12,000
c50c4803: posts the ante 12,000
793d53d4: posts the ante 12,000
Hero: posts the ante 12,000
Hero: posts small blind 40,000
5056be4e: posts big blind 80,000
*** HOLE CARDS ***
Dealt to 45f2a4a4 
Dealt to Hero [2d Ts]
Dealt to 5056be4e 
Dealt to c50c4803 
Dealt to 3d8f9953 
Dealt to 793d53d4 
Dealt to 4e9c4c34 
c50c4803: folds
3d8f9953: folds
793d53d4: folds
4e9c4c34: raises 80,000 to 160,000
45f2a4a4: raises 3,727,317 to 3,887,317 and is all-in
Hero: folds
5056be4e: folds
4e9c4c34: folds
Uncalled bet (3,727,317) returned to 45f2a4a4
*** SHOWDOWN ***
45f2a4a4 collected 524,000 from pot
*** SUMMARY ***
Total pot 524,000 | Rake 0 | Jackpot 0 | Bingo 0 | Fortune 0 | Tax 0
Seat 2: 45f2a4a4 (button) collected (524,000)
Seat 3: Hero (small blind) folded before Flop
Seat 4: 5056be4e (big blind) folded before Flop
Seat 5: c50c4803 folded before Flop
Seat 6: 3d8f9953 folded before Flop
Seat 7: 793d53d4 folded before Flop
Seat 8: 4e9c4c34 folded before Flop


Poker Hand #TM3552712692: Tournament #156543396, Bounty Hunters Special $1.08 Hold'em No Limit - Level36(40,000/80,000) - 2024/08/05 15:13:39
Table '47' 8-max Seat #8 is the button
Seat 2: 45f2a4a4 (3,741,317 in chips)
Seat 3: Hero (2,713,573 in chips)
Seat 4: 5056be4e (618,580 in chips)
Seat 5: c50c4803 (1,346,901 in chips)
Seat 6: 3d8f9953 (1,084,408 in chips)
Seat 7: 793d53d4 (2,897,068 in chips)
Seat 8: 4e9c4c34 (1,773,128 in chips)
4e9c4c34: posts the ante 12,000
3d8f9953: posts the ante 12,000
45f2a4a4: posts the ante 12,000
5056be4e: posts the ante 12,000
c50c4803: posts the ante 12,000
793d53d4: posts the ante 12,000
Hero: posts the ante 12,000
45f2a4a4: posts small blind 40,000
Hero: posts big blind 80,000
*** HOLE CARDS ***
Dealt to 45f2a4a4 
Dealt to Hero [6c 9c]
Dealt to 5056be4e 
Dealt to c50c4803 
Dealt to 3d8f9953 
Dealt to 793d53d4 
Dealt to 4e9c4c34 
5056be4e: folds
c50c4803: folds
3d8f9953: folds
793d53d4: raises 96,000 to 176,000
4e9c4c34: calls 176,000
45f2a4a4: raises 3,553,317 to 3,729,317 and is all-in
Hero: folds
793d53d4: folds
4e9c4c34: calls 1,585,128 and is all-in
Uncalled bet (1,968,189) returned to 45f2a4a4
45f2a4a4: shows [Qh Ah]
4e9c4c34: shows [Qd Ac]
*** FLOP *** [Ts 9d As]
*** TURN *** [Ts 9d As] [5d]
*** RIVER *** [Ts 9d As 5d] [5c]
*** SHOWDOWN ***
45f2a4a4 collected 1,931,128 from pot
4e9c4c34 collected 1,931,128 from pot
*** SUMMARY ***
Total pot 3,862,256 | Rake 0 | Jackpot 0 | Bingo 0 | Fortune 0 | Tax 0
Board [Ts 9d As 5d 5c]
Seat 2: 45f2a4a4 (small blind) showed [Qh Ah] and won (1,931,128) with Pair of Aces and Pair of Fives
Seat 3: Hero (big blind) folded before Flop
Seat 4: 5056be4e folded before Flop
Seat 5: c50c4803 folded before Flop
Seat 6: 3d8f9953 folded before Flop
Seat 7: 793d53d4 folded before Flop
Seat 8: 4e9c4c34 (button) showed [Qd Ac] and won (1,931,128) with Pair of Aces and Pair of Fives


Poker Hand #TM3552712653: Tournament #156543396, Bounty Hunters Special $1.08 Hold'em No Limit - Level36(40,000/80,000) - 2024/08/05 15:12:32
Table '47' 8-max Seat #7 is the button
Seat 2: 45f2a4a4 (3,833,317 in chips)
Seat 3: Hero (2,725,573 in chips)
Seat 4: 5056be4e (630,580 in chips)
Seat 5: c50c4803 (1,358,901 in chips)
Seat 6: 3d8f9953 (1,096,408 in chips)
Seat 7: 793d53d4 (2,909,068 in chips)
Seat 8: 4e9c4c34 (1,621,128 in chips)
4e9c4c34: posts the ante 12,000
3d8f9953: posts the ante 12,000
45f2a4a4: posts the ante 12,000
5056be4e: posts the ante 12,000
c50c4803: posts the ante 12,000
793d53d4: posts the ante 12,000
Hero: posts the ante 12,000
4e9c4c34: posts small blind 40,000
45f2a4a4: posts big blind 80,000
*** HOLE CARDS ***
Dealt to 45f2a4a4 
Dealt to Hero [5c 6s]
Dealt to 5056be4e 
Dealt to c50c4803 
Dealt to 3d8f9953 
Dealt to 793d53d4 
Dealt to 4e9c4c34 
Hero: folds
5056be4e: folds
c50c4803: folds
3d8f9953: folds
793d53d4: folds
4e9c4c34: calls 40,000
45f2a4a4: checks
*** FLOP *** [9d Ad 7c]
4e9c4c34: bets 122,000
45f2a4a4: folds
Uncalled bet (122,000) returned to 4e9c4c34
*** SHOWDOWN ***
4e9c4c34 collected 244,000 from pot
*** SUMMARY ***
Total pot 244,000 | Rake 0 | Jackpot 0 | Bingo 0 | Fortune 0 | Tax 0
Board [9d Ad 7c]
Seat 2: 45f2a4a4 (big blind) folded on the Flop
Seat 3: Hero folded before Flop
Seat 4: 5056be4e folded before Flop
Seat 5: c50c4803 folded before Flop
Seat 6: 3d8f9953 folded before Flop
Seat 7: 793d53d4 (button) folded before Flop
Seat 8: 4e9c4c34 (small blind) won (244,000)


Poker Hand #TM3552712612: Tournament #156543396, Bounty Hunters Special $1.08 Hold'em No Limit - Level35(35,000/70,000) - 2024/08/05 15:11:21
Table '47' 8-max Seat #6 is the button
Seat 2: 45f2a4a4 (3,843,317 in chips)
Seat 3: Hero (2,910,573 in chips)
Seat 4: 5056be4e (640,580 in chips)
Seat 5: c50c4803 (1,368,901 in chips)
Seat 6: 3d8f9953 (1,106,408 in chips)
Seat 7: 793d53d4 (2,499,068 in chips)
Seat 8: 4e9c4c34 (1,806,128 in chips)
4e9c4c34: posts the ante 10,000
3d8f9953: posts the ante 10,000
45f2a4a4: posts the ante 10,000
5056be4e: posts the ante 10,000
c50c4803: posts the ante 10,000
793d53d4: posts the ante 10,000
Hero: posts the ante 10,000
793d53d4: posts small blind 35,000
4e9c4c34: posts big blind 70,000
*** HOLE CARDS ***
Dealt to 45f2a4a4 
Dealt to Hero [Qd As]
Dealt to 5056be4e 
Dealt to c50c4803 
Dealt to 3d8f9953 
Dealt to 793d53d4 
Dealt to 4e9c4c34 
45f2a4a4: folds
Hero: raises 105,000 to 175,000
5056be4e: folds
c50c4803: folds
3d8f9953: folds
793d53d4: calls 140,000
4e9c4c34: calls 105,000
*** FLOP *** [2s 8h 8d]
793d53d4: checks
4e9c4c34: checks
Hero: checks
*** TURN *** [2s 8h 8d] [Jd]
793d53d4: bets 196,350
4e9c4c34: folds
Hero: folds
Uncalled bet (196,350) returned to 793d53d4
*** SHOWDOWN ***
793d53d4 collected 595,000 from pot
*** SUMMARY ***
Total pot 595,000 | Rake 0 | Jackpot 0 | Bingo 0 | Fortune 0 | Tax 0
Board [2s 8h 8d Jd]
Seat 2: 45f2a4a4 folded before Flop
Seat 3: Hero folded on the Turn
Seat 4: 5056be4e folded before Flop
Seat 5: c50c4803 folded before Flop
Seat 6: 3d8f9953 (button) folded before Flop
Seat 7: 793d53d4 (small blind) won (595,000)
Seat 8: 4e9c4c34 (big blind) folded on the Turn


Poker Hand #TM3552712584: Tournament #156543396, Bounty Hunters Special $1.08 Hold'em No Limit - Level35(35,000/70,000) - 2024/08/05 15:10:28
Table '47' 8-max Seat #5 is the button
Seat 2: 45f2a4a4 (3,853,317 in chips)
Seat 3: Hero (2,920,573 in chips)
Seat 4: 5056be4e (650,580 in chips)
Seat 5: c50c4803 (1,378,901 in chips)
Seat 6: 3d8f9953 (1,256,408 in chips)
Seat 7: 793d53d4 (2,299,068 in chips)
Seat 8: 4e9c4c34 (1,816,128 in chips)
4e9c4c34: posts the ante 10,000
3d8f9953: posts the ante 10,000
45f2a4a4: posts the ante 10,000
5056be4e: posts the ante 10,000
c50c4803: posts the ante 10,000
793d53d4: posts the ante 10,000
Hero: posts the ante 10,000
3d8f9953: posts small blind 35,000
793d53d4: posts big blind 70,000
*** HOLE CARDS ***
Dealt to 45f2a4a4 
Dealt to Hero [8s Qc]
Dealt to 5056be4e 
Dealt to c50c4803 
Dealt to 3d8f9953 
Dealt to 793d53d4 
Dealt to 4e9c4c34 
4e9c4c34: folds
45f2a4a4: folds
Hero: folds
5056be4e: folds
c50c4803: folds
3d8f9953: raises 70,000 to 140,000
793d53d4: calls 70,000
*** FLOP *** [6h Kc 2c]
3d8f9953: checks
793d53d4: bets 140,000
3d8f9953: folds
Uncalled bet (140,000) returned to 793d53d4
*** SHOWDOWN ***
793d53d4 collected 350,000 from pot
*** SUMMARY ***
Total pot 350,000 | Rake 0 | Jackpot 0 | Bingo 0 | Fortune 0 | Tax 0
Board [6h Kc 2c]
Seat 2: 45f2a4a4 folded before Flop
Seat 3: Hero folded before Flop
Seat 4: 5056be4e folded before Flop
Seat 5: c50c4803 (button) folded before Flop
Seat 6: 3d8f9953 (small blind) folded on the Flop
Seat 7: 793d53d4 (big blind) won (350,000)
Seat 8: 4e9c4c34 folded before Flop


Poker Hand #TM3552712545: Tournament #156543396, Bounty Hunters Special $1.08 Hold'em No Limit - Level35(35,000/70,000) - 2024/08/05 15:09:01
Table '47' 8-max Seat #4 is the button
Seat 2: 45f2a4a4 (3,863,317 in chips)
Seat 3: Hero (3,210,573 in chips)
Seat 4: 5056be4e (660,580 in chips)
Seat 5: c50c4803 (1,423,901 in chips)
Seat 6: 3d8f9953 (881,408 in chips)
Seat 7: 793d53d4 (2,309,068 in chips)
Seat 8: 4e9c4c34 (1,826,128 in chips)
4e9c4c34: posts the ante 10,000
3d8f9953: posts the ante 10,000
45f2a4a4: posts the ante 10,000
5056be4e: posts the ante 10,000
c50c4803: posts the ante 10,000
793d53d4: posts the ante 10,000
Hero: posts the ante 10,000
c50c4803: posts small blind 35,000
3d8f9953: posts big blind 70,000
*** HOLE CARDS ***
Dealt to 45f2a4a4 
Dealt to Hero [Ac Jd]
Dealt to 5056be4e 
Dealt to c50c4803 
Dealt to 3d8f9953 
Dealt to 793d53d4 
Dealt to 4e9c4c34 
793d53d4: folds
4e9c4c34: folds
45f2a4a4: folds
Hero: raises 70,000 to 140,000
5056be4e: folds
c50c4803: folds
3d8f9953: calls 70,000
*** FLOP *** [2c Td 9d]
3d8f9953: checks
Hero: checks
*** TURN *** [2c Td 9d] [3h]
3d8f9953: bets 140,000
Hero: calls 140,000
*** RIVER *** [2c Td 9d 3h] [4d]
3d8f9953: checks
Hero: checks
3d8f9953: shows [Ts 7h] (Pair of Tens)
Hero: shows [Ac Jd] (Ace-High)
*** SHOWDOWN ***
3d8f9953 collected 665,000 from pot
*** SUMMARY ***
Total pot 665,000 | Rake 0 | Jackpot 0 | Bingo 0 | Fortune 0 | Tax 0
Board [2c Td 9d 3h 4d]
Seat 2: 45f2a4a4 folded before Flop
Seat 3: Hero showed [Ac Jd] and lost with Ace-High
Seat 4: 5056be4e (button) folded before Flop
Seat 5: c50c4803 (small blind) folded before Flop
Seat 6: 3d8f9953 (big blind) showed [Ts 7h] and won (665,000) with Pair of Tens
Seat 7: 793d53d4 folded before Flop
Seat 8: 4e9c4c34 folded before Flop


Poker Hand #TM3552712521: Tournament #156543396, Bounty Hunters Special $1.08 Hold'em No Limit - Level35(35,000/70,000) - 2024/08/05 15:08:09
Table '47' 8-max Seat #3 is the button
Seat 2: 45f2a4a4 (3,873,317 in chips)
Seat 3: Hero (2,755,423 in chips)
Seat 4: 5056be4e (705,580 in chips)
Seat 5: c50c4803 (1,503,901 in chips)
Seat 6: 3d8f9953 (891,408 in chips)
Seat 7: 793d53d4 (2,609,218 in chips)
Seat 8: 4e9c4c34 (1,836,128 in chips)
4e9c4c34: posts the ante 10,000
3d8f9953: posts the ante 10,000
45f2a4a4: posts the ante 10,000
5056be4e: posts the ante 10,000
c50c4803: posts the ante 10,000
793d53d4: posts the ante 10,000
Hero: posts the ante 10,000
5056be4e: posts small blind 35,000
c50c4803: posts big blind 70,000
*** HOLE CARDS ***
Dealt to 45f2a4a4 
Dealt to Hero [Ac Kc]
Dealt to 5056be4e 
Dealt to c50c4803 
Dealt to 3d8f9953 
Dealt to 793d53d4 
Dealt to 4e9c4c34 
3d8f9953: folds
793d53d4: raises 70,000 to 140,000
4e9c4c34: folds
45f2a4a4: folds
Hero: raises 150,150 to 290,150
5056be4e: folds
c50c4803: folds
793d53d4: calls 150,150
*** FLOP *** [4d Jd Js]
793d53d4: checks
Hero: bets 377,650
793d53d4: folds
Uncalled bet (377,650) returned to Hero
*** SHOWDOWN ***
Hero collected 755,300 from pot
*** SUMMARY ***
Total pot 755,300 | Rake 0 | Jackpot 0 | Bingo 0 | Fortune 0 | Tax 0
Board [4d Jd Js]
Seat 2: 45f2a4a4 folded before Flop
Seat 3: Hero (button) won (755,300)
Seat 4: 5056be4e (small blind) folded before Flop
Seat 5: c50c4803 (big blind) folded before Flop
Seat 6: 3d8f9953 folded before Flop
Seat 7: 793d53d4 folded on the Flop
Seat 8: 4e9c4c34 folded before Flop


Poker Hand #TM3552712492: Tournament #156543396, Bounty Hunters Special $1.08 Hold'em No Limit - Level35(35,000/70,000) - 2024/08/05 15:07:08
Table '47' 8-max Seat #2 is the button
Seat 2: 45f2a4a4 (3,883,317 in chips)
Seat 3: Hero (2,800,423 in chips)
Seat 4: 5056be4e (310,290 in chips)
Seat 5: c50c4803 (1,814,191 in chips)
Seat 6: 3d8f9953 (901,408 in chips)
Seat 7: 793d53d4 (2,619,218 in chips)
Seat 8: 4e9c4c34 (1,846,128 in chips)
4e9c4c34: posts the ante 10,000
3d8f9953: posts the ante 10,000
45f2a4a4: posts the ante 10,000
5056be4e: posts the ante 10,000
c50c4803: posts the ante 10,000
793d53d4: posts the ante 10,000
Hero: posts the ante 10,000
Hero: posts small blind 35,000
5056be4e: posts big blind 70,000
*** HOLE CARDS ***
Dealt to 45f2a4a4 
Dealt to Hero [8d Jh]
Dealt to 5056be4e 
Dealt to c50c4803 
Dealt to 3d8f9953 
Dealt to 793d53d4 
Dealt to 4e9c4c34 
c50c4803: raises 70,000 to 140,000
3d8f9953: folds
793d53d4: folds
4e9c4c34: folds
45f2a4a4: folds
Hero: folds
5056be4e: calls 70,000
*** FLOP *** [4h 4c 9c]
5056be4e: bets 160,290 and is all-in
c50c4803: calls 160,290
5056be4e: shows [5c 5h] (Pair of Fives and Pair of Fours)
c50c4803: shows [Kh Ah] (Pair of Fours)
*** TURN *** [4h 4c 9c] [8c]
*** RIVER *** [4h 4c 9c 8c] [Qc]
*** SHOWDOWN ***
5056be4e collected 705,580 from pot
*** SUMMARY ***
Total pot 705,580 | Rake 0 | Jackpot 0 | Bingo 0 | Fortune 0 | Tax 0
Board [4h 4c 9c 8c Qc]
Seat 2: 45f2a4a4 (button) folded before Flop
Seat 3: Hero (small blind) folded before Flop
Seat 4: 5056be4e (big blind) showed [5c 5h] and won (705,580) with Queen High Flush
Seat 5: c50c4803 showed [Kh Ah] and lost with Pair of Fours
Seat 6: 3d8f9953 folded before Flop
Seat 7: 793d53d4 folded before Flop
Seat 8: 4e9c4c34 folded before Flop


Poker Hand #TM3552712475: Tournament #156543396, Bounty Hunters Special $1.08 Hold'em No Limit - Level35(35,000/70,000) - 2024/08/05 15:06:31
Table '47' 8-max Seat #8 is the button
Seat 2: 45f2a4a4 (3,753,317 in chips)
Seat 3: Hero (2,880,423 in chips)
Seat 4: 5056be4e (320,290 in chips)
Seat 5: c50c4803 (1,824,191 in chips)
Seat 6: 3d8f9953 (911,408 in chips)
Seat 7: 793d53d4 (2,629,218 in chips)
Seat 8: 4e9c4c34 (1,856,128 in chips)
4e9c4c34: posts the ante 10,000
3d8f9953: posts the ante 10,000
45f2a4a4: posts the ante 10,000
5056be4e: posts the ante 10,000
c50c4803: posts the ante 10,000
793d53d4: posts the ante 10,000
Hero: posts the ante 10,000
45f2a4a4: posts small blind 35,000
Hero: posts big blind 70,000
*** HOLE CARDS ***
Dealt to 45f2a4a4 
Dealt to Hero [Jc 2h]
Dealt to 5056be4e 
Dealt to c50c4803 
Dealt to 3d8f9953 
Dealt to 793d53d4 
Dealt to 4e9c4c34 
5056be4e: folds
c50c4803: folds
3d8f9953: folds
793d53d4: folds
4e9c4c34: folds
45f2a4a4: raises 175,000 to 245,000
Hero: folds
Uncalled bet (175,000) returned to 45f2a4a4
*** SHOWDOWN ***
45f2a4a4 collected 210,000 from pot
*** SUMMARY ***
Total pot 210,000 | Rake 0 | Jackpot 0 | Bingo 0 | Fortune 0 | Tax 0
Seat 2: 45f2a4a4 (small blind) collected (210,000)
Seat 3: Hero (big blind) folded before Flop
Seat 4: 5056be4e folded before Flop
Seat 5: c50c4803 folded before Flop
Seat 6: 3d8f9953 folded before Flop
Seat 7: 793d53d4 folded before Flop
Seat 8: 4e9c4c34 (button) folded before Flop


Poker Hand #TM3552712466: Tournament #156543396, Bounty Hunters Special $1.08 Hold'em No Limit - Level35(35,000/70,000) - 2024/08/05 15:06:07
Table '47' 8-max Seat #7 is the button
Seat 2: 45f2a4a4 (3,658,317 in chips)
Seat 3: Hero (2,890,423 in chips)
Seat 4: 5056be4e (330,290 in chips)
Seat 5: c50c4803 (1,834,191 in chips)
Seat 6: 3d8f9953 (921,408 in chips)
Seat 7: 793d53d4 (2,639,218 in chips)
Seat 8: 4e9c4c34 (1,901,128 in chips)
4e9c4c34: posts the ante 10,000
3d8f9953: posts the ante 10,000
45f2a4a4: posts the ante 10,000
5056be4e: posts the ante 10,000
c50c4803: posts the ante 10,000
793d53d4: posts the ante 10,000
Hero: posts the ante 10,000
4e9c4c34: posts small blind 35,000
45f2a4a4: posts big blind 70,000
*** HOLE CARDS ***
Dealt to 45f2a4a4 
Dealt to Hero [Qd 9s]
Dealt to 5056be4e 
Dealt to c50c4803 
Dealt to 3d8f9953 
Dealt to 793d53d4 
Dealt to 4e9c4c34 
Hero: folds
5056be4e: folds
c50c4803: folds
3d8f9953: folds
793d53d4: folds
4e9c4c34: folds
Uncalled bet (35,000) returned to 45f2a4a4
*** SHOWDOWN ***
45f2a4a4 collected 140,000 from pot
*** SUMMARY ***
Total pot 140,000 | Rake 0 | Jackpot 0 | Bingo 0 | Fortune 0 | Tax 0
Seat 2: 45f2a4a4 (big blind) collected (140,000)
Seat 3: Hero folded before Flop
Seat 4: 5056be4e folded before Flop
Seat 5: c50c4803 folded before Flop
Seat 6: 3d8f9953 folded before Flop
Seat 7: 793d53d4 (button) folded before Flop
Seat 8: 4e9c4c34 (small blind) folded before Flop


Poker Hand #TM3552712430: Tournament #156543396, Bounty Hunters Special $1.08 Hold'em No Limit - Level35(35,000/70,000) - 2024/08/05 15:04:47
Table '47' 8-max Seat #5 is the button
Seat 2: 45f2a4a4 (3,668,317 in chips)
Seat 3: Hero (2,900,423 in chips)
Seat 4: 5056be4e (340,290 in chips)
Seat 5: c50c4803 (1,844,191 in chips)
Seat 7: 793d53d4 (3,036,218 in chips)
Seat 8: 4e9c4c34 (1,464,128 in chips)
4e9c4c34: posts the ante 10,000
45f2a4a4: posts the ante 10,000
5056be4e: posts the ante 10,000
c50c4803: posts the ante 10,000
793d53d4: posts the ante 10,000
Hero: posts the ante 10,000
793d53d4: posts small blind 35,000
4e9c4c34: posts big blind 70,000
*** HOLE CARDS ***
Dealt to 45f2a4a4 
Dealt to Hero [Kd 5d]
Dealt to 5056be4e 
Dealt to c50c4803 
Dealt to 793d53d4 
Dealt to 4e9c4c34 
45f2a4a4: folds
Hero: folds
5056be4e: folds
c50c4803: folds
793d53d4: calls 35,000
4e9c4c34: checks
*** FLOP *** [Qc Tc Jh]
793d53d4: checks
4e9c4c34: checks
*** TURN *** [Qc Tc Jh] [Th]
793d53d4: bets 100,000
4e9c4c34: calls 100,000
*** RIVER *** [Qc Tc Jh Th] [Td]
793d53d4: bets 217,000
4e9c4c34: calls 217,000
793d53d4: shows [6s 8h] (Three Tens)
4e9c4c34: shows [Qs 5s] (Tens Full over Queens)
*** SHOWDOWN ***
4e9c4c34 collected 834,000 from pot
*** SUMMARY ***
Total pot 834,000 | Rake 0 | Jackpot 0 | Bingo 0 | Fortune 0 | Tax 0
Board [Qc Tc Jh Th Td]
Seat 2: 45f2a4a4 folded before Flop
Seat 3: Hero folded before Flop
Seat 4: 5056be4e folded before Flop
Seat 5: c50c4803 (button) folded before Flop
Seat 7: 793d53d4 (small blind) showed [6s 8h] and lost with Three Tens
Seat 8: 4e9c4c34 (big blind) showed [Qs 5s] and won (834,000) with Tens Full over Queens


Poker Hand #TM3552712387: Tournament #156543396, Bounty Hunters Special $1.08 Hold'em No Limit - Level34(30,000/60,000) - 2024/08/05 15:03:01
Table '47' 8-max Seat #4 is the button
Seat 2: 45f2a4a4 (3,677,317 in chips)
Seat 3: Hero (2,909,423 in chips)
Seat 4: 5056be4e (349,290 in chips)
Seat 5: c50c4803 (915,051 in chips)
Seat 6: 892eb287 (884,140 in chips)
Seat 7: 793d53d4 (3,045,218 in chips)
Seat 8: 4e9c4c34 (1,473,128 in chips)
4e9c4c34: posts the ante 9,000
45f2a4a4: posts the ante 9,000
5056be4e: posts the ante 9,000
c50c4803: posts the ante 9,000
793d53d4: posts the ante 9,000
Hero: posts the ante 9,000
892eb287: posts the ante 9,000
c50c4803: posts small blind 30,000
892eb287: posts big blind 60,000
*** HOLE CARDS ***
Dealt to 45f2a4a4 
Dealt to Hero [7s Jh]
Dealt to 5056be4e 
Dealt to c50c4803 
Dealt to 892eb287 
Dealt to 793d53d4 
Dealt to 4e9c4c34 
793d53d4: folds
4e9c4c34: folds
45f2a4a4: folds
Hero: folds
5056be4e: folds
c50c4803: raises 60,000 to 120,000
892eb287: calls 60,000
*** FLOP *** [7c Ah 9h]
c50c4803: bets 120,000
892eb287: calls 120,000
*** TURN *** [7c Ah 9h] [Qc]
c50c4803: bets 180,000
892eb287: calls 180,000
*** RIVER *** [7c Ah 9h Qc] [9c]
c50c4803: checks
892eb287: bets 455,140 and is all-in
c50c4803: calls 455,140
892eb287: shows [8s Td] (Pair of Nines)
c50c4803: shows [Ac 2h] (Pair of Aces and Pair of Nines)
*** SHOWDOWN ***
c50c4803 collected 1,813,280 from pot
*** SUMMARY ***
Total pot 1,813,280 | Rake 0 | Jackpot 0 | Bingo 0 | Fortune 0 | Tax 0
Board [7c Ah 9h Qc 9c]
Seat 2: 45f2a4a4 folded before Flop
Seat 3: Hero folded before Flop
Seat 4: 5056be4e (button) folded before Flop
Seat 5: c50c4803 (small blind) showed [Ac 2h] and won (1,813,280) with Pair of Aces and Pair of Nines
Seat 6: 892eb287 (big blind) showed [8s Td] and lost with Pair of Nines
Seat 7: 793d53d4 folded before Flop
Seat 8: 4e9c4c34 folded before Flop


Poker Hand #TM3552712357: Tournament #156543396, Bounty Hunters Special $1.08 Hold'em No Limit - Level34(30,000/60,000) - 2024/08/05 15:01:57
Table '47' 8-max Seat #3 is the button
Seat 1: 70f690a3 (518,016 in chips)
Seat 2: 45f2a4a4 (3,015,301 in chips)
Seat 3: Hero (2,918,423 in chips)
Seat 4: 5056be4e (388,290 in chips)
Seat 5: c50c4803 (984,051 in chips)
Seat 6: 892eb287 (893,140 in chips)
Seat 7: 793d53d4 (3,054,218 in chips)
Seat 8: 4e9c4c34 (1,482,128 in chips)
4e9c4c34: posts the ante 9,000
45f2a4a4: posts the ante 9,000
70f690a3: posts the ante 9,000
5056be4e: posts the ante 9,000
c50c4803: posts the ante 9,000
793d53d4: posts the ante 9,000
Hero: posts the ante 9,000
892eb287: posts the ante 9,000
5056be4e: posts small blind 30,000
c50c4803: posts big blind 60,000
*** HOLE CARDS ***
Dealt to 70f690a3 
Dealt to 45f2a4a4 
Dealt to Hero [5d Th]
Dealt to 5056be4e 
Dealt to c50c4803 
Dealt to 892eb287 
Dealt to 793d53d4 
Dealt to 4e9c4c34 
892eb287: folds
793d53d4: folds
4e9c4c34: folds
70f690a3: raises 449,016 to 509,016 and is all-in
45f2a4a4: calls 509,016
Hero: folds
5056be4e: folds
c50c4803: folds
70f690a3: shows [Ah Kc]
45f2a4a4: shows [9d Td]
*** FLOP *** [5c 6h 9s]
*** TURN *** [5c 6h 9s] [8c]
*** RIVER *** [5c 6h 9s 8c] [Qs]
*** SHOWDOWN ***
45f2a4a4 collected 1,180,032 from pot
*** SUMMARY ***
Total pot 1,180,032 | Rake 0 | Jackpot 0 | Bingo 0 | Fortune 0 | Tax 0
Board [5c 6h 9s 8c Qs]
Seat 1: 70f690a3 showed [Ah Kc] and lost with Ace-High
Seat 2: 45f2a4a4 showed [9d Td] and won (1,180,032) with Pair of Nines
Seat 3: Hero (button) folded before Flop
Seat 4: 5056be4e (small blind) folded before Flop
Seat 5: c50c4803 (big blind) folded before Flop
Seat 6: 892eb287 folded before Flop
Seat 7: 793d53d4 folded before Flop
Seat 8: 4e9c4c34 folded before Flop


Poker Hand #TM3552712349: Tournament #156543396, Bounty Hunters Special $1.08 Hold'em No Limit - Level34(30,000/60,000) - 2024/08/05 15:00:56
Table '47' 8-max Seat #2 is the button
Seat 1: 70f690a3 (587,016 in chips)
Seat 2: 45f2a4a4 (2,820,301 in chips)
Seat 3: Hero (2,957,423 in chips)
Seat 4: 5056be4e (457,290 in chips)
Seat 6: 892eb287 (902,140 in chips)
Seat 7: 793d53d4 (3,063,218 in chips)
45f2a4a4: posts the ante 9,000
70f690a3: posts the ante 9,000
5056be4e: posts the ante 9,000
793d53d4: posts the ante 9,000
892eb287: posts the ante 9,000
Hero: posts the ante 9,000
Hero: posts small blind 30,000
5056be4e: posts big blind 60,000
*** HOLE CARDS ***
Dealt to 70f690a3 
Dealt to 45f2a4a4 
Dealt to Hero [4d 3d]
Dealt to 5056be4e 
Dealt to 892eb287 
Dealt to 793d53d4 
892eb287: folds
793d53d4: folds
70f690a3: calls 60,000
45f2a4a4: raises 2,751,301 to 2,811,301 and is all-in
Hero: folds
5056be4e: folds
70f690a3: folds
Uncalled bet (2,751,301) returned to 45f2a4a4
*** SHOWDOWN ***
45f2a4a4 collected 264,000 from pot
*** SUMMARY ***
Total pot 264,000 | Rake 0 | Jackpot 0 | Bingo 0 | Fortune 0 | Tax 0
Seat 1: 70f690a3 folded before Flop
Seat 2: 45f2a4a4 (button) collected (264,000)
Seat 3: Hero (small blind) folded before Flop
Seat 4: 5056be4e (big blind) folded before Flop
Seat 6: 892eb287 folded before Flop
Seat 7: 793d53d4 folded before Flop


Poker Hand #TM3552712335: Tournament #156543396, Bounty Hunters Special $1.08 Hold'em No Limit - Level34(30,000/60,000) - 2024/08/05 14:54:45
Table '47' 8-max Seat #1 is the button
Seat 1: 70f690a3 (596,016 in chips)
Seat 2: 45f2a4a4 (3,225,721 in chips)
Seat 3: Hero (2,516,003 in chips)
Seat 4: 5056be4e (466,290 in chips)
Seat 6: 892eb287 (911,140 in chips)
Seat 7: 793d53d4 (3,072,218 in chips)
70f690a3: posts the ante 9,000
45f2a4a4: posts the ante 9,000
5056be4e: posts the ante 9,000
793d53d4: posts the ante 9,000
892eb287: posts the ante 9,000
Hero: posts the ante 9,000
45f2a4a4: posts small blind 30,000
Hero: posts big blind 60,000
*** HOLE CARDS ***
Dealt to 70f690a3 
Dealt to 45f2a4a4 
Dealt to Hero [Ks Td]
Dealt to 5056be4e 
Dealt to 892eb287 
Dealt to 793d53d4 
5056be4e: folds
892eb287: folds
793d53d4: folds
70f690a3: folds
45f2a4a4: raises 150,000 to 210,000
Hero: calls 150,000
*** FLOP *** [Ac 9h Kd]
45f2a4a4: bets 186,420
Hero: raises 186,420 to 372,840
45f2a4a4: folds
Uncalled bet (186,420) returned to Hero
*** SHOWDOWN ***
Hero collected 846,840 from pot
*** SUMMARY ***
Total pot 846,840 | Rake 0 | Jackpot 0 | Bingo 0 | Fortune 0 | Tax 0
Board [Ac 9h Kd]
Seat 1: 70f690a3 (button) folded before Flop
Seat 2: 45f2a4a4 (small blind) folded on the Flop
Seat 3: Hero (big blind) won (846,840)
Seat 4: 5056be4e folded before Flop
Seat 6: 892eb287 folded before Flop
Seat 7: 793d53d4 folded before Flop


Poker Hand #TM3552712321: Tournament #156543396, Bounty Hunters Special $1.08 Hold'em No Limit - Level34(30,000/60,000) - 2024/08/05 14:54:11
Table '47' 8-max Seat #7 is the button
Seat 1: 70f690a3 (635,016 in chips)
Seat 2: 45f2a4a4 (3,150,721 in chips)
Seat 3: Hero (2,525,003 in chips)
Seat 4: 5056be4e (475,290 in chips)
Seat 6: 892eb287 (920,140 in chips)
Seat 7: 793d53d4 (3,081,218 in chips)
45f2a4a4: posts the ante 9,000
70f690a3: posts the ante 9,000
5056be4e: posts the ante 9,000
793d53d4: posts the ante 9,000
892eb287: posts the ante 9,000
Hero: posts the ante 9,000
70f690a3: posts small blind 30,000
45f2a4a4: posts big blind 60,000
*** HOLE CARDS ***
Dealt to 70f690a3 
Dealt to 45f2a4a4 
Dealt to Hero [7c Kd]
Dealt to 5056be4e 
Dealt to 892eb287 
Dealt to 793d53d4 
Hero: folds
5056be4e: folds
892eb287: folds
793d53d4: folds
70f690a3: folds
Uncalled bet (30,000) returned to 45f2a4a4
*** SHOWDOWN ***
45f2a4a4 collected 114,000 from pot
*** SUMMARY ***
Total pot 114,000 | Rake 0 | Jackpot 0 | Bingo 0 | Fortune 0 | Tax 0
Seat 1: 70f690a3 (small blind) folded before Flop
Seat 2: 45f2a4a4 (big blind) collected (114,000)
Seat 3: Hero folded before Flop
Seat 4: 5056be4e folded before Flop
Seat 6: 892eb287 folded before Flop
Seat 7: 793d53d4 (button) folded before Flop


Poker Hand #TM3552712301: Tournament #156543396, Bounty Hunters Special $1.08 Hold'em No Limit - Level34(30,000/60,000) - 2024/08/05 14:53:29
Table '47' 8-max Seat #6 is the button
Seat 1: 70f690a3 (704,016 in chips)
Seat 2: 45f2a4a4 (3,159,721 in chips)
Seat 3: Hero (2,390,003 in chips)
Seat 4: 5056be4e (484,290 in chips)
Seat 6: 892eb287 (929,140 in chips)
Seat 7: 793d53d4 (3,120,218 in chips)
45f2a4a4: posts the ante 9,000
70f690a3: posts the ante 9,000
5056be4e: posts the ante 9,000
793d53d4: posts the ante 9,000
892eb287: posts the ante 9,000
Hero: posts the ante 9,000
793d53d4: posts small blind 30,000
70f690a3: posts big blind 60,000
*** HOLE CARDS ***
Dealt to 70f690a3 
Dealt to 45f2a4a4 
Dealt to Hero [Qh Th]
Dealt to 5056be4e 
Dealt to 892eb287 
Dealt to 793d53d4 
45f2a4a4: folds
Hero: raises 90,000 to 150,000
5056be4e: folds
892eb287: folds
793d53d4: folds
70f690a3: folds
Uncalled bet (90,000) returned to Hero
*** SHOWDOWN ***
Hero collected 204,000 from pot
*** SUMMARY ***
Total pot 204,000 | Rake 0 | Jackpot 0 | Bingo 0 | Fortune 0 | Tax 0
Seat 1: 70f690a3 (big blind) folded before Flop
Seat 2: 45f2a4a4 folded before Flop
Seat 3: Hero collected (204,000)
Seat 4: 5056be4e folded before Flop
Seat 6: 892eb287 (button) folded before Flop
Seat 7: 793d53d4 (small blind) folded before Flop


Poker Hand #TM3552712265: Tournament #156543396, Bounty Hunters Special $1.08 Hold'em No Limit - Level34(30,000/60,000) - 2024/08/05 14:52:21
Table '47' 8-max Seat #4 is the button
Seat 1: 70f690a3 (713,016 in chips)
Seat 2: 45f2a4a4 (3,168,721 in chips)
Seat 3: Hero (2,399,003 in chips)
Seat 4: 5056be4e (493,290 in chips)
Seat 5: 296e9e62 (321,320 in chips)
Seat 6: 892eb287 (998,140 in chips)
Seat 7: 793d53d4 (2,693,898 in chips)
45f2a4a4: posts the ante 9,000
70f690a3: posts the ante 9,000
5056be4e: posts the ante 9,000
296e9e62: posts the ante 9,000
793d53d4: posts the ante 9,000
Hero: posts the ante 9,000
892eb287: posts the ante 9,000
296e9e62: posts small blind 30,000
892eb287: posts big blind 60,000
*** HOLE CARDS ***
Dealt to 70f690a3 
Dealt to 45f2a4a4 
Dealt to Hero [3c Jd]
Dealt to 5056be4e 
Dealt to 296e9e62 
Dealt to 892eb287 
Dealt to 793d53d4 
793d53d4: raises 60,000 to 120,000
70f690a3: folds
45f2a4a4: folds
Hero: folds
5056be4e: folds
296e9e62: raises 192,320 to 312,320 and is all-in
892eb287: folds
793d53d4: calls 192,320
296e9e62: shows [Th Ts]
793d53d4: shows [Jc Js]
*** FLOP *** [4d Ac 3h]
*** TURN *** [4d Ac 3h] [Qs]
*** RIVER *** [4d Ac 3h Qs] [9d]
Hero: shows [Jd] (Ace-High)
*** SHOWDOWN ***
793d53d4 collected 747,640 from pot
*** SUMMARY ***
Total pot 747,640 | Rake 0 | Jackpot 0 | Bingo 0 | Fortune 0 | Tax 0
Board [4d Ac 3h Qs 9d]
Seat 1: 70f690a3 folded before Flop
Seat 2: 45f2a4a4 folded before Flop
Seat 3: Hero folded before Flop
Seat 4: 5056be4e (button) folded before Flop
Seat 5: 296e9e62 (small blind) showed [Th Ts] and lost with Pair of Tens
Seat 6: 892eb287 (big blind) folded before Flop
Seat 7: 793d53d4 showed [Jc Js] and won (747,640) with Pair of Jacks


Poker Hand #TM3552712223: Tournament #156543396, Bounty Hunters Special $1.08 Hold'em No Limit - Level34(30,000/60,000) - 2024/08/05 14:50:58
Table '47' 8-max Seat #3 is the button
Seat 1: 70f690a3 (722,016 in chips)
Seat 2: 45f2a4a4 (3,177,721 in chips)
Seat 3: Hero (2,408,003 in chips)
Seat 4: 5056be4e (532,290 in chips)
Seat 5: 296e9e62 (390,320 in chips)
Seat 6: 892eb287 (854,140 in chips)
Seat 7: 793d53d4 (2,702,898 in chips)
45f2a4a4: posts the ante 9,000
70f690a3: posts the ante 9,000
5056be4e: posts the ante 9,000
296e9e62: posts the ante 9,000
793d53d4: posts the ante 9,000
Hero: posts the ante 9,000
892eb287: posts the ante 9,000
5056be4e: posts small blind 30,000
296e9e62: posts big blind 60,000
*** HOLE CARDS ***
Dealt to 70f690a3 
Dealt to 45f2a4a4 
Dealt to Hero [9h Kh]
Dealt to 5056be4e 
Dealt to 296e9e62 
Dealt to 892eb287 
Dealt to 793d53d4 
892eb287: raises 78,000 to 138,000
793d53d4: folds
70f690a3: folds
45f2a4a4: folds
Hero: folds
5056be4e: folds
296e9e62: folds
Uncalled bet (78,000) returned to 892eb287
892eb287: shows [9s 9c]
*** SHOWDOWN ***
892eb287 collected 213,000 from pot
*** SUMMARY ***
Total pot 213,000 | Rake 0 | Jackpot 0 | Bingo 0 | Fortune 0 | Tax 0
Seat 1: 70f690a3 folded before Flop
Seat 2: 45f2a4a4 folded before Flop
Seat 3: Hero (button) folded before Flop
Seat 4: 5056be4e (small blind) folded before Flop
Seat 5: 296e9e62 (big blind) folded before Flop
Seat 6: 892eb287 showed [9s 9c] and collected (213,000)
Seat 7: 793d53d4 folded before Flop


Poker Hand #TM3552712201: Tournament #156543396, Bounty Hunters Special $1.08 Hold'em No Limit - Level33(25,000/50,000) - 2024/08/05 14:49:54
Table '47' 8-max Seat #2 is the button
Seat 1: 70f690a3 (729,516 in chips)
Seat 2: 45f2a4a4 (3,185,221 in chips)
Seat 3: Hero (2,515,503 in chips)
Seat 4: 5056be4e (589,790 in chips)
Seat 5: 296e9e62 (397,820 in chips)
Seat 6: 892eb287 (861,640 in chips)
Seat 7: 793d53d4 (2,507,898 in chips)
45f2a4a4: posts the ante 7,500
70f690a3: posts the ante 7,500
5056be4e: posts the ante 7,500
296e9e62: posts the ante 7,500
793d53d4: posts the ante 7,500
892eb287: posts the ante 7,500
Hero: posts the ante 7,500
Hero: posts small blind 25,000
5056be4e: posts big blind 50,000
*** HOLE CARDS ***
Dealt to 70f690a3 
Dealt to 45f2a4a4 
Dealt to Hero [9c Ac]
Dealt to 5056be4e 
Dealt to 296e9e62 
Dealt to 892eb287 
Dealt to 793d53d4 
296e9e62: folds
892eb287: folds
793d53d4: raises 50,000 to 100,000
70f690a3: folds
45f2a4a4: folds
Hero: calls 75,000
5056be4e: folds
*** FLOP *** [Jd 2s 4d]
Hero: checks
793d53d4: bets 99,825
Hero: folds
Uncalled bet (99,825) returned to 793d53d4
*** SHOWDOWN ***
793d53d4 collected 302,500 from pot
*** SUMMARY ***
Total pot 302,500 | Rake 0 | Jackpot 0 | Bingo 0 | Fortune 0 | Tax 0
Board [Jd 2s 4d]
Seat 1: 70f690a3 folded before Flop
Seat 2: 45f2a4a4 (button) folded before Flop
Seat 3: Hero (small blind) folded on the Flop
Seat 4: 5056be4e (big blind) folded before Flop
Seat 5: 296e9e62 folded before Flop
Seat 6: 892eb287 folded before Flop
Seat 7: 793d53d4 won (302,500)


Poker Hand #TM3552712179: Tournament #156543396, Bounty Hunters Special $1.08 Hold'em No Limit - Level33(25,000/50,000) - 2024/08/05 14:48:59
Table '47' 8-max Seat #1 is the button
Seat 1: 70f690a3 (737,016 in chips)
Seat 2: 45f2a4a4 (3,340,381 in chips)
Seat 3: Hero (2,573,003 in chips)
Seat 4: 5056be4e (597,290 in chips)
Seat 5: 296e9e62 (155,160 in chips)
Seat 6: 892eb287 (869,140 in chips)
Seat 7: 793d53d4 (2,515,398 in chips)
70f690a3: posts the ante 7,500
45f2a4a4: posts the ante 7,500
5056be4e: posts the ante 7,500
296e9e62: posts the ante 7,500
793d53d4: posts the ante 7,500
892eb287: posts the ante 7,500
Hero: posts the ante 7,500
45f2a4a4: posts small blind 25,000
Hero: posts big blind 50,000
*** HOLE CARDS ***
Dealt to 70f690a3 
Dealt to 45f2a4a4 
Dealt to Hero [8c 6d]
Dealt to 5056be4e 
Dealt to 296e9e62 
Dealt to 892eb287 
Dealt to 793d53d4 
5056be4e: folds
296e9e62: raises 97,660 to 147,660 and is all-in
892eb287: folds
793d53d4: folds
70f690a3: folds
45f2a4a4: raises 3,185,221 to 3,332,881 and is all-in
Hero: folds
Uncalled bet (3,185,221) returned to 45f2a4a4
45f2a4a4: shows [7h 7c]
296e9e62: shows [Ad Tc]
*** FLOP *** [Ts Js Qs]
*** TURN *** [Ts Js Qs] [2d]
*** RIVER *** [Ts Js Qs 2d] [2h]
*** SHOWDOWN ***
296e9e62 collected 397,820 from pot
*** SUMMARY ***
Total pot 397,820 | Rake 0 | Jackpot 0 | Bingo 0 | Fortune 0 | Tax 0
Board [Ts Js Qs 2d 2h]
Seat 1: 70f690a3 (button) folded before Flop
Seat 2: 45f2a4a4 (small blind) showed [7h 7c] and lost with Pair of Sevens and Pair of Twos
Seat 3: Hero (big blind) folded before Flop
Seat 4: 5056be4e folded before Flop
Seat 5: 296e9e62 showed [Ad Tc] and won (397,820) with Pair of Tens and Pair of Twos
Seat 6: 892eb287 folded before Flop
Seat 7: 793d53d4 folded before Flop


Poker Hand #TM3552712156: Tournament #156543396, Bounty Hunters Special $1.08 Hold'em No Limit - Level33(25,000/50,000) - 2024/08/05 14:47:44
Table '47' 8-max Seat #7 is the button
Seat 1: 70f690a3 (349,758 in chips)
Seat 2: 45f2a4a4 (3,690,139 in chips)
Seat 3: Hero (2,580,503 in chips)
Seat 4: 5056be4e (604,790 in chips)
Seat 5: 296e9e62 (162,660 in chips)
Seat 6: 892eb287 (876,640 in chips)
Seat 7: 793d53d4 (2,522,898 in chips)
45f2a4a4: posts the ante 7,500
70f690a3: posts the ante 7,500
5056be4e: posts the ante 7,500
296e9e62: posts the ante 7,500
793d53d4: posts the ante 7,500
892eb287: posts the ante 7,500
Hero: posts the ante 7,500
70f690a3: posts small blind 25,000
45f2a4a4: posts big blind 50,000
*** HOLE CARDS ***
Dealt to 70f690a3 
Dealt to 45f2a4a4 
Dealt to Hero [Jh 5c]
Dealt to 5056be4e 
Dealt to 296e9e62 
Dealt to 892eb287 
Dealt to 793d53d4 
Hero: folds
5056be4e: folds
296e9e62: folds
892eb287: folds
793d53d4: folds
70f690a3: raises 292,258 to 342,258 and is all-in
45f2a4a4: calls 292,258
70f690a3: shows [As Th]
45f2a4a4: shows [Kd 6s]
*** FLOP *** [2s 9s Qd]
*** TURN *** [2s 9s Qd] [Qs]
*** RIVER *** [2s 9s Qd Qs] [Jd]
*** SHOWDOWN ***
70f690a3 collected 737,016 from pot
*** SUMMARY ***
Total pot 737,016 | Rake 0 | Jackpot 0 | Bingo 0 | Fortune 0 | Tax 0
Board [2s 9s Qd Qs Jd]
Seat 1: 70f690a3 (small blind) showed [As Th] and won (737,016) with Pair of Queens
Seat 2: 45f2a4a4 (big blind) showed [Kd 6s] and lost with Pair of Queens
Seat 3: Hero folded before Flop
Seat 4: 5056be4e folded before Flop
Seat 5: 296e9e62 folded before Flop
Seat 6: 892eb287 folded before Flop
Seat 7: 793d53d4 (button) folded before Flop


Poker Hand #TM3552712113: Tournament #156543396, Bounty Hunters Special $1.08 Hold'em No Limit - Level33(25,000/50,000) - 2024/08/05 14:46:05
Table '47' 8-max Seat #6 is the button
Seat 1: 70f690a3 (584,158 in chips)
Seat 2: 45f2a4a4 (3,697,639 in chips)
Seat 3: Hero (2,588,003 in chips)
Seat 4: 5056be4e (612,290 in chips)
Seat 5: 296e9e62 (170,160 in chips)
Seat 6: 892eb287 (884,140 in chips)
Seat 7: 793d53d4 (2,250,998 in chips)
45f2a4a4: posts the ante 7,500
70f690a3: posts the ante 7,500
5056be4e: posts the ante 7,500
296e9e62: posts the ante 7,500
793d53d4: posts the ante 7,500
892eb287: posts the ante 7,500
Hero: posts the ante 7,500
793d53d4: posts small blind 25,000
70f690a3: posts big blind 50,000
*** HOLE CARDS ***
Dealt to 70f690a3 
Dealt to 45f2a4a4 
Dealt to Hero [As 3s]
Dealt to 5056be4e 
Dealt to 296e9e62 
Dealt to 892eb287 
Dealt to 793d53d4 
45f2a4a4: folds
Hero: folds
5056be4e: folds
296e9e62: folds
892eb287: folds
793d53d4: calls 25,000
70f690a3: checks
*** FLOP *** [6s Ks 2h]
793d53d4: bets 50,325
70f690a3: calls 50,325
*** TURN *** [6s Ks 2h] [9s]
793d53d4: bets 126,575
70f690a3: calls 126,575
*** RIVER *** [6s Ks 2h 9s] [4s]
793d53d4: checks
70f690a3: checks
793d53d4: shows [7s 8s] (King High Flush)
70f690a3: shows [Ad 9c] (Pair of Nines)
Hero: shows [As] (Ace High Flush)
*** SHOWDOWN ***
793d53d4 collected 506,300 from pot
*** SUMMARY ***
Total pot 506,300 | Rake 0 | Jackpot 0 | Bingo 0 | Fortune 0 | Tax 0
Board [6s Ks 2h 9s 4s]
Seat 1: 70f690a3 (big blind) showed [Ad 9c] and lost with Pair of Nines
Seat 2: 45f2a4a4 folded before Flop
Seat 3: Hero folded before Flop
Seat 4: 5056be4e folded before Flop
Seat 5: 296e9e62 folded before Flop
Seat 6: 892eb287 (button) folded before Flop
Seat 7: 793d53d4 (small blind) showed [7s 8s] and won (506,300) with King High Flush


Poker Hand #TM3552712085: Tournament #156543396, Bounty Hunters Special $1.08 Hold'em No Limit - Level33(25,000/50,000) - 2024/08/05 14:45:00
Table '47' 8-max Seat #5 is the button
Seat 1: 70f690a3 (591,658 in chips)
Seat 2: 45f2a4a4 (3,705,139 in chips)
Seat 3: Hero (2,595,503 in chips)
Seat 5: 296e9e62 (177,660 in chips)
Seat 6: 892eb287 (796,640 in chips)
Seat 7: 793d53d4 (2,308,498 in chips)
45f2a4a4: posts the ante 7,500
70f690a3: posts the ante 7,500
296e9e62: posts the ante 7,500
793d53d4: posts the ante 7,500
Hero: posts the ante 7,500
892eb287: posts the ante 7,500
892eb287: posts small blind 25,000
793d53d4: posts big blind 50,000
*** HOLE CARDS ***
Dealt to 70f690a3 
Dealt to 45f2a4a4 
Dealt to Hero [2d 2s]
Dealt to 296e9e62 
Dealt to 892eb287 
Dealt to 793d53d4 
70f690a3: folds
45f2a4a4: folds
Hero: folds
296e9e62: folds
892eb287: raises 739,140 to 789,140 and is all-in
793d53d4: folds
Uncalled bet (739,140) returned to 892eb287
*** SHOWDOWN ***
892eb287 collected 145,000 from pot
*** SUMMARY ***
Total pot 145,000 | Rake 0 | Jackpot 0 | Bingo 0 | Fortune 0 | Tax 0
Seat 1: 70f690a3 folded before Flop
Seat 2: 45f2a4a4 folded before Flop
Seat 3: Hero folded before Flop
Seat 5: 296e9e62 (button) folded before Flop
Seat 6: 892eb287 (small blind) collected (145,000)
Seat 7: 793d53d4 (big blind) folded before Flop


Poker Hand #TM3552712005: Tournament #156543396, Bounty Hunters Special $1.08 Hold'em No Limit - Level32(20,000/40,000) - 2024/08/05 14:41:39
Table '47' 8-max Seat #3 is the button
Seat 1: 70f690a3 (597,658 in chips)
Seat 2: 45f2a4a4 (3,952,139 in chips)
Seat 3: Hero (2,601,503 in chips)
Seat 4: 37ff5d80 (456,906 in chips)
Seat 5: 296e9e62 (223,660 in chips)
Seat 6: 892eb287 (802,640 in chips)
Seat 7: 793d53d4 (1,540,592 in chips)
45f2a4a4: posts the ante 6,000
70f690a3: posts the ante 6,000
37ff5d80: posts the ante 6,000
296e9e62: posts the ante 6,000
793d53d4: posts the ante 6,000
Hero: posts the ante 6,000
892eb287: posts the ante 6,000
37ff5d80: posts small blind 20,000
296e9e62: posts big blind 40,000
*** HOLE CARDS ***
Dealt to 70f690a3 
Dealt to 45f2a4a4 
Dealt to Hero [5h 6c]
Dealt to 37ff5d80 
Dealt to 296e9e62 
Dealt to 892eb287 
Dealt to 793d53d4 
892eb287: folds
793d53d4: raises 40,000 to 80,000
70f690a3: folds
45f2a4a4: calls 80,000
Hero: folds
37ff5d80: calls 60,000
296e9e62: folds
*** FLOP *** [5c Qh 9s]
37ff5d80: bets 161,000
793d53d4: calls 161,000
45f2a4a4: calls 161,000
*** TURN *** [5c Qh 9s] [3h]
37ff5d80: bets 209,906 and is all-in
793d53d4: raises 404,188 to 614,094
45f2a4a4: folds
Uncalled bet (404,188) returned to 793d53d4
793d53d4: shows [Qd 9d] (Pair of Queens and Pair of Nines)
37ff5d80: shows [Kh Qc] (Pair of Queens)
*** RIVER *** [5c Qh 9s 3h] [8d]
*** SHOWDOWN ***
793d53d4 collected 1,224,812 from pot
*** SUMMARY ***
Total pot 1,224,812 | Rake 0 | Jackpot 0 | Bingo 0 | Fortune 0 | Tax 0
Board [5c Qh 9s 3h 8d]
Seat 1: 70f690a3 folded before Flop
Seat 2: 45f2a4a4 folded on the Turn
Seat 3: Hero (button) folded before Flop
Seat 4: 37ff5d80 (small blind) showed [Kh Qc] and lost with Pair of Queens
Seat 5: 296e9e62 (big blind) folded before Flop
Seat 6: 892eb287 folded before Flop
Seat 7: 793d53d4 showed [Qd 9d] and won (1,224,812) with Pair of Queens and Pair of Nines


Poker Hand #TM3552711977: Tournament #156543396, Bounty Hunters Special $1.08 Hold'em No Limit - Level32(20,000/40,000) - 2024/08/05 14:40:21
Table '47' 8-max Seat #2 is the button
Seat 1: 70f690a3 (603,658 in chips)
Seat 2: 45f2a4a4 (3,958,139 in chips)
Seat 3: Hero (2,627,503 in chips)
Seat 4: 37ff5d80 (502,906 in chips)
Seat 5: 296e9e62 (229,660 in chips)
Seat 6: 892eb287 (706,640 in chips)
Seat 7: 793d53d4 (1,546,592 in chips)
45f2a4a4: posts the ante 6,000
70f690a3: posts the ante 6,000
37ff5d80: posts the ante 6,000
296e9e62: posts the ante 6,000
793d53d4: posts the ante 6,000
892eb287: posts the ante 6,000
Hero: posts the ante 6,000
Hero: posts small blind 20,000
37ff5d80: posts big blind 40,000
*** HOLE CARDS ***
Dealt to 70f690a3 
Dealt to 45f2a4a4 
Dealt to Hero [Ad 5h]
Dealt to 37ff5d80 
Dealt to 296e9e62 
Dealt to 892eb287 
Dealt to 793d53d4 
296e9e62: folds
892eb287: raises 52,000 to 92,000
793d53d4: folds
70f690a3: folds
45f2a4a4: folds
Hero: folds
37ff5d80: folds
Uncalled bet (52,000) returned to 892eb287
*** SHOWDOWN ***
892eb287 collected 142,000 from pot
*** SUMMARY ***
Total pot 142,000 | Rake 0 | Jackpot 0 | Bingo 0 | Fortune 0 | Tax 0
Seat 1: 70f690a3 folded before Flop
Seat 2: 45f2a4a4 (button) folded before Flop
Seat 3: Hero (small blind) folded before Flop
Seat 4: 37ff5d80 (big blind) folded before Flop
Seat 5: 296e9e62 folded before Flop
Seat 6: 892eb287 collected (142,000)
Seat 7: 793d53d4 folded before Flop


Poker Hand #TM3552711964: Tournament #156543396, Bounty Hunters Special $1.08 Hold'em No Limit - Level32(20,000/40,000) - 2024/08/05 14:39:48
Table '47' 8-max Seat #1 is the button
Seat 1: 70f690a3 (609,658 in chips)
Seat 2: 45f2a4a4 (3,984,139 in chips)
Seat 3: Hero (2,673,503 in chips)
Seat 4: 37ff5d80 (406,906 in chips)
Seat 5: 296e9e62 (235,660 in chips)
Seat 6: 892eb287 (712,640 in chips)
Seat 7: 793d53d4 (1,552,592 in chips)
70f690a3: posts the ante 6,000
37ff5d80: posts the ante 6,000
45f2a4a4: posts the ante 6,000
296e9e62: posts the ante 6,000
793d53d4: posts the ante 6,000
892eb287: posts the ante 6,000
Hero: posts the ante 6,000
45f2a4a4: posts small blind 20,000
Hero: posts big blind 40,000
*** HOLE CARDS ***
Dealt to 70f690a3 
Dealt to 45f2a4a4 
Dealt to Hero [3c Js]
Dealt to 37ff5d80 
Dealt to 296e9e62 
Dealt to 892eb287 
Dealt to 793d53d4 
37ff5d80: raises 360,906 to 400,906 and is all-in
296e9e62: folds
892eb287: folds
793d53d4: folds
70f690a3: folds
45f2a4a4: folds
Hero: folds
Uncalled bet (360,906) returned to 37ff5d80
*** SHOWDOWN ***
37ff5d80 collected 142,000 from pot
*** SUMMARY ***
Total pot 142,000 | Rake 0 | Jackpot 0 | Bingo 0 | Fortune 0 | Tax 0
Seat 1: 70f690a3 (button) folded before Flop
Seat 2: 45f2a4a4 (small blind) folded before Flop
Seat 3: Hero (big blind) folded before Flop
Seat 4: 37ff5d80 collected (142,000)
Seat 5: 296e9e62 folded before Flop
Seat 6: 892eb287 folded before Flop
Seat 7: 793d53d4 folded before Flop


Poker Hand #TM3552711922: Tournament #156543396, Bounty Hunters Special $1.08 Hold'em No Limit - Level32(20,000/40,000) - 2024/08/05 14:38:23
Table '47' 8-max Seat #8 is the button
Seat 1: 70f690a3 (635,658 in chips)
Seat 2: 45f2a4a4 (3,211,276 in chips)
Seat 3: Hero (2,679,503 in chips)
Seat 4: 37ff5d80 (412,906 in chips)
Seat 5: 296e9e62 (241,660 in chips)
Seat 6: 892eb287 (810,640 in chips)
Seat 7: 793d53d4 (1,558,592 in chips)
Seat 8: da341a66 (624,863 in chips)
37ff5d80: posts the ante 6,000
45f2a4a4: posts the ante 6,000
70f690a3: posts the ante 6,000
da341a66: posts the ante 6,000
296e9e62: posts the ante 6,000
793d53d4: posts the ante 6,000
892eb287: posts the ante 6,000
Hero: posts the ante 6,000
70f690a3: posts small blind 20,000
45f2a4a4: posts big blind 40,000
*** HOLE CARDS ***
Dealt to 70f690a3 
Dealt to 45f2a4a4 
Dealt to Hero [8s 8d]
Dealt to 37ff5d80 
Dealt to 296e9e62 
Dealt to 892eb287 
Dealt to 793d53d4 
Dealt to da341a66 
Hero: folds
37ff5d80: folds
296e9e62: folds
892eb287: raises 52,000 to 92,000
793d53d4: folds
da341a66: calls 92,000
70f690a3: folds
45f2a4a4: raises 3,113,276 to 3,205,276 and is all-in
892eb287: folds
da341a66: calls 526,863 and is all-in
Uncalled bet (2,586,413) returned to 45f2a4a4
45f2a4a4: shows [Kd As]
da341a66: shows [Ad Jh]
*** FLOP *** [5h 9d 2h]
*** TURN *** [5h 9d 2h] [5c]
*** RIVER *** [5h 9d 2h 5c] [8h]
*** SHOWDOWN ***
45f2a4a4 collected 1,397,726 from pot
*** SUMMARY ***
Total pot 1,397,726 | Rake 0 | Jackpot 0 | Bingo 0 | Fortune 0 | Tax 0
Board [5h 9d 2h 5c 8h]
Seat 1: 70f690a3 (small blind) folded before Flop
Seat 2: 45f2a4a4 (big blind) showed [Kd As] and won (1,397,726) with Pair of Fives
Seat 3: Hero folded before Flop
Seat 4: 37ff5d80 folded before Flop
Seat 5: 296e9e62 folded before Flop
Seat 6: 892eb287 folded before Flop
Seat 7: 793d53d4 folded before Flop
Seat 8: da341a66 (button) showed [Ad Jh] and lost with Pair of Fives


Poker Hand #TM3552711905: Tournament #156543396, Bounty Hunters Special $1.08 Hold'em No Limit - Level32(20,000/40,000) - 2024/08/05 14:37:49
Table '47' 8-max Seat #7 is the button
Seat 1: 70f690a3 (681,658 in chips)
Seat 2: 45f2a4a4 (3,217,276 in chips)
Seat 3: Hero (2,685,503 in chips)
Seat 4: 37ff5d80 (418,906 in chips)
Seat 5: 296e9e62 (247,660 in chips)
Seat 6: 892eb287 (816,640 in chips)
Seat 7: 793d53d4 (1,456,592 in chips)
Seat 8: da341a66 (650,863 in chips)
37ff5d80: posts the ante 6,000
45f2a4a4: posts the ante 6,000
70f690a3: posts the ante 6,000
da341a66: posts the ante 6,000
296e9e62: posts the ante 6,000
793d53d4: posts the ante 6,000
892eb287: posts the ante 6,000
Hero: posts the ante 6,000
da341a66: posts small blind 20,000
70f690a3: posts big blind 40,000
*** HOLE CARDS ***
Dealt to 70f690a3 
Dealt to 45f2a4a4 
Dealt to Hero [Th Kd]
Dealt to 37ff5d80 
Dealt to 296e9e62 
Dealt to 892eb287 
Dealt to 793d53d4 
Dealt to da341a66 
45f2a4a4: folds
Hero: folds
37ff5d80: folds
296e9e62: folds
892eb287: folds
793d53d4: raises 1,410,592 to 1,450,592 and is all-in
da341a66: folds
70f690a3: folds
Uncalled bet (1,410,592) returned to 793d53d4
*** SHOWDOWN ***
793d53d4 collected 148,000 from pot
*** SUMMARY ***
Total pot 148,000 | Rake 0 | Jackpot 0 | Bingo 0 | Fortune 0 | Tax 0
Seat 1: 70f690a3 (big blind) folded before Flop
Seat 2: 45f2a4a4 folded before Flop
Seat 3: Hero folded before Flop
Seat 4: 37ff5d80 folded before Flop
Seat 5: 296e9e62 folded before Flop
Seat 6: 892eb287 folded before Flop
Seat 7: 793d53d4 (button) collected (148,000)
Seat 8: da341a66 (small blind) folded before Flop


Poker Hand #TM3552711883: Tournament #156543396, Bounty Hunters Special $1.08 Hold'em No Limit - Level32(20,000/40,000) - 2024/08/05 14:37:09
Table '47' 8-max Seat #6 is the button
Seat 3: Hero (2,691,503 in chips)
Seat 4: 37ff5d80 (424,906 in chips)
Seat 5: 296e9e62 (253,660 in chips)
Seat 6: 892eb287 (822,640 in chips)
Seat 7: 793d53d4 (1,554,592 in chips)
Seat 8: da341a66 (528,863 in chips)
37ff5d80: posts the ante 6,000
da341a66: posts the ante 6,000
296e9e62: posts the ante 6,000
793d53d4: posts the ante 6,000
892eb287: posts the ante 6,000
Hero: posts the ante 6,000
793d53d4: posts small blind 20,000
da341a66: posts big blind 40,000
*** HOLE CARDS ***
Dealt to Hero [Jd Qh]
Dealt to 37ff5d80 
Dealt to 296e9e62 
Dealt to 892eb287 
Dealt to 793d53d4 
Dealt to da341a66 
Hero: folds
37ff5d80: folds
296e9e62: folds
892eb287: folds
793d53d4: raises 52,000 to 92,000
da341a66: raises 430,863 to 522,863 and is all-in
793d53d4: folds
Uncalled bet (430,863) returned to da341a66
da341a66: shows [Ks Ad]
*** SHOWDOWN ***
da341a66 collected 220,000 from pot
*** SUMMARY ***
Total pot 220,000 | Rake 0 | Jackpot 0 | Bingo 0 | Fortune 0 | Tax 0
Seat 3: Hero folded before Flop
Seat 4: 37ff5d80 folded before Flop
Seat 5: 296e9e62 folded before Flop
Seat 6: 892eb287 (button) folded before Flop
Seat 7: 793d53d4 (small blind) folded before Flop
Seat 8: da341a66 (big blind) showed [Ks Ad] and collected (220,000)


Poker Hand #TM3552711866: Tournament #156543396, Bounty Hunters Special $1.08 Hold'em No Limit - Level32(20,000/40,000) - 2024/08/05 14:36:31
Table '47' 8-max Seat #5 is the button
Seat 3: Hero (2,697,503 in chips)
Seat 4: 37ff5d80 (430,906 in chips)
Seat 5: 296e9e62 (259,660 in chips)
Seat 6: 892eb287 (848,640 in chips)
Seat 7: 793d53d4 (1,504,592 in chips)
Seat 8: da341a66 (534,863 in chips)
37ff5d80: posts the ante 6,000
da341a66: posts the ante 6,000
296e9e62: posts the ante 6,000
793d53d4: posts the ante 6,000
Hero: posts the ante 6,000
892eb287: posts the ante 6,000
892eb287: posts small blind 20,000
793d53d4: posts big blind 40,000
*** HOLE CARDS ***
Dealt to Hero [7h 3c]
Dealt to 37ff5d80 
Dealt to 296e9e62 
Dealt to 892eb287 
Dealt to 793d53d4 
Dealt to da341a66 
da341a66: folds
Hero: folds
37ff5d80: folds
296e9e62: folds
892eb287: folds
Uncalled bet (20,000) returned to 793d53d4
*** SHOWDOWN ***
793d53d4 collected 76,000 from pot
*** SUMMARY ***
Total pot 76,000 | Rake 0 | Jackpot 0 | Bingo 0 | Fortune 0 | Tax 0
Seat 3: Hero folded before Flop
Seat 4: 37ff5d80 folded before Flop
Seat 5: 296e9e62 (button) folded before Flop
Seat 6: 892eb287 (small blind) folded before Flop
Seat 7: 793d53d4 (big blind) collected (76,000)
Seat 8: da341a66 folded before Flop


Poker Hand #TM3552711840: Tournament #156543396, Bounty Hunters Special $1.08 Hold'em No Limit - Level32(20,000/40,000) - 2024/08/05 14:35:35
Table '47' 8-max Seat #4 is the button
Seat 3: Hero (2,703,503 in chips)
Seat 4: 37ff5d80 (516,906 in chips)
Seat 5: 296e9e62 (285,660 in chips)
Seat 6: 892eb287 (718,640 in chips)
Seat 7: 793d53d4 (1,510,592 in chips)
Seat 8: da341a66 (540,863 in chips)
37ff5d80: posts the ante 6,000
da341a66: posts the ante 6,000
296e9e62: posts the ante 6,000
793d53d4: posts the ante 6,000
Hero: posts the ante 6,000
892eb287: posts the ante 6,000
296e9e62: posts small blind 20,000
892eb287: posts big blind 40,000
*** HOLE CARDS ***
Dealt to Hero [2s Kh]
Dealt to 37ff5d80 
Dealt to 296e9e62 
Dealt to 892eb287 
Dealt to 793d53d4 
Dealt to da341a66 
793d53d4: folds
da341a66: folds
Hero: folds
37ff5d80: raises 40,000 to 80,000
296e9e62: folds
892eb287: raises 632,640 to 712,640 and is all-in
37ff5d80: folds
Uncalled bet (632,640) returned to 892eb287
*** SHOWDOWN ***
892eb287 collected 216,000 from pot
*** SUMMARY ***
Total pot 216,000 | Rake 0 | Jackpot 0 | Bingo 0 | Fortune 0 | Tax 0
Seat 3: Hero folded before Flop
Seat 4: 37ff5d80 (button) folded before Flop
Seat 5: 296e9e62 (small blind) folded before Flop
Seat 6: 892eb287 (big blind) collected (216,000)
Seat 7: 793d53d4 folded before Flop
Seat 8: da341a66 folded before Flop


Poker Hand #TM3552711829: Tournament #156543396, Bounty Hunters Special $1.08 Hold'em No Limit - Level32(20,000/40,000) - 2024/08/05 14:35:15
Table '47' 8-max Seat #3 is the button
Seat 3: Hero (2,709,503 in chips)
Seat 4: 37ff5d80 (542,906 in chips)
Seat 5: 296e9e62 (235,660 in chips)
Seat 6: 892eb287 (724,640 in chips)
Seat 7: 793d53d4 (1,516,592 in chips)
Seat 8: da341a66 (546,863 in chips)
37ff5d80: posts the ante 6,000
da341a66: posts the ante 6,000
296e9e62: posts the ante 6,000
793d53d4: posts the ante 6,000
Hero: posts the ante 6,000
892eb287: posts the ante 6,000
37ff5d80: posts small blind 20,000
296e9e62: posts big blind 40,000
*** HOLE CARDS ***
Dealt to Hero [9d 7d]
Dealt to 37ff5d80 
Dealt to 296e9e62 
Dealt to 892eb287 
Dealt to 793d53d4 
Dealt to da341a66 
892eb287: folds
793d53d4: folds
da341a66: folds
Hero: folds
37ff5d80: folds
Uncalled bet (20,000) returned to 296e9e62
*** SHOWDOWN ***
296e9e62 collected 76,000 from pot
*** SUMMARY ***
Total pot 76,000 | Rake 0 | Jackpot 0 | Bingo 0 | Fortune 0 | Tax 0
Seat 3: Hero (button) folded before Flop
Seat 4: 37ff5d80 (small blind) folded before Flop
Seat 5: 296e9e62 (big blind) collected (76,000)
Seat 6: 892eb287 folded before Flop
Seat 7: 793d53d4 folded before Flop
Seat 8: da341a66 folded before Flop


Poker Hand #TM3552711810: Tournament #156543396, Bounty Hunters Special $1.08 Hold'em No Limit - Level32(20,000/40,000) - 2024/08/05 14:34:36
Table '47' 8-max Seat #8 is the button
Seat 3: Hero (2,735,503 in chips)
Seat 4: 37ff5d80 (588,906 in chips)
Seat 5: 296e9e62 (241,660 in chips)
Seat 6: 892eb287 (634,640 in chips)
Seat 7: 793d53d4 (1,522,592 in chips)
Seat 8: da341a66 (552,863 in chips)
37ff5d80: posts the ante 6,000
da341a66: posts the ante 6,000
296e9e62: posts the ante 6,000
793d53d4: posts the ante 6,000
892eb287: posts the ante 6,000
Hero: posts the ante 6,000
Hero: posts small blind 20,000
37ff5d80: posts big blind 40,000
*** HOLE CARDS ***
Dealt to Hero [Jc Th]
Dealt to 37ff5d80 
Dealt to 296e9e62 
Dealt to 892eb287 
Dealt to 793d53d4 
Dealt to da341a66 
296e9e62: folds
892eb287: raises 52,000 to 92,000
793d53d4: folds
da341a66: folds
Hero: folds
37ff5d80: folds
Uncalled bet (52,000) returned to 892eb287
*** SHOWDOWN ***
892eb287 collected 136,000 from pot
*** SUMMARY ***
Total pot 136,000 | Rake 0 | Jackpot 0 | Bingo 0 | Fortune 0 | Tax 0
Seat 3: Hero (small blind) folded before Flop
Seat 4: 37ff5d80 (big blind) folded before Flop
Seat 5: 296e9e62 folded before Flop
Seat 6: 892eb287 collected (136,000)
Seat 7: 793d53d4 folded before Flop
Seat 8: da341a66 (button) folded before Flop


Poker Hand #TM3552711783: Tournament #156543396, Bounty Hunters Special $1.08 Hold'em No Limit - Level31(17,500/35,000) - 2024/08/05 14:33:44
Table '47' 8-max Seat #7 is the button
Seat 3: Hero (2,821,003 in chips)
Seat 4: 37ff5d80 (593,906 in chips)
Seat 5: 296e9e62 (246,660 in chips)
Seat 6: 892eb287 (639,640 in chips)
Seat 7: 793d53d4 (1,399,592 in chips)
Seat 8: da341a66 (575,363 in chips)
37ff5d80: posts the ante 5,000
da341a66: posts the ante 5,000
296e9e62: posts the ante 5,000
793d53d4: posts the ante 5,000
892eb287: posts the ante 5,000
Hero: posts the ante 5,000
da341a66: posts small blind 17,500
Hero: posts big blind 35,000
*** HOLE CARDS ***
Dealt to Hero [Ts Ad]
Dealt to 37ff5d80 
Dealt to 296e9e62 
Dealt to 892eb287 
Dealt to 793d53d4 
Dealt to da341a66 
37ff5d80: folds
296e9e62: folds
892eb287: folds
793d53d4: raises 45,500 to 80,500
da341a66: folds
Hero: calls 45,500
*** FLOP *** [8h 8s 2d]
Hero: checks
793d53d4: bets 68,805
Hero: folds
Uncalled bet (68,805) returned to 793d53d4
*** SHOWDOWN ***
793d53d4 collected 208,500 from pot
*** SUMMARY ***
Total pot 208,500 | Rake 0 | Jackpot 0 | Bingo 0 | Fortune 0 | Tax 0
Board [8h 8s 2d]
Seat 3: Hero (big blind) folded on the Flop
Seat 4: 37ff5d80 folded before Flop
Seat 5: 296e9e62 folded before Flop
Seat 6: 892eb287 folded before Flop
Seat 7: 793d53d4 (button) won (208,500)
Seat 8: da341a66 (small blind) folded before Flop


Poker Hand #TM3552711760: Tournament #156543396, Bounty Hunters Special $1.08 Hold'em No Limit - Level31(17,500/35,000) - 2024/08/05 14:33:08
Table '47' 8-max Seat #6 is the button
Seat 3: Hero (2,826,003 in chips)
Seat 4: 37ff5d80 (598,906 in chips)
Seat 5: 296e9e62 (251,660 in chips)
Seat 6: 892eb287 (562,140 in chips)
Seat 7: 793d53d4 (1,422,092 in chips)
Seat 8: da341a66 (615,363 in chips)
37ff5d80: posts the ante 5,000
da341a66: posts the ante 5,000
296e9e62: posts the ante 5,000
793d53d4: posts the ante 5,000
892eb287: posts the ante 5,000
Hero: posts the ante 5,000
793d53d4: posts small blind 17,500
da341a66: posts big blind 35,000
*** HOLE CARDS ***
Dealt to Hero [Ah 6d]
Dealt to 37ff5d80 
Dealt to 296e9e62 
Dealt to 892eb287 
Dealt to 793d53d4 
Dealt to da341a66 
Hero: folds
37ff5d80: folds
296e9e62: folds
892eb287: raises 45,500 to 80,500
793d53d4: folds
da341a66: folds
Uncalled bet (45,500) returned to 892eb287
*** SHOWDOWN ***
892eb287 collected 117,500 from pot
*** SUMMARY ***
Total pot 117,500 | Rake 0 | Jackpot 0 | Bingo 0 | Fortune 0 | Tax 0
Seat 3: Hero folded before Flop
Seat 4: 37ff5d80 folded before Flop
Seat 5: 296e9e62 folded before Flop
Seat 6: 892eb287 (button) collected (117,500)
Seat 7: 793d53d4 (small blind) folded before Flop
Seat 8: da341a66 (big blind) folded before Flop


Poker Hand #TM3552711744: Tournament #156543396, Bounty Hunters Special $1.08 Hold'em No Limit - Level31(17,500/35,000) - 2024/08/05 14:32:35
Table '47' 8-max Seat #5 is the button
Seat 3: Hero (2,831,003 in chips)
Seat 4: 37ff5d80 (603,906 in chips)
Seat 5: 296e9e62 (256,660 in chips)
Seat 6: 892eb287 (584,640 in chips)
Seat 7: 793d53d4 (1,462,092 in chips)
Seat 8: da341a66 (537,863 in chips)
37ff5d80: posts the ante 5,000
da341a66: posts the ante 5,000
296e9e62: posts the ante 5,000
793d53d4: posts the ante 5,000
Hero: posts the ante 5,000
892eb287: posts the ante 5,000
892eb287: posts small blind 17,500
793d53d4: posts big blind 35,000
*** HOLE CARDS ***
Dealt to Hero [2h Ks]
Dealt to 37ff5d80 
Dealt to 296e9e62 
Dealt to 892eb287 
Dealt to 793d53d4 
Dealt to da341a66 
da341a66: raises 497,863 to 532,863 and is all-in
Hero: folds
37ff5d80: folds
296e9e62: folds
892eb287: folds
793d53d4: folds
Uncalled bet (497,863) returned to da341a66
*** SHOWDOWN ***
da341a66 collected 117,500 from pot
*** SUMMARY ***
Total pot 117,500 | Rake 0 | Jackpot 0 | Bingo 0 | Fortune 0 | Tax 0
Seat 3: Hero folded before Flop
Seat 4: 37ff5d80 folded before Flop
Seat 5: 296e9e62 (button) folded before Flop
Seat 6: 892eb287 (small blind) folded before Flop
Seat 7: 793d53d4 (big blind) folded before Flop
Seat 8: da341a66 collected (117,500)


Poker Hand #TM3552711721: Tournament #156543396, Bounty Hunters Special $1.08 Hold'em No Limit - Level31(17,500/35,000) - 2024/08/05 14:31:51
Table '47' 8-max Seat #4 is the button
Seat 1: 319dcc00 (177,657 in chips)
Seat 3: Hero (2,836,003 in chips)
Seat 4: 37ff5d80 (521,406 in chips)
Seat 5: 296e9e62 (279,160 in chips)
Seat 6: 892eb287 (624,640 in chips)
Seat 7: 793d53d4 (1,467,092 in chips)
Seat 8: da341a66 (542,863 in chips)
319dcc00: posts the ante 5,000
37ff5d80: posts the ante 5,000
da341a66: posts the ante 5,000
296e9e62: posts the ante 5,000
793d53d4: posts the ante 5,000
Hero: posts the ante 5,000
892eb287: posts the ante 5,000
296e9e62: posts small blind 17,500
892eb287: posts big blind 35,000
*** HOLE CARDS ***
Dealt to 319dcc00 
Dealt to Hero [2h Kc]
Dealt to 37ff5d80 
Dealt to 296e9e62 
Dealt to 892eb287 
Dealt to 793d53d4 
Dealt to da341a66 
793d53d4: folds
da341a66: folds
319dcc00: folds
Hero: folds
37ff5d80: raises 481,406 to 516,406 and is all-in
296e9e62: folds
892eb287: folds
Uncalled bet (481,406) returned to 37ff5d80
*** SHOWDOWN ***
37ff5d80 collected 122,500 from pot
*** SUMMARY ***
Total pot 122,500 | Rake 0 | Jackpot 0 | Bingo 0 | Fortune 0 | Tax 0
Seat 1: 319dcc00 folded before Flop
Seat 3: Hero folded before Flop
Seat 4: 37ff5d80 (button) collected (122,500)
Seat 5: 296e9e62 (small blind) folded before Flop
Seat 6: 892eb287 (big blind) folded before Flop
Seat 7: 793d53d4 folded before Flop
Seat 8: da341a66 folded before Flop


Poker Hand #TM3552711699: Tournament #156543396, Bounty Hunters Special $1.08 Hold'em No Limit - Level31(17,500/35,000) - 2024/08/05 14:31:13
Table '47' 8-max Seat #3 is the button
Seat 1: 319dcc00 (182,657 in chips)
Seat 3: Hero (2,841,003 in chips)
Seat 4: 37ff5d80 (543,906 in chips)
Seat 5: 296e9e62 (319,160 in chips)
Seat 6: 892eb287 (629,640 in chips)
Seat 7: 793d53d4 (1,384,592 in chips)
Seat 8: da341a66 (547,863 in chips)
319dcc00: posts the ante 5,000
37ff5d80: posts the ante 5,000
da341a66: posts the ante 5,000
296e9e62: posts the ante 5,000
793d53d4: posts the ante 5,000
Hero: posts the ante 5,000
892eb287: posts the ante 5,000
37ff5d80: posts small blind 17,500
296e9e62: posts big blind 35,000
*** HOLE CARDS ***
Dealt to 319dcc00 
Dealt to Hero [6c 5h]
Dealt to 37ff5d80 
Dealt to 296e9e62 
Dealt to 892eb287 
Dealt to 793d53d4 
Dealt to da341a66 
892eb287: folds
793d53d4: raises 35,000 to 70,000
da341a66: folds
319dcc00: folds
Hero: folds
37ff5d80: folds
296e9e62: folds
Uncalled bet (35,000) returned to 793d53d4
*** SHOWDOWN ***
793d53d4 collected 122,500 from pot
*** SUMMARY ***
Total pot 122,500 | Rake 0 | Jackpot 0 | Bingo 0 | Fortune 0 | Tax 0
Seat 1: 319dcc00 folded before Flop
Seat 3: Hero (button) folded before Flop
Seat 4: 37ff5d80 (small blind) folded before Flop
Seat 5: 296e9e62 (big blind) folded before Flop
Seat 6: 892eb287 folded before Flop
Seat 7: 793d53d4 collected (122,500)
Seat 8: da341a66 folded before Flop


Poker Hand #TM3552711640: Tournament #156543396, Bounty Hunters Special $1.08 Hold'em No Limit - Level31(17,500/35,000) - 2024/08/05 14:29:22
Table '47' 8-max Seat #1 is the button
Seat 1: 319dcc00 (187,657 in chips)
Seat 3: Hero (2,863,503 in chips)
Seat 4: 37ff5d80 (583,906 in chips)
Seat 5: 296e9e62 (82,220 in chips)
Seat 6: 892eb287 (634,640 in chips)
Seat 7: 793d53d4 (1,512,092 in chips)
Seat 8: da341a66 (584,803 in chips)
319dcc00: posts the ante 5,000
37ff5d80: posts the ante 5,000
da341a66: posts the ante 5,000
296e9e62: posts the ante 5,000
793d53d4: posts the ante 5,000
892eb287: posts the ante 5,000
Hero: posts the ante 5,000
Hero: posts small blind 17,500
37ff5d80: posts big blind 35,000
*** HOLE CARDS ***
Dealt to 319dcc00 
Dealt to Hero [5s Tc]
Dealt to 37ff5d80 
Dealt to 296e9e62 
Dealt to 892eb287 
Dealt to 793d53d4 
Dealt to da341a66 
296e9e62: raises 35,000 to 70,000
892eb287: folds
793d53d4: calls 70,000
da341a66: calls 70,000
319dcc00: folds
Hero: folds
37ff5d80: folds
*** FLOP *** [5d Jd Ad]
296e9e62: checks
793d53d4: bets 52,500
da341a66: raises 132,825 to 185,325
296e9e62: calls 7,220 and is all-in
793d53d4: folds
Uncalled bet (132,825) returned to da341a66
da341a66: shows [Th Kd] (Ace-High)
296e9e62: shows [Ah Ac] (Three Aces)
*** TURN *** [5d Jd Ad] [As]
*** RIVER *** [5d Jd Ad As] [7c]
*** SHOWDOWN ***
296e9e62 collected 319,160 from pot
da341a66 collected 90,560 from pot
*** SUMMARY ***
Total pot 409,720 | Rake 0 | Jackpot 0 | Bingo 0 | Fortune 0 | Tax 0
Board [5d Jd Ad As 7c]
Seat 1: 319dcc00 (button) folded before Flop
Seat 3: Hero (small blind) folded before Flop
Seat 4: 37ff5d80 (big blind) folded before Flop
Seat 5: 296e9e62 showed [Ah Ac] and won (319,160) with Four Aces
Seat 6: 892eb287 folded before Flop
Seat 7: 793d53d4 folded on the Flop
Seat 8: da341a66 showed [Th Kd] and won (90,560) with Pair of Aces


Poker Hand #TM3552711603: Tournament #156543396, Bounty Hunters Special $1.08 Hold'em No Limit - Level31(17,500/35,000) - 2024/08/05 14:28:02
Table '47' 8-max Seat #8 is the button
Seat 1: 319dcc00 (210,157 in chips)
Seat 2: 6f8884c (286,200 in chips)
Seat 3: Hero (2,529,803 in chips)
Seat 4: 37ff5d80 (588,906 in chips)
Seat 5: 296e9e62 (87,220 in chips)
Seat 6: 892eb287 (639,640 in chips)
Seat 7: 793d53d4 (1,517,092 in chips)
Seat 8: da341a66 (589,803 in chips)
319dcc00: posts the ante 5,000
37ff5d80: posts the ante 5,000
da341a66: posts the ante 5,000
296e9e62: posts the ante 5,000
793d53d4: posts the ante 5,000
892eb287: posts the ante 5,000
Hero: posts the ante 5,000
6f8884c: posts the ante 5,000
319dcc00: posts small blind 17,500
6f8884c: posts big blind 35,000
*** HOLE CARDS ***
Dealt to 319dcc00 
Dealt to 6f8884c 
Dealt to Hero [Ts Td]
Dealt to 37ff5d80 
Dealt to 296e9e62 
Dealt to 892eb287 
Dealt to 793d53d4 
Dealt to da341a66 
Hero: raises 52,500 to 87,500
37ff5d80: folds
296e9e62: folds
892eb287: folds
793d53d4: folds
da341a66: folds
319dcc00: folds
6f8884c: calls 52,500
*** FLOP *** [7c 7s 8h]
6f8884c: checks
Hero: bets 232,500
6f8884c: calls 193,700 and is all-in
Uncalled bet (38,800) returned to Hero
Hero: shows [Ts Td] (Pair of Tens and Pair of Sevens)
6f8884c: shows [7d 4d] (Three Sevens)
*** TURN *** [7c 7s 8h] [9d]
*** RIVER *** [7c 7s 8h 9d] [Js]
*** SHOWDOWN ***
Hero collected 619,900 from pot
*** SUMMARY ***
Total pot 619,900 | Rake 0 | Jackpot 0 | Bingo 0 | Fortune 0 | Tax 0
Board [7c 7s 8h 9d Js]
Seat 1: 319dcc00 (small blind) folded before Flop
Seat 2: 6f8884c (big blind) showed [7d 4d] and lost with Three Sevens
Seat 3: Hero showed [Ts Td] and won (619,900) with Jacks-High Straight
Seat 4: 37ff5d80 folded before Flop
Seat 5: 296e9e62 folded before Flop
Seat 6: 892eb287 folded before Flop
Seat 7: 793d53d4 folded before Flop
Seat 8: da341a66 (button) folded before Flop


Poker Hand #TM3552711580: Tournament #156543396, Bounty Hunters Special $1.08 Hold'em No Limit - Level31(17,500/35,000) - 2024/08/05 14:27:13
Table '47' 8-max Seat #7 is the button
Seat 1: 319dcc00 (250,157 in chips)
Seat 2: 6f8884c (291,200 in chips)
Seat 3: Hero (2,534,803 in chips)
Seat 4: 37ff5d80 (593,906 in chips)
Seat 5: 296e9e62 (92,220 in chips)
Seat 6: 892eb287 (749,640 in chips)
Seat 7: 793d53d4 (1,324,592 in chips)
Seat 8: da341a66 (612,303 in chips)
319dcc00: posts the ante 5,000
37ff5d80: posts the ante 5,000
da341a66: posts the ante 5,000
296e9e62: posts the ante 5,000
793d53d4: posts the ante 5,000
892eb287: posts the ante 5,000
Hero: posts the ante 5,000
6f8884c: posts the ante 5,000
da341a66: posts small blind 17,500
319dcc00: posts big blind 35,000
*** HOLE CARDS ***
Dealt to 319dcc00 
Dealt to 6f8884c 
Dealt to Hero [7h Jh]
Dealt to 37ff5d80 
Dealt to 296e9e62 
Dealt to 892eb287 
Dealt to 793d53d4 
Dealt to da341a66 
6f8884c: folds
Hero: folds
37ff5d80: folds
296e9e62: folds
892eb287: raises 70,000 to 105,000
793d53d4: raises 1,214,592 to 1,319,592 and is all-in
da341a66: folds
319dcc00: folds
892eb287: folds
Uncalled bet (1,214,592) returned to 793d53d4
*** SHOWDOWN ***
793d53d4 collected 302,500 from pot
*** SUMMARY ***
Total pot 302,500 | Rake 0 | Jackpot 0 | Bingo 0 | Fortune 0 | Tax 0
Seat 1: 319dcc00 (big blind) folded before Flop
Seat 2: 6f8884c folded before Flop
Seat 3: Hero folded before Flop
Seat 4: 37ff5d80 folded before Flop
Seat 5: 296e9e62 folded before Flop
Seat 6: 892eb287 folded before Flop
Seat 7: 793d53d4 (button) collected (302,500)
Seat 8: da341a66 (small blind) folded before Flop


Poker Hand #TM3552711545: Tournament #156543396, Bounty Hunters Special $1.08 Hold'em No Limit - Level30(15,000/30,000) - 2024/08/05 14:26:07
Table '47' 8-max Seat #6 is the button
Seat 1: 319dcc00 (326,237 in chips)
Seat 2: 6f8884c (295,700 in chips)
Seat 3: Hero (2,539,303 in chips)
Seat 4: 37ff5d80 (598,406 in chips)
Seat 5: 296e9e62 (96,720 in chips)
Seat 6: 892eb287 (754,140 in chips)
Seat 7: 793d53d4 (1,191,512 in chips)
Seat 8: da341a66 (646,803 in chips)
319dcc00: posts the ante 4,500
37ff5d80: posts the ante 4,500
da341a66: posts the ante 4,500
296e9e62: posts the ante 4,500
793d53d4: posts the ante 4,500
892eb287: posts the ante 4,500
Hero: posts the ante 4,500
6f8884c: posts the ante 4,500
793d53d4: posts small blind 15,000
da341a66: posts big blind 30,000
*** HOLE CARDS ***
Dealt to 319dcc00 
Dealt to 6f8884c 
Dealt to Hero [Th 5s]
Dealt to 37ff5d80 
Dealt to 296e9e62 
Dealt to 892eb287 
Dealt to 793d53d4 
Dealt to da341a66 
319dcc00: calls 30,000
6f8884c: folds
Hero: folds
37ff5d80: folds
296e9e62: folds
892eb287: folds
793d53d4: calls 15,000
da341a66: checks
*** FLOP *** [6h 6d 2h]
793d53d4: checks
da341a66: checks
319dcc00: checks
*** TURN *** [6h 6d 2h] [Qd]
793d53d4: bets 41,580
da341a66: folds
319dcc00: calls 41,580
*** RIVER *** [6h 6d 2h Qd] [9s]
793d53d4: checks
319dcc00: checks
793d53d4: shows [Qh 4s] (Pair of Queens and Pair of Sixes)
319dcc00: shows [Ah Kd] (Pair of Sixes)
*** SHOWDOWN ***
793d53d4 collected 209,160 from pot
*** SUMMARY ***
Total pot 209,160 | Rake 0 | Jackpot 0 | Bingo 0 | Fortune 0 | Tax 0
Board [6h 6d 2h Qd 9s]
Seat 1: 319dcc00 showed [Ah Kd] and lost with Pair of Sixes
Seat 2: 6f8884c folded before Flop
Seat 3: Hero folded before Flop
Seat 4: 37ff5d80 folded before Flop
Seat 5: 296e9e62 folded before Flop
Seat 6: 892eb287 (button) folded before Flop
Seat 7: 793d53d4 (small blind) showed [Qh 4s] and won (209,160) with Pair of Queens and Pair of Sixes
Seat 8: da341a66 (big blind) folded on the Turn


Poker Hand #TM3552711503: Tournament #156543396, Bounty Hunters Special $1.08 Hold'em No Limit - Level30(15,000/30,000) - 2024/08/05 14:24:50
Table '47' 8-max Seat #5 is the button
Seat 1: 319dcc00 (330,737 in chips)
Seat 2: 6f8884c (426,530 in chips)
Seat 3: Hero (2,336,473 in chips)
Seat 4: 37ff5d80 (602,906 in chips)
Seat 5: 296e9e62 (101,220 in chips)
Seat 6: 892eb287 (773,640 in chips)
Seat 7: 793d53d4 (1,226,012 in chips)
Seat 8: da341a66 (651,303 in chips)
319dcc00: posts the ante 4,500
37ff5d80: posts the ante 4,500
da341a66: posts the ante 4,500
296e9e62: posts the ante 4,500
793d53d4: posts the ante 4,500
Hero: posts the ante 4,500
892eb287: posts the ante 4,500
6f8884c: posts the ante 4,500
892eb287: posts small blind 15,000
793d53d4: posts big blind 30,000
*** HOLE CARDS ***
Dealt to 319dcc00 
Dealt to 6f8884c 
Dealt to Hero [Qc As]
Dealt to 37ff5d80 
Dealt to 296e9e62 
Dealt to 892eb287 
Dealt to 793d53d4 
Dealt to da341a66 
da341a66: folds
319dcc00: folds
6f8884c: raises 30,000 to 60,000
Hero: raises 66,330 to 126,330
37ff5d80: folds
296e9e62: folds
892eb287: folds
793d53d4: folds
6f8884c: calls 66,330
*** FLOP *** [9s 3c Kh]
6f8884c: checks
Hero: checks
*** TURN *** [9s 3c Kh] [5d]
6f8884c: checks
Hero: checks
*** RIVER *** [9s 3c Kh 5d] [5c]
6f8884c: checks
Hero: checks
6f8884c: shows [Qs Ts] (Pair of Fives)
Hero: shows [Qc As] (Pair of Fives)
*** SHOWDOWN ***
Hero collected 333,660 from pot
*** SUMMARY ***
Total pot 333,660 | Rake 0 | Jackpot 0 | Bingo 0 | Fortune 0 | Tax 0
Board [9s 3c Kh 5d 5c]
Seat 1: 319dcc00 folded before Flop
Seat 2: 6f8884c showed [Qs Ts] and lost with Pair of Fives
Seat 3: Hero showed [Qc As] and won (333,660) with Pair of Fives
Seat 4: 37ff5d80 folded before Flop
Seat 5: 296e9e62 (button) folded before Flop
Seat 6: 892eb287 (small blind) folded before Flop
Seat 7: 793d53d4 (big blind) folded before Flop
Seat 8: da341a66 folded before Flop


Poker Hand #TM3552711463: Tournament #156543396, Bounty Hunters Special $1.08 Hold'em No Limit - Level30(15,000/30,000) - 2024/08/05 14:23:38
Table '47' 8-max Seat #4 is the button
Seat 1: 319dcc00 (335,237 in chips)
Seat 2: 6f8884c (431,030 in chips)
Seat 3: Hero (2,340,973 in chips)
Seat 4: 37ff5d80 (365,906 in chips)
Seat 5: 296e9e62 (120,720 in chips)
Seat 6: 892eb287 (808,140 in chips)
Seat 7: 793d53d4 (1,230,512 in chips)
Seat 8: da341a66 (816,303 in chips)
319dcc00: posts the ante 4,500
37ff5d80: posts the ante 4,500
da341a66: posts the ante 4,500
296e9e62: posts the ante 4,500
793d53d4: posts the ante 4,500
Hero: posts the ante 4,500
892eb287: posts the ante 4,500
6f8884c: posts the ante 4,500
296e9e62: posts small blind 15,000
892eb287: posts big blind 30,000
*** HOLE CARDS ***
Dealt to 319dcc00 
Dealt to 6f8884c 
Dealt to Hero [8h Ts]
Dealt to 37ff5d80 
Dealt to 296e9e62 
Dealt to 892eb287 
Dealt to 793d53d4 
Dealt to da341a66 
793d53d4: folds
da341a66: raises 30,000 to 60,000
319dcc00: folds
6f8884c: folds
Hero: folds
37ff5d80: calls 60,000
296e9e62: folds
892eb287: folds
*** FLOP *** [8d 9s Jh]
da341a66: bets 100,500
37ff5d80: calls 100,500
*** TURN *** [8d 9s Jh] [4d]
da341a66: checks
37ff5d80: bets 200,906 and is all-in
da341a66: folds
Uncalled bet (200,906) returned to 37ff5d80
*** SHOWDOWN ***
37ff5d80 collected 402,000 from pot
*** SUMMARY ***
Total pot 402,000 | Rake 0 | Jackpot 0 | Bingo 0 | Fortune 0 | Tax 0
Board [8d 9s Jh 4d]
Seat 1: 319dcc00 folded before Flop
Seat 2: 6f8884c folded before Flop
Seat 3: Hero folded before Flop
Seat 4: 37ff5d80 (button) won (402,000)
Seat 5: 296e9e62 (small blind) folded before Flop
Seat 6: 892eb287 (big blind) folded before Flop
Seat 7: 793d53d4 folded before Flop
Seat 8: da341a66 folded on the Turn


Poker Hand #TM3552711443: Tournament #156543396, Bounty Hunters Special $1.08 Hold'em No Limit - Level30(15,000/30,000) - 2024/08/05 14:22:59
Table '47' 8-max Seat #3 is the button
Seat 1: 319dcc00 (339,737 in chips)
Seat 2: 6f8884c (435,530 in chips)
Seat 3: Hero (2,345,473 in chips)
Seat 4: 37ff5d80 (385,406 in chips)
Seat 5: 296e9e62 (155,220 in chips)
Seat 6: 892eb287 (812,640 in chips)
Seat 7: 793d53d4 (1,154,012 in chips)
Seat 8: da341a66 (820,803 in chips)
319dcc00: posts the ante 4,500
37ff5d80: posts the ante 4,500
da341a66: posts the ante 4,500
296e9e62: posts the ante 4,500
793d53d4: posts the ante 4,500
Hero: posts the ante 4,500
892eb287: posts the ante 4,500
6f8884c: posts the ante 4,500
37ff5d80: posts small blind 15,000
296e9e62: posts big blind 30,000
*** HOLE CARDS ***
Dealt to 319dcc00 
Dealt to 6f8884c 
Dealt to Hero [7s Ad]
Dealt to 37ff5d80 
Dealt to 296e9e62 
Dealt to 892eb287 
Dealt to 793d53d4 
Dealt to da341a66 
892eb287: folds
793d53d4: raises 30,000 to 60,000
da341a66: folds
319dcc00: folds
6f8884c: folds
Hero: folds
37ff5d80: folds
296e9e62: folds
Uncalled bet (30,000) returned to 793d53d4
*** SHOWDOWN ***
793d53d4 collected 111,000 from pot
*** SUMMARY ***
Total pot 111,000 | Rake 0 | Jackpot 0 | Bingo 0 | Fortune 0 | Tax 0
Seat 1: 319dcc00 folded before Flop
Seat 2: 6f8884c folded before Flop
Seat 3: Hero (button) folded before Flop
Seat 4: 37ff5d80 (small blind) folded before Flop
Seat 5: 296e9e62 (big blind) folded before Flop
Seat 6: 892eb287 folded before Flop
Seat 7: 793d53d4 collected (111,000)
Seat 8: da341a66 folded before Flop


Poker Hand #TM3552711422: Tournament #156543396, Bounty Hunters Special $1.08 Hold'em No Limit - Level30(15,000/30,000) - 2024/08/05 14:22:17
Table '47' 8-max Seat #2 is the button
Seat 1: 319dcc00 (344,237 in chips)
Seat 2: 6f8884c (440,030 in chips)
Seat 3: Hero (2,283,973 in chips)
Seat 4: 37ff5d80 (419,906 in chips)
Seat 5: 296e9e62 (159,720 in chips)
Seat 6: 892eb287 (817,140 in chips)
Seat 7: 793d53d4 (1,158,512 in chips)
Seat 8: da341a66 (825,303 in chips)
319dcc00: posts the ante 4,500
37ff5d80: posts the ante 4,500
da341a66: posts the ante 4,500
296e9e62: posts the ante 4,500
793d53d4: posts the ante 4,500
892eb287: posts the ante 4,500
Hero: posts the ante 4,500
6f8884c: posts the ante 4,500
Hero: posts small blind 15,000
37ff5d80: posts big blind 30,000
*** HOLE CARDS ***
Dealt to 319dcc00 
Dealt to 6f8884c 
Dealt to Hero [5d 5s]
Dealt to 37ff5d80 
Dealt to 296e9e62 
Dealt to 892eb287 
Dealt to 793d53d4 
Dealt to da341a66 
296e9e62: folds
892eb287: folds
793d53d4: folds
da341a66: folds
319dcc00: folds
6f8884c: folds
Hero: raises 420,000 to 450,000
37ff5d80: folds
Uncalled bet (420,000) returned to Hero
*** SHOWDOWN ***
Hero collected 96,000 from pot
*** SUMMARY ***
Total pot 96,000 | Rake 0 | Jackpot 0 | Bingo 0 | Fortune 0 | Tax 0
Seat 1: 319dcc00 folded before Flop
Seat 2: 6f8884c (button) folded before Flop
Seat 3: Hero (small blind) collected (96,000)
Seat 4: 37ff5d80 (big blind) folded before Flop
Seat 5: 296e9e62 folded before Flop
Seat 6: 892eb287 folded before Flop
Seat 7: 793d53d4 folded before Flop
Seat 8: da341a66 folded before Flop


Poker Hand #TM3552711405: Tournament #156543396, Bounty Hunters Special $1.08 Hold'em No Limit - Level30(15,000/30,000) - 2024/08/05 14:21:42
Table '47' 8-max Seat #1 is the button
Seat 1: 319dcc00 (348,737 in chips)
Seat 2: 6f8884c (378,530 in chips)
Seat 3: Hero (2,318,473 in chips)
Seat 4: 37ff5d80 (424,406 in chips)
Seat 5: 296e9e62 (164,220 in chips)
Seat 6: 892eb287 (821,640 in chips)
Seat 7: 793d53d4 (1,163,012 in chips)
Seat 8: da341a66 (829,803 in chips)
319dcc00: posts the ante 4,500
37ff5d80: posts the ante 4,500
da341a66: posts the ante 4,500
296e9e62: posts the ante 4,500
793d53d4: posts the ante 4,500
892eb287: posts the ante 4,500
Hero: posts the ante 4,500
6f8884c: posts the ante 4,500
6f8884c: posts small blind 15,000
Hero: posts big blind 30,000
*** HOLE CARDS ***
Dealt to 319dcc00 
Dealt to 6f8884c 
Dealt to Hero [Th Qd]
Dealt to 37ff5d80 
Dealt to 296e9e62 
Dealt to 892eb287 
Dealt to 793d53d4 
Dealt to da341a66 
37ff5d80: folds
296e9e62: folds
892eb287: folds
793d53d4: folds
da341a66: folds
319dcc00: folds
6f8884c: raises 344,030 to 374,030 and is all-in
Hero: folds
Uncalled bet (344,030) returned to 6f8884c
*** SHOWDOWN ***
6f8884c collected 96,000 from pot
*** SUMMARY ***
Total pot 96,000 | Rake 0 | Jackpot 0 | Bingo 0 | Fortune 0 | Tax 0
Seat 1: 319dcc00 (button) folded before Flop
Seat 2: 6f8884c (small blind) collected (96,000)
Seat 3: Hero (big blind) folded before Flop
Seat 4: 37ff5d80 folded before Flop
Seat 5: 296e9e62 folded before Flop
Seat 6: 892eb287 folded before Flop
Seat 7: 793d53d4 folded before Flop
Seat 8: da341a66 folded before Flop


Poker Hand #TM3552711374: Tournament #156543396, Bounty Hunters Special $1.08 Hold'em No Limit - Level30(15,000/30,000) - 2024/08/05 14:20:42
Table '47' 8-max Seat #8 is the button
Seat 1: 319dcc00 (368,237 in chips)
Seat 2: 6f8884c (563,030 in chips)
Seat 3: Hero (2,322,973 in chips)
Seat 4: 37ff5d80 (428,906 in chips)
Seat 5: 296e9e62 (168,720 in chips)
Seat 6: 892eb287 (1,006,140 in chips)
Seat 7: 793d53d4 (756,512 in chips)
Seat 8: da341a66 (834,303 in chips)
319dcc00: posts the ante 4,500
37ff5d80: posts the ante 4,500
da341a66: posts the ante 4,500
296e9e62: posts the ante 4,500
793d53d4: posts the ante 4,500
892eb287: posts the ante 4,500
Hero: posts the ante 4,500
6f8884c: posts the ante 4,500
319dcc00: posts small blind 15,000
6f8884c: posts big blind 30,000
*** HOLE CARDS ***
Dealt to 319dcc00 
Dealt to 6f8884c 
Dealt to Hero [6s 9d]
Dealt to 37ff5d80 
Dealt to 296e9e62 
Dealt to 892eb287 
Dealt to 793d53d4 
Dealt to da341a66 
Hero: folds
37ff5d80: folds
296e9e62: folds
892eb287: raises 30,000 to 60,000
793d53d4: raises 120,000 to 180,000
da341a66: folds
319dcc00: folds
6f8884c: calls 150,000
892eb287: calls 120,000
*** FLOP *** [Th 4s 2d]
6f8884c: checks
892eb287: checks
793d53d4: bets 572,012 and is all-in
6f8884c: folds
892eb287: folds
Uncalled bet (572,012) returned to 793d53d4
*** SHOWDOWN ***
793d53d4 collected 591,000 from pot
*** SUMMARY ***
Total pot 591,000 | Rake 0 | Jackpot 0 | Bingo 0 | Fortune 0 | Tax 0
Board [Th 4s 2d]
Seat 1: 319dcc00 (small blind) folded before Flop
Seat 2: 6f8884c (big blind) folded on the Flop
Seat 3: Hero folded before Flop
Seat 4: 37ff5d80 folded before Flop
Seat 5: 296e9e62 folded before Flop
Seat 6: 892eb287 folded on the Flop
Seat 7: 793d53d4 won (591,000)
Seat 8: da341a66 (button) folded before Flop


Poker Hand #TM3552711341: Tournament #156543396, Bounty Hunters Special $1.08 Hold'em No Limit - Level30(15,000/30,000) - 2024/08/05 14:19:29
Table '47' 8-max Seat #7 is the button
Seat 1: 319dcc00 (402,737 in chips)
Seat 2: 6f8884c (567,530 in chips)
Seat 3: Hero (2,327,473 in chips)
Seat 4: 37ff5d80 (433,406 in chips)
Seat 5: 296e9e62 (173,220 in chips)
Seat 6: 892eb287 (1,088,640 in chips)
Seat 7: 793d53d4 (761,012 in chips)
Seat 8: da341a66 (694,803 in chips)
319dcc00: posts the ante 4,500
37ff5d80: posts the ante 4,500
da341a66: posts the ante 4,500
296e9e62: posts the ante 4,500
793d53d4: posts the ante 4,500
892eb287: posts the ante 4,500
Hero: posts the ante 4,500
6f8884c: posts the ante 4,500
da341a66: posts small blind 15,000
319dcc00: posts big blind 30,000
*** HOLE CARDS ***
Dealt to 319dcc00 
Dealt to 6f8884c 
Dealt to Hero [Kc 2s]
Dealt to 37ff5d80 
Dealt to 296e9e62 
Dealt to 892eb287 
Dealt to 793d53d4 
Dealt to da341a66 
6f8884c: folds
Hero: folds
37ff5d80: folds
296e9e62: folds
892eb287: raises 48,000 to 78,000
793d53d4: folds
da341a66: calls 63,000
319dcc00: folds
*** FLOP *** [4c 3h Jc]
da341a66: bets 166,500
892eb287: folds
Uncalled bet (166,500) returned to da341a66
*** SHOWDOWN ***
da341a66 collected 222,000 from pot
*** SUMMARY ***
Total pot 222,000 | Rake 0 | Jackpot 0 | Bingo 0 | Fortune 0 | Tax 0
Board [4c 3h Jc]
Seat 1: 319dcc00 (big blind) folded before Flop
Seat 2: 6f8884c folded before Flop
Seat 3: Hero folded before Flop
Seat 4: 37ff5d80 folded before Flop
Seat 5: 296e9e62 folded before Flop
Seat 6: 892eb287 folded on the Flop
Seat 7: 793d53d4 (button) folded before Flop
Seat 8: da341a66 (small blind) won (222,000)


Poker Hand #TM3552711315: Tournament #156543396, Bounty Hunters Special $1.08 Hold'em No Limit - Level30(15,000/30,000) - 2024/08/05 14:18:39
Table '47' 8-max Seat #6 is the button
Seat 1: 319dcc00 (407,237 in chips)
Seat 2: 6f8884c (572,030 in chips)
Seat 3: Hero (2,331,973 in chips)
Seat 4: 37ff5d80 (437,906 in chips)
Seat 5: 296e9e62 (177,720 in chips)
Seat 6: 892eb287 (1,093,140 in chips)
Seat 7: 793d53d4 (699,512 in chips)
Seat 8: da341a66 (729,303 in chips)
319dcc00: posts the ante 4,500
37ff5d80: posts the ante 4,500
da341a66: posts the ante 4,500
296e9e62: posts the ante 4,500
793d53d4: posts the ante 4,500
892eb287: posts the ante 4,500
Hero: posts the ante 4,500
6f8884c: posts the ante 4,500
793d53d4: posts small blind 15,000
da341a66: posts big blind 30,000
*** HOLE CARDS ***
Dealt to 319dcc00 
Dealt to 6f8884c 
Dealt to Hero [4c Ac]
Dealt to 37ff5d80 
Dealt to 296e9e62 
Dealt to 892eb287 
Dealt to 793d53d4 
Dealt to da341a66 
319dcc00: folds
6f8884c: folds
Hero: folds
37ff5d80: folds
296e9e62: folds
892eb287: folds
793d53d4: raises 54,000 to 84,000
da341a66: folds
Uncalled bet (54,000) returned to 793d53d4
*** SHOWDOWN ***
793d53d4 collected 96,000 from pot
*** SUMMARY ***
Total pot 96,000 | Rake 0 | Jackpot 0 | Bingo 0 | Fortune 0 | Tax 0
Seat 1: 319dcc00 folded before Flop
Seat 2: 6f8884c folded before Flop
Seat 3: Hero folded before Flop
Seat 4: 37ff5d80 folded before Flop
Seat 5: 296e9e62 folded before Flop
Seat 6: 892eb287 (button) folded before Flop
Seat 7: 793d53d4 (small blind) collected (96,000)
Seat 8: da341a66 (big blind) folded before Flop


Poker Hand #TM3552711272: Tournament #156543396, Bounty Hunters Special $1.08 Hold'em No Limit - Level29(12,500/25,000) - 2024/08/05 14:17:22
Table '47' 8-max Seat #5 is the button
Seat 1: 319dcc00 (435,737 in chips)
Seat 2: 6f8884c (575,530 in chips)
Seat 3: Hero (2,335,473 in chips)
Seat 4: 37ff5d80 (338,406 in chips)
Seat 5: 296e9e62 (181,220 in chips)
Seat 6: 892eb287 (1,121,640 in chips)
Seat 7: 793d53d4 (728,012 in chips)
Seat 8: da341a66 (732,803 in chips)
319dcc00: posts the ante 3,500
37ff5d80: posts the ante 3,500
da341a66: posts the ante 3,500
296e9e62: posts the ante 3,500
793d53d4: posts the ante 3,500
Hero: posts the ante 3,500
892eb287: posts the ante 3,500
6f8884c: posts the ante 3,500
892eb287: posts small blind 12,500
793d53d4: posts big blind 25,000
*** HOLE CARDS ***
Dealt to 319dcc00 
Dealt to 6f8884c 
Dealt to Hero [Js Td]
Dealt to 37ff5d80 
Dealt to 296e9e62 
Dealt to 892eb287 
Dealt to 793d53d4 
Dealt to da341a66 
da341a66: folds
319dcc00: calls 25,000
6f8884c: folds
Hero: folds
37ff5d80: calls 25,000
296e9e62: folds
892eb287: calls 12,500
793d53d4: checks
*** FLOP *** [3h 5h 9d]
892eb287: checks
793d53d4: checks
319dcc00: checks
37ff5d80: bets 128,000
892eb287: folds
793d53d4: folds
319dcc00: folds
Uncalled bet (128,000) returned to 37ff5d80
*** SHOWDOWN ***
37ff5d80 collected 128,000 from pot
*** SUMMARY ***
Total pot 128,000 | Rake 0 | Jackpot 0 | Bingo 0 | Fortune 0 | Tax 0
Board [3h 5h 9d]
Seat 1: 319dcc00 folded on the Flop
Seat 2: 6f8884c folded before Flop
Seat 3: Hero folded before Flop
Seat 4: 37ff5d80 won (128,000)
Seat 5: 296e9e62 (button) folded before Flop
Seat 6: 892eb287 (small blind) folded on the Flop
Seat 7: 793d53d4 (big blind) folded on the Flop
Seat 8: da341a66 folded before Flop


Poker Hand #TM3552711253: Tournament #156543396, Bounty Hunters Special $1.08 Hold'em No Limit - Level29(12,500/25,000) - 2024/08/05 14:16:34
Table '47' 8-max Seat #4 is the button
Seat 1: 319dcc00 (439,237 in chips)
Seat 2: 6f8884c (579,030 in chips)
Seat 3: Hero (2,338,973 in chips)
Seat 4: 37ff5d80 (341,906 in chips)
Seat 5: 296e9e62 (197,220 in chips)
Seat 6: 892eb287 (1,084,640 in chips)
Seat 7: 793d53d4 (731,512 in chips)
Seat 8: da341a66 (736,303 in chips)
319dcc00: posts the ante 3,500
37ff5d80: posts the ante 3,500
da341a66: posts the ante 3,500
296e9e62: posts the ante 3,500
793d53d4: posts the ante 3,500
Hero: posts the ante 3,500
892eb287: posts the ante 3,500
6f8884c: posts the ante 3,500
296e9e62: posts small blind 12,500
892eb287: posts big blind 25,000
*** HOLE CARDS ***
Dealt to 319dcc00 
Dealt to 6f8884c 
Dealt to Hero [3c 2c]
Dealt to 37ff5d80 
Dealt to 296e9e62 
Dealt to 892eb287 
Dealt to 793d53d4 
Dealt to da341a66 
793d53d4: folds
da341a66: folds
319dcc00: folds
6f8884c: folds
Hero: folds
37ff5d80: folds
296e9e62: folds
Uncalled bet (12,500) returned to 892eb287
*** SHOWDOWN ***
892eb287 collected 53,000 from pot
*** SUMMARY ***
Total pot 53,000 | Rake 0 | Jackpot 0 | Bingo 0 | Fortune 0 | Tax 0
Seat 1: 319dcc00 folded before Flop
Seat 2: 6f8884c folded before Flop
Seat 3: Hero folded before Flop
Seat 4: 37ff5d80 (button) folded before Flop
Seat 5: 296e9e62 (small blind) folded before Flop
Seat 6: 892eb287 (big blind) collected (53,000)
Seat 7: 793d53d4 folded before Flop
Seat 8: da341a66 folded before Flop


Poker Hand #TM3552711222: Tournament #156543396, Bounty Hunters Special $1.08 Hold'em No Limit - Level29(12,500/25,000) - 2024/08/05 14:15:28
Table '47' 8-max Seat #3 is the button
Seat 1: 319dcc00 (442,737 in chips)
Seat 2: 6f8884c (582,530 in chips)
Seat 3: Hero (2,342,473 in chips)
Seat 4: 37ff5d80 (357,906 in chips)
Seat 5: 296e9e62 (225,720 in chips)
Seat 6: 892eb287 (1,088,140 in chips)
Seat 7: 793d53d4 (735,012 in chips)
Seat 8: da341a66 (674,303 in chips)
319dcc00: posts the ante 3,500
37ff5d80: posts the ante 3,500
da341a66: posts the ante 3,500
296e9e62: posts the ante 3,500
793d53d4: posts the ante 3,500
Hero: posts the ante 3,500
892eb287: posts the ante 3,500
6f8884c: posts the ante 3,500
37ff5d80: posts small blind 12,500
296e9e62: posts big blind 25,000
*** HOLE CARDS ***
Dealt to 319dcc00 
Dealt to 6f8884c 
Dealt to Hero [3s Qc]
Dealt to 37ff5d80 
Dealt to 296e9e62 
Dealt to 892eb287 
Dealt to 793d53d4 
Dealt to da341a66 
892eb287: folds
793d53d4: folds
da341a66: raises 50,000 to 75,000
319dcc00: folds
6f8884c: folds
Hero: folds
37ff5d80: folds
296e9e62: folds
Uncalled bet (50,000) returned to da341a66
*** SHOWDOWN ***
da341a66 collected 90,500 from pot
*** SUMMARY ***
Total pot 90,500 | Rake 0 | Jackpot 0 | Bingo 0 | Fortune 0 | Tax 0
Seat 1: 319dcc00 folded before Flop
Seat 2: 6f8884c folded before Flop
Seat 3: Hero (button) folded before Flop
Seat 4: 37ff5d80 (small blind) folded before Flop
Seat 5: 296e9e62 (big blind) folded before Flop
Seat 6: 892eb287 folded before Flop
Seat 7: 793d53d4 folded before Flop
Seat 8: da341a66 collected (90,500)


Poker Hand #TM3552711175: Tournament #156543396, Bounty Hunters Special $1.08 Hold'em No Limit - Level29(12,500/25,000) - 2024/08/05 14:13:39
Table '47' 8-max Seat #2 is the button
Seat 1: 319dcc00 (446,237 in chips)
Seat 2: 6f8884c (675,030 in chips)
Seat 3: Hero (1,874,973 in chips)
Seat 4: 37ff5d80 (386,406 in chips)
Seat 5: 296e9e62 (229,220 in chips)
Seat 6: 892eb287 (1,091,640 in chips)
Seat 7: 793d53d4 (738,512 in chips)
Seat 8: da341a66 (1,006,803 in chips)
319dcc00: posts the ante 3,500
37ff5d80: posts the ante 3,500
da341a66: posts the ante 3,500
296e9e62: posts the ante 3,500
793d53d4: posts the ante 3,500
892eb287: posts the ante 3,500
Hero: posts the ante 3,500
6f8884c: posts the ante 3,500
Hero: posts small blind 12,500
37ff5d80: posts big blind 25,000
*** HOLE CARDS ***
Dealt to 319dcc00 
Dealt to 6f8884c 
Dealt to Hero [6d Qc]
Dealt to 37ff5d80 
Dealt to 296e9e62 
Dealt to 892eb287 
Dealt to 793d53d4 
Dealt to da341a66 
296e9e62: folds
892eb287: folds
793d53d4: folds
da341a66: calls 25,000
319dcc00: folds
6f8884c: calls 25,000
Hero: calls 12,500
37ff5d80: checks
*** FLOP *** [8h 8c 6h]
Hero: checks
37ff5d80: checks
da341a66: checks
6f8884c: checks
*** TURN *** [8h 8c 6h] [5s]
Hero: bets 64,000
37ff5d80: folds
da341a66: calls 64,000
6f8884c: calls 64,000
*** RIVER *** [8h 8c 6h 5s] [Qd]
Hero: checks
da341a66: bets 240,000
6f8884c: folds
Hero: calls 240,000
da341a66: shows [2d 3d] (Pair of Eights)
Hero: shows [6d Qc] (Pair of Queens and Pair of Eights)
*** SHOWDOWN ***
Hero collected 800,000 from pot
*** SUMMARY ***
Total pot 800,000 | Rake 0 | Jackpot 0 | Bingo 0 | Fortune 0 | Tax 0
Board [8h 8c 6h 5s Qd]
Seat 1: 319dcc00 folded before Flop
Seat 2: 6f8884c (button) folded on the River
Seat 3: Hero (small blind) showed [6d Qc] and won (800,000) with Pair of Queens and Pair of Eights
Seat 4: 37ff5d80 (big blind) folded on the Turn
Seat 5: 296e9e62 folded before Flop
Seat 6: 892eb287 folded before Flop
Seat 7: 793d53d4 folded before Flop
Seat 8: da341a66 showed [2d 3d] and lost with Pair of Eights


Poker Hand #TM3552711156: Tournament #156543396, Bounty Hunters Special $1.08 Hold'em No Limit - Level29(12,500/25,000) - 2024/08/05 14:12:58
Table '47' 8-max Seat #1 is the button
Seat 1: 319dcc00 (449,737 in chips)
Seat 2: 6f8884c (691,030 in chips)
Seat 3: Hero (1,903,473 in chips)
Seat 4: 37ff5d80 (324,406 in chips)
Seat 5: 296e9e62 (232,720 in chips)
Seat 6: 892eb287 (1,095,140 in chips)
Seat 7: 793d53d4 (742,012 in chips)
Seat 8: da341a66 (1,010,303 in chips)
319dcc00: posts the ante 3,500
37ff5d80: posts the ante 3,500
da341a66: posts the ante 3,500
296e9e62: posts the ante 3,500
793d53d4: posts the ante 3,500
892eb287: posts the ante 3,500
Hero: posts the ante 3,500
6f8884c: posts the ante 3,500
6f8884c: posts small blind 12,500
Hero: posts big blind 25,000
*** HOLE CARDS ***
Dealt to 319dcc00 
Dealt to 6f8884c 
Dealt to Hero [6s 5d]
Dealt to 37ff5d80 
Dealt to 296e9e62 
Dealt to 892eb287 
Dealt to 793d53d4 
Dealt to da341a66 
37ff5d80: raises 25,000 to 50,000
296e9e62: folds
892eb287: folds
793d53d4: folds
da341a66: folds
319dcc00: folds
6f8884c: folds
Hero: folds
Uncalled bet (25,000) returned to 37ff5d80
*** SHOWDOWN ***
37ff5d80 collected 90,500 from pot
*** SUMMARY ***
Total pot 90,500 | Rake 0 | Jackpot 0 | Bingo 0 | Fortune 0 | Tax 0
Seat 1: 319dcc00 (button) folded before Flop
Seat 2: 6f8884c (small blind) folded before Flop
Seat 3: Hero (big blind) folded before Flop
Seat 4: 37ff5d80 collected (90,500)
Seat 5: 296e9e62 folded before Flop
Seat 6: 892eb287 folded before Flop
Seat 7: 793d53d4 folded before Flop
Seat 8: da341a66 folded before Flop


Poker Hand #TM3552711132: Tournament #156543396, Bounty Hunters Special $1.08 Hold'em No Limit - Level29(12,500/25,000) - 2024/08/05 14:12:08
Table '47' 8-max Seat #8 is the button
Seat 1: 319dcc00 (465,737 in chips)
Seat 2: 6f8884c (719,530 in chips)
Seat 3: Hero (1,791,473 in chips)
Seat 4: 37ff5d80 (327,906 in chips)
Seat 5: 296e9e62 (236,220 in chips)
Seat 6: 892eb287 (1,098,640 in chips)
Seat 7: 793d53d4 (745,512 in chips)
Seat 8: da341a66 (1,063,803 in chips)
319dcc00: posts the ante 3,500
37ff5d80: posts the ante 3,500
da341a66: posts the ante 3,500
296e9e62: posts the ante 3,500
793d53d4: posts the ante 3,500
892eb287: posts the ante 3,500
Hero: posts the ante 3,500
6f8884c: posts the ante 3,500
319dcc00: posts small blind 12,500
6f8884c: posts big blind 25,000
*** HOLE CARDS ***
Dealt to 319dcc00 
Dealt to 6f8884c 
Dealt to Hero [Kd Td]
Dealt to 37ff5d80 
Dealt to 296e9e62 
Dealt to 892eb287 
Dealt to 793d53d4 
Dealt to da341a66 
Hero: raises 25,000 to 50,000
37ff5d80: folds
296e9e62: folds
892eb287: folds
793d53d4: folds
da341a66: calls 50,000
319dcc00: folds
6f8884c: folds
*** FLOP *** [Th Kc 3d]
Hero: bets 54,615
da341a66: folds
Uncalled bet (54,615) returned to Hero
*** SHOWDOWN ***
Hero collected 165,500 from pot
*** SUMMARY ***
Total pot 165,500 | Rake 0 | Jackpot 0 | Bingo 0 | Fortune 0 | Tax 0
Board [Th Kc 3d]
Seat 1: 319dcc00 (small blind) folded before Flop
Seat 2: 6f8884c (big blind) folded before Flop
Seat 3: Hero won (165,500)
Seat 4: 37ff5d80 folded before Flop
Seat 5: 296e9e62 folded before Flop
Seat 6: 892eb287 folded before Flop
Seat 7: 793d53d4 folded before Flop
Seat 8: da341a66 (button) folded on the Flop


Poker Hand #TM3552711113: Tournament #156543396, Bounty Hunters Special $1.08 Hold'em No Limit - Level29(12,500/25,000) - 2024/08/05 14:11:31
Table '47' 8-max Seat #7 is the button
Seat 1: 319dcc00 (494,237 in chips)
Seat 2: 6f8884c (657,530 in chips)
Seat 3: Hero (1,794,973 in chips)
Seat 4: 37ff5d80 (331,406 in chips)
Seat 5: 296e9e62 (239,720 in chips)
Seat 6: 892eb287 (1,102,140 in chips)
Seat 7: 793d53d4 (749,012 in chips)
Seat 8: da341a66 (1,079,803 in chips)
319dcc00: posts the ante 3,500
37ff5d80: posts the ante 3,500
da341a66: posts the ante 3,500
296e9e62: posts the ante 3,500
793d53d4: posts the ante 3,500
892eb287: posts the ante 3,500
Hero: posts the ante 3,500
6f8884c: posts the ante 3,500
da341a66: posts small blind 12,500
319dcc00: posts big blind 25,000
*** HOLE CARDS ***
Dealt to 319dcc00 
Dealt to 6f8884c 
Dealt to Hero [Jc 2d]
Dealt to 37ff5d80 
Dealt to 296e9e62 
Dealt to 892eb287 
Dealt to 793d53d4 
Dealt to da341a66 
6f8884c: raises 50,000 to 75,000
Hero: folds
37ff5d80: folds
296e9e62: folds
892eb287: folds
793d53d4: folds
da341a66: folds
319dcc00: folds
Uncalled bet (50,000) returned to 6f8884c
*** SHOWDOWN ***
6f8884c collected 90,500 from pot
*** SUMMARY ***
Total pot 90,500 | Rake 0 | Jackpot 0 | Bingo 0 | Fortune 0 | Tax 0
Seat 1: 319dcc00 (big blind) folded before Flop
Seat 2: 6f8884c collected (90,500)
Seat 3: Hero folded before Flop
Seat 4: 37ff5d80 folded before Flop
Seat 5: 296e9e62 folded before Flop
Seat 6: 892eb287 folded before Flop
Seat 7: 793d53d4 (button) folded before Flop
Seat 8: da341a66 (small blind) folded before Flop


Poker Hand #TM3552711098: Tournament #156543396, Bounty Hunters Special $1.08 Hold'em No Limit - Level29(12,500/25,000) - 2024/08/05 14:10:53
Table '77' 8-max Seat #6 is the button
Seat 1: fece3a3c (633,861 in chips)
Seat 2: 92ecd93c (594,848 in chips)
Seat 5: 4e67c452 (300,352 in chips)
Seat 6: 1eb12e7b (1,178,140 in chips)
Seat 7: 57a49ef4 (383,735 in chips)
Seat 8: Hero (1,468,121 in chips)
4e67c452: posts the ante 3,500
fece3a3c: posts the ante 3,500
1eb12e7b: posts the ante 3,500
57a49ef4: posts the ante 3,500
92ecd93c: posts the ante 3,500
Hero: posts the ante 3,500
57a49ef4: posts small blind 12,500
Hero: posts big blind 25,000
*** HOLE CARDS ***
Dealt to fece3a3c 
Dealt to 92ecd93c 
Dealt to 4e67c452 
Dealt to 1eb12e7b 
Dealt to 57a49ef4 
Dealt to Hero [Ah Jd]
fece3a3c: folds
92ecd93c: folds
4e67c452: raises 271,852 to 296,852 and is all-in
1eb12e7b: folds
57a49ef4: folds
Hero: calls 271,852
4e67c452: shows [Ks Js]
Hero: shows [Ah Jd]
*** FLOP *** [5c 7s Ad]
*** TURN *** [5c 7s Ad] [9s]
*** RIVER *** [5c 7s Ad 9s] [9c]
*** SHOWDOWN ***
Hero collected 627,204 from pot
*** SUMMARY ***
Total pot 627,204 | Rake 0 | Jackpot 0 | Bingo 0 | Fortune 0 | Tax 0
Board [5c 7s Ad 9s 9c]
Seat 1: fece3a3c folded before Flop
Seat 2: 92ecd93c folded before Flop
Seat 5: 4e67c452 showed [Ks Js] and lost with Pair of Nines
Seat 6: 1eb12e7b (button) folded before Flop
Seat 7: 57a49ef4 (small blind) folded before Flop
Seat 8: Hero (big blind) showed [Ah Jd] and won (627,204) with Pair of Aces and Pair of Nines


Poker Hand #TM3552711090: Tournament #156543396, Bounty Hunters Special $1.08 Hold'em No Limit - Level29(12,500/25,000) - 2024/08/05 14:10:35
Table '77' 8-max Seat #5 is the button
Seat 1: fece3a3c (637,361 in chips)
Seat 2: 92ecd93c (598,348 in chips)
Seat 5: 4e67c452 (303,852 in chips)
Seat 6: 1eb12e7b (1,194,140 in chips)
Seat 7: 57a49ef4 (412,235 in chips)
Seat 8: Hero (1,413,121 in chips)
4e67c452: posts the ante 3,500
fece3a3c: posts the ante 3,500
57a49ef4: posts the ante 3,500
1eb12e7b: posts the ante 3,500
92ecd93c: posts the ante 3,500
Hero: posts the ante 3,500
1eb12e7b: posts small blind 12,500
57a49ef4: posts big blind 25,000
*** HOLE CARDS ***
Dealt to fece3a3c 
Dealt to 92ecd93c 
Dealt to 4e67c452 
Dealt to 1eb12e7b 
Dealt to 57a49ef4 
Dealt to Hero [Ks Kh]
Hero: raises 37,500 to 62,500
fece3a3c: folds
92ecd93c: folds
4e67c452: folds
1eb12e7b: folds
57a49ef4: folds
Uncalled bet (37,500) returned to Hero
*** SHOWDOWN ***
Hero collected 83,500 from pot
*** SUMMARY ***
Total pot 83,500 | Rake 0 | Jackpot 0 | Bingo 0 | Fortune 0 | Tax 0
Seat 1: fece3a3c folded before Flop
Seat 2: 92ecd93c folded before Flop
Seat 5: 4e67c452 (button) folded before Flop
Seat 6: 1eb12e7b (small blind) folded before Flop
Seat 7: 57a49ef4 (big blind) folded before Flop
Seat 8: Hero collected (83,500)


Poker Hand #TM3552711071: Tournament #156543396, Bounty Hunters Special $1.08 Hold'em No Limit - Level28(10,000/20,000) - 2024/08/05 14:09:58
Table '77' 8-max Seat #3 is the button
Seat 1: fece3a3c (640,361 in chips)
Seat 2: 92ecd93c (601,348 in chips)
Seat 3: a117c86b (391,602 in chips)
Seat 5: 4e67c452 (316,852 in chips)
Seat 6: 1eb12e7b (777,538 in chips)
Seat 7: 57a49ef4 (415,235 in chips)
Seat 8: Hero (1,416,121 in chips)
4e67c452: posts the ante 3,000
a117c86b: posts the ante 3,000
fece3a3c: posts the ante 3,000
57a49ef4: posts the ante 3,000
1eb12e7b: posts the ante 3,000
92ecd93c: posts the ante 3,000
Hero: posts the ante 3,000
4e67c452: posts small blind 10,000
1eb12e7b: posts big blind 20,000
*** HOLE CARDS ***
Dealt to fece3a3c 
Dealt to 92ecd93c 
Dealt to a117c86b 
Dealt to 4e67c452 
Dealt to 1eb12e7b 
Dealt to 57a49ef4 
Dealt to Hero [9d Ts]
57a49ef4: folds
Hero: folds
fece3a3c: folds
92ecd93c: folds
a117c86b: raises 368,602 to 388,602 and is all-in
4e67c452: folds
1eb12e7b: calls 368,602
a117c86b: shows [Jh As]
1eb12e7b: shows [Js Jc]
*** FLOP *** [4d 4c 2d]
*** TURN *** [4d 4c 2d] [4s]
*** RIVER *** [4d 4c 2d 4s] [Qd]
*** SHOWDOWN ***
1eb12e7b collected 808,204 from pot
*** SUMMARY ***
Total pot 808,204 | Rake 0 | Jackpot 0 | Bingo 0 | Fortune 0 | Tax 0
Board [4d 4c 2d 4s Qd]
Seat 1: fece3a3c folded before Flop
Seat 2: 92ecd93c folded before Flop
Seat 3: a117c86b (button) showed [Jh As] and lost with Three Fours
Seat 5: 4e67c452 (small blind) folded before Flop
Seat 6: 1eb12e7b (big blind) showed [Js Jc] and won (808,204) with Fours Full over Jacks
Seat 7: 57a49ef4 folded before Flop
Seat 8: Hero folded before Flop


Poker Hand #TM3552711061: Tournament #156543396, Bounty Hunters Special $1.08 Hold'em No Limit - Level28(10,000/20,000) - 2024/08/05 14:09:22
Table '77' 8-max Seat #2 is the button
Seat 1: fece3a3c (592,361 in chips)
Seat 2: 92ecd93c (604,348 in chips)
Seat 3: a117c86b (404,602 in chips)
Seat 5: 4e67c452 (339,852 in chips)
Seat 6: 1eb12e7b (780,538 in chips)
Seat 7: 57a49ef4 (418,235 in chips)
Seat 8: Hero (1,419,121 in chips)
4e67c452: posts the ante 3,000
a117c86b: posts the ante 3,000
fece3a3c: posts the ante 3,000
57a49ef4: posts the ante 3,000
1eb12e7b: posts the ante 3,000
92ecd93c: posts the ante 3,000
Hero: posts the ante 3,000
a117c86b: posts small blind 10,000
4e67c452: posts big blind 20,000
*** HOLE CARDS ***
Dealt to fece3a3c 
Dealt to 92ecd93c 
Dealt to a117c86b 
Dealt to 4e67c452 
Dealt to 1eb12e7b 
Dealt to 57a49ef4 
Dealt to Hero [7d As]
1eb12e7b: folds
57a49ef4: folds
Hero: folds
fece3a3c: calls 20,000
92ecd93c: folds
a117c86b: folds
4e67c452: checks
*** FLOP *** [Qc 9s 4c]
4e67c452: checks
fece3a3c: checks
*** TURN *** [Qc 9s 4c] [7c]
4e67c452: checks
fece3a3c: checks
*** RIVER *** [Qc 9s 4c 7c] [Kd]
4e67c452: checks
fece3a3c: checks
4e67c452: shows [8c 4s] (Pair of Fours)
fece3a3c: shows [Kh Ts] (Pair of Kings)
*** SHOWDOWN ***
fece3a3c collected 71,000 from pot
*** SUMMARY ***
Total pot 71,000 | Rake 0 | Jackpot 0 | Bingo 0 | Fortune 0 | Tax 0
Board [Qc 9s 4c 7c Kd]
Seat 1: fece3a3c showed [Kh Ts] and won (71,000) with Pair of Kings
Seat 2: 92ecd93c (button) folded before Flop
Seat 3: a117c86b (small blind) folded before Flop
Seat 5: 4e67c452 (big blind) showed [8c 4s] and lost with Pair of Fours
Seat 6: 1eb12e7b folded before Flop
Seat 7: 57a49ef4 folded before Flop
Seat 8: Hero folded before Flop


Poker Hand #TM3552711048: Tournament #156543396, Bounty Hunters Special $1.08 Hold'em No Limit - Level28(10,000/20,000) - 2024/08/05 14:08:31
Table '77' 8-max Seat #1 is the button
Seat 1: fece3a3c (595,361 in chips)
Seat 2: 92ecd93c (273,174 in chips)
Seat 3: a117c86b (677,776 in chips)
Seat 4: 4e9c4c34 (601,934 in chips)
Seat 5: 4e67c452 (342,852 in chips)
Seat 6: 1eb12e7b (783,538 in chips)
Seat 7: 57a49ef4 (421,235 in chips)
Seat 8: Hero (1,422,121 in chips)
4e67c452: posts the ante 3,000
4e9c4c34: posts the ante 3,000
a117c86b: posts the ante 3,000
fece3a3c: posts the ante 3,000
57a49ef4: posts the ante 3,000
1eb12e7b: posts the ante 3,000
92ecd93c: posts the ante 3,000
Hero: posts the ante 3,000
92ecd93c: posts small blind 10,000
a117c86b: posts big blind 20,000
*** HOLE CARDS ***
Dealt to fece3a3c 
Dealt to 92ecd93c 
Dealt to a117c86b 
Dealt to 4e9c4c34 
Dealt to 4e67c452 
Dealt to 1eb12e7b 
Dealt to 57a49ef4 
Dealt to Hero [3s Ad]
4e9c4c34: raises 20,000 to 40,000
4e67c452: folds
1eb12e7b: folds
57a49ef4: folds
Hero: folds
fece3a3c: folds
92ecd93c: raises 230,174 to 270,174 and is all-in
a117c86b: raises 404,602 to 674,776 and is all-in
4e9c4c34: folds
Uncalled bet (404,602) returned to a117c86b
a117c86b: shows [Kh Th]
92ecd93c: shows [9s 9h]
*** FLOP *** [2d 4d Qs]
*** TURN *** [2d 4d Qs] [6s]
*** RIVER *** [2d 4d Qs 6s] [5h]
Hero: shows [3s Ad] (Sixes-High Straight)
*** SHOWDOWN ***
92ecd93c collected 604,348 from pot
*** SUMMARY ***
Total pot 604,348 | Rake 0 | Jackpot 0 | Bingo 0 | Fortune 0 | Tax 0
Board [2d 4d Qs 6s 5h]
Seat 1: fece3a3c (button) folded before Flop
Seat 2: 92ecd93c (small blind) showed [9s 9h] and won (604,348) with Pair of Nines
Seat 3: a117c86b (big blind) showed [Kh Th] and lost with King-High
Seat 4: 4e9c4c34 folded before Flop
Seat 5: 4e67c452 folded before Flop
Seat 6: 1eb12e7b folded before Flop
Seat 7: 57a49ef4 folded before Flop
Seat 8: Hero folded before Flop


Poker Hand #TM3552711042: Tournament #156543396, Bounty Hunters Special $1.08 Hold'em No Limit - Level28(10,000/20,000) - 2024/08/05 14:08:01
Table '77' 8-max Seat #8 is the button
Seat 1: fece3a3c (618,361 in chips)
Seat 2: 92ecd93c (232,174 in chips)
Seat 3: a117c86b (680,776 in chips)
Seat 4: 4e9c4c34 (604,934 in chips)
Seat 5: 4e67c452 (345,852 in chips)
Seat 6: 1eb12e7b (786,538 in chips)
Seat 7: 57a49ef4 (424,235 in chips)
Seat 8: Hero (1,425,121 in chips)
4e67c452: posts the ante 3,000
4e9c4c34: posts the ante 3,000
a117c86b: posts the ante 3,000
fece3a3c: posts the ante 3,000
57a49ef4: posts the ante 3,000
1eb12e7b: posts the ante 3,000
92ecd93c: posts the ante 3,000
Hero: posts the ante 3,000
fece3a3c: posts small blind 10,000
92ecd93c: posts big blind 20,000
*** HOLE CARDS ***
Dealt to fece3a3c 
Dealt to 92ecd93c 
Dealt to a117c86b 
Dealt to 4e9c4c34 
Dealt to 4e67c452 
Dealt to 1eb12e7b 
Dealt to 57a49ef4 
Dealt to Hero [2c 5h]
a117c86b: folds
4e9c4c34: folds
4e67c452: folds
1eb12e7b: folds
57a49ef4: folds
Hero: folds
fece3a3c: calls 10,000
92ecd93c: checks
*** FLOP *** [Ah Qd 3s]
fece3a3c: checks
92ecd93c: bets 38,400
fece3a3c: folds
Uncalled bet (38,400) returned to 92ecd93c
*** SHOWDOWN ***
92ecd93c collected 64,000 from pot
*** SUMMARY ***
Total pot 64,000 | Rake 0 | Jackpot 0 | Bingo 0 | Fortune 0 | Tax 0
Board [Ah Qd 3s]
Seat 1: fece3a3c (small blind) folded on the Flop
Seat 2: 92ecd93c (big blind) won (64,000)
Seat 3: a117c86b folded before Flop
Seat 4: 4e9c4c34 folded before Flop
Seat 5: 4e67c452 folded before Flop
Seat 6: 1eb12e7b folded before Flop
Seat 7: 57a49ef4 folded before Flop
Seat 8: Hero (button) folded before Flop


Poker Hand #TM3552711034: Tournament #156543396, Bounty Hunters Special $1.08 Hold'em No Limit - Level28(10,000/20,000) - 2024/08/05 14:07:39
Table '77' 8-max Seat #7 is the button
Seat 1: fece3a3c (641,361 in chips)
Seat 2: 92ecd93c (235,174 in chips)
Seat 3: a117c86b (683,776 in chips)
Seat 4: 4e9c4c34 (607,934 in chips)
Seat 5: 4e67c452 (348,852 in chips)
Seat 6: 1eb12e7b (789,538 in chips)
Seat 7: 57a49ef4 (373,235 in chips)
Seat 8: Hero (1,438,121 in chips)
4e67c452: posts the ante 3,000
4e9c4c34: posts the ante 3,000
a117c86b: posts the ante 3,000
fece3a3c: posts the ante 3,000
57a49ef4: posts the ante 3,000
1eb12e7b: posts the ante 3,000
92ecd93c: posts the ante 3,000
Hero: posts the ante 3,000
Hero: posts small blind 10,000
fece3a3c: posts big blind 20,000
*** HOLE CARDS ***
Dealt to fece3a3c 
Dealt to 92ecd93c 
Dealt to a117c86b 
Dealt to 4e9c4c34 
Dealt to 4e67c452 
Dealt to 1eb12e7b 
Dealt to 57a49ef4 
Dealt to Hero [7d Kc]
92ecd93c: folds
a117c86b: folds
4e9c4c34: folds
4e67c452: folds
1eb12e7b: folds
57a49ef4: raises 40,000 to 60,000
Hero: folds
fece3a3c: folds
Uncalled bet (40,000) returned to 57a49ef4
*** SHOWDOWN ***
57a49ef4 collected 74,000 from pot
*** SUMMARY ***
Total pot 74,000 | Rake 0 | Jackpot 0 | Bingo 0 | Fortune 0 | Tax 0
Seat 1: fece3a3c (big blind) folded before Flop
Seat 2: 92ecd93c folded before Flop
Seat 3: a117c86b folded before Flop
Seat 4: 4e9c4c34 folded before Flop
Seat 5: 4e67c452 folded before Flop
Seat 6: 1eb12e7b folded before Flop
Seat 7: 57a49ef4 (button) collected (74,000)
Seat 8: Hero (small blind) folded before Flop


Poker Hand #TM3552711030: Tournament #156543396, Bounty Hunters Special $1.08 Hold'em No Limit - Level28(10,000/20,000) - 2024/08/05 14:07:17
Table '77' 8-max Seat #6 is the button
Seat 1: fece3a3c (644,361 in chips)
Seat 2: 92ecd93c (238,174 in chips)
Seat 3: a117c86b (686,776 in chips)
Seat 4: 4e9c4c34 (610,934 in chips)
Seat 5: 4e67c452 (351,852 in chips)
Seat 6: 1eb12e7b (792,538 in chips)
Seat 7: 57a49ef4 (386,235 in chips)
Seat 8: Hero (1,407,121 in chips)
4e67c452: posts the ante 3,000
4e9c4c34: posts the ante 3,000
a117c86b: posts the ante 3,000
fece3a3c: posts the ante 3,000
1eb12e7b: posts the ante 3,000
57a49ef4: posts the ante 3,000
92ecd93c: posts the ante 3,000
Hero: posts the ante 3,000
57a49ef4: posts small blind 10,000
Hero: posts big blind 20,000
*** HOLE CARDS ***
Dealt to fece3a3c 
Dealt to 92ecd93c 
Dealt to a117c86b 
Dealt to 4e9c4c34 
Dealt to 4e67c452 
Dealt to 1eb12e7b 
Dealt to 57a49ef4 
Dealt to Hero [3d 7h]
fece3a3c: folds
92ecd93c: folds
a117c86b: folds
4e9c4c34: folds
4e67c452: folds
1eb12e7b: folds
57a49ef4: folds
Uncalled bet (10,000) returned to Hero
Hero: shows [3d 7h]
*** SHOWDOWN ***
Hero collected 44,000 from pot
*** SUMMARY ***
Total pot 44,000 | Rake 0 | Jackpot 0 | Bingo 0 | Fortune 0 | Tax 0
Seat 1: fece3a3c folded before Flop
Seat 2: 92ecd93c folded before Flop
Seat 3: a117c86b folded before Flop
Seat 4: 4e9c4c34 folded before Flop
Seat 5: 4e67c452 folded before Flop
Seat 6: 1eb12e7b (button) folded before Flop
Seat 7: 57a49ef4 (small blind) folded before Flop
Seat 8: Hero (big blind) showed [3d 7h] and collected (44,000)


Poker Hand #TM3552711012: Tournament #156543396, Bounty Hunters Special $1.08 Hold'em No Limit - Level28(10,000/20,000) - 2024/08/05 14:06:16
Table '77' 8-max Seat #5 is the button
Seat 1: fece3a3c (647,361 in chips)
Seat 2: 92ecd93c (241,174 in chips)
Seat 3: a117c86b (689,776 in chips)
Seat 4: 4e9c4c34 (613,934 in chips)
Seat 5: 4e67c452 (354,852 in chips)
Seat 6: 1eb12e7b (815,538 in chips)
Seat 7: 57a49ef4 (345,235 in chips)
Seat 8: Hero (1,410,121 in chips)
4e67c452: posts the ante 3,000
4e9c4c34: posts the ante 3,000
a117c86b: posts the ante 3,000
fece3a3c: posts the ante 3,000
57a49ef4: posts the ante 3,000
1eb12e7b: posts the ante 3,000
92ecd93c: posts the ante 3,000
Hero: posts the ante 3,000
1eb12e7b: posts small blind 10,000
57a49ef4: posts big blind 20,000
*** HOLE CARDS ***
Dealt to fece3a3c 
Dealt to 92ecd93c 
Dealt to a117c86b 
Dealt to 4e9c4c34 
Dealt to 4e67c452 
Dealt to 1eb12e7b 
Dealt to 57a49ef4 
Dealt to Hero [Jd 7h]
Hero: folds
fece3a3c: folds
92ecd93c: folds
a117c86b: folds
4e9c4c34: folds
4e67c452: folds
1eb12e7b: calls 10,000
57a49ef4: checks
*** FLOP *** [2s 8h 2d]
1eb12e7b: checks
57a49ef4: checks
*** TURN *** [2s 8h 2d] [Th]
1eb12e7b: checks
57a49ef4: checks
*** RIVER *** [2s 8h 2d Th] [2h]
1eb12e7b: checks
57a49ef4: checks
1eb12e7b: shows [Jc 9c] (Three Twos)
57a49ef4: shows [Kc 9s] (Three Twos)
*** SHOWDOWN ***
57a49ef4 collected 64,000 from pot
*** SUMMARY ***
Total pot 64,000 | Rake 0 | Jackpot 0 | Bingo 0 | Fortune 0 | Tax 0
Board [2s 8h 2d Th 2h]
Seat 1: fece3a3c folded before Flop
Seat 2: 92ecd93c folded before Flop
Seat 3: a117c86b folded before Flop
Seat 4: 4e9c4c34 folded before Flop
Seat 5: 4e67c452 (button) folded before Flop
Seat 6: 1eb12e7b (small blind) showed [Jc 9c] and lost with Three Twos
Seat 7: 57a49ef4 (big blind) showed [Kc 9s] and won (64,000) with Three Twos
Seat 8: Hero folded before Flop


Poker Hand #TM3552711006: Tournament #156543396, Bounty Hunters Special $1.08 Hold'em No Limit - Level28(10,000/20,000) - 2024/08/05 14:05:56
Table '77' 8-max Seat #4 is the button
Seat 1: fece3a3c (650,361 in chips)
Seat 2: 92ecd93c (244,174 in chips)
Seat 3: a117c86b (692,776 in chips)
Seat 4: 4e9c4c34 (616,934 in chips)
Seat 5: 4e67c452 (367,852 in chips)
Seat 6: 1eb12e7b (784,538 in chips)
Seat 7: 57a49ef4 (348,235 in chips)
Seat 8: Hero (1,413,121 in chips)
4e9c4c34: posts the ante 3,000
4e67c452: posts the ante 3,000
a117c86b: posts the ante 3,000
fece3a3c: posts the ante 3,000
57a49ef4: posts the ante 3,000
1eb12e7b: posts the ante 3,000
92ecd93c: posts the ante 3,000
Hero: posts the ante 3,000
4e67c452: posts small blind 10,000
1eb12e7b: posts big blind 20,000
*** HOLE CARDS ***
Dealt to fece3a3c 
Dealt to 92ecd93c 
Dealt to a117c86b 
Dealt to 4e9c4c34 
Dealt to 4e67c452 
Dealt to 1eb12e7b 
Dealt to 57a49ef4 
Dealt to Hero [9d 3d]
57a49ef4: folds
Hero: folds
fece3a3c: folds
92ecd93c: folds
a117c86b: folds
4e9c4c34: folds
4e67c452: folds
Uncalled bet (10,000) returned to 1eb12e7b
*** SHOWDOWN ***
1eb12e7b collected 44,000 from pot
*** SUMMARY ***
Total pot 44,000 | Rake 0 | Jackpot 0 | Bingo 0 | Fortune 0 | Tax 0
Seat 1: fece3a3c folded before Flop
Seat 2: 92ecd93c folded before Flop
Seat 3: a117c86b folded before Flop
Seat 4: 4e9c4c34 (button) folded before Flop
Seat 5: 4e67c452 (small blind) folded before Flop
Seat 6: 1eb12e7b (big blind) collected (44,000)
Seat 7: 57a49ef4 folded before Flop
Seat 8: Hero folded before Flop


Poker Hand #TM3552710989: Tournament #156543396, Bounty Hunters Special $1.08 Hold'em No Limit - Level28(10,000/20,000) - 2024/08/05 14:04:44
Table '77' 8-max Seat #3 is the button
Seat 1: fece3a3c (673,361 in chips)
Seat 2: 92ecd93c (247,174 in chips)
Seat 3: a117c86b (695,776 in chips)
Seat 4: 4e9c4c34 (781,860 in chips)
Seat 5: 4e67c452 (164,926 in chips)
Seat 6: 1eb12e7b (787,538 in chips)
Seat 7: 57a49ef4 (351,235 in chips)
Seat 8: Hero (1,416,121 in chips)
4e67c452: posts the ante 3,000
4e9c4c34: posts the ante 3,000
a117c86b: posts the ante 3,000
fece3a3c: posts the ante 3,000
57a49ef4: posts the ante 3,000
1eb12e7b: posts the ante 3,000
92ecd93c: posts the ante 3,000
Hero: posts the ante 3,000
4e9c4c34: posts small blind 10,000
4e67c452: posts big blind 20,000
*** HOLE CARDS ***
Dealt to fece3a3c 
Dealt to 92ecd93c 
Dealt to a117c86b 
Dealt to 4e9c4c34 
Dealt to 4e67c452 
Dealt to 1eb12e7b 
Dealt to 57a49ef4 
Dealt to Hero [2h 2d]
1eb12e7b: folds
57a49ef4: folds
Hero: folds
fece3a3c: calls 20,000
92ecd93c: folds
a117c86b: folds
4e9c4c34: raises 80,000 to 100,000
4e67c452: raises 61,926 to 161,926 and is all-in
fece3a3c: folds
4e9c4c34: calls 61,926
4e67c452: shows [Ad Jd]
4e9c4c34: shows [Kd Qs]
*** FLOP *** [2c Ts 7c]
*** TURN *** [2c Ts 7c] [8h]
*** RIVER *** [2c Ts 7c 8h] [5d]
1eb12e7b: shows [Td 2s] (Pair of Tens and Pair of Twos)
*** SHOWDOWN ***
4e67c452 collected 367,852 from pot
*** SUMMARY ***
Total pot 367,852 | Rake 0 | Jackpot 0 | Bingo 0 | Fortune 0 | Tax 0
Board [2c Ts 7c 8h 5d]
Seat 1: fece3a3c folded before Flop
Seat 2: 92ecd93c folded before Flop
Seat 3: a117c86b (button) folded before Flop
Seat 4: 4e9c4c34 (small blind) showed [Kd Qs] and lost with King-High
Seat 5: 4e67c452 (big blind) showed [Ad Jd] and won (367,852) with Ace-High
Seat 6: 1eb12e7b folded before Flop
Seat 7: 57a49ef4 folded before Flop
Seat 8: Hero folded before Flop


Poker Hand #TM3552710981: Tournament #156543396, Bounty Hunters Special $1.08 Hold'em No Limit - Level28(10,000/20,000) - 2024/08/05 14:03:58
Table '77' 8-max Seat #2 is the button
Seat 1: fece3a3c (676,361 in chips)
Seat 2: 92ecd93c (250,174 in chips)
Seat 3: a117c86b (624,776 in chips)
Seat 4: 4e9c4c34 (834,860 in chips)
Seat 5: 4e67c452 (167,926 in chips)
Seat 6: 1eb12e7b (790,538 in chips)
Seat 7: 57a49ef4 (354,235 in chips)
Seat 8: Hero (1,419,121 in chips)
4e67c452: posts the ante 3,000
4e9c4c34: posts the ante 3,000
a117c86b: posts the ante 3,000
fece3a3c: posts the ante 3,000
57a49ef4: posts the ante 3,000
1eb12e7b: posts the ante 3,000
92ecd93c: posts the ante 3,000
Hero: posts the ante 3,000
a117c86b: posts small blind 10,000
4e9c4c34: posts big blind 20,000
*** HOLE CARDS ***
Dealt to fece3a3c 
Dealt to 92ecd93c 
Dealt to a117c86b 
Dealt to 4e9c4c34 
Dealt to 4e67c452 
Dealt to 1eb12e7b 
Dealt to 57a49ef4 
Dealt to Hero [9h 4d]
4e67c452: folds
1eb12e7b: folds
57a49ef4: folds
Hero: folds
fece3a3c: folds
92ecd93c: folds
a117c86b: raises 30,000 to 50,000
4e9c4c34: calls 30,000
*** FLOP *** [5h 8d Qc]
a117c86b: bets 40,920
4e9c4c34: folds
Uncalled bet (40,920) returned to a117c86b
*** SHOWDOWN ***
a117c86b collected 124,000 from pot
*** SUMMARY ***
Total pot 124,000 | Rake 0 | Jackpot 0 | Bingo 0 | Fortune 0 | Tax 0
Board [5h 8d Qc]
Seat 1: fece3a3c folded before Flop
Seat 2: 92ecd93c (button) folded before Flop
Seat 3: a117c86b (small blind) won (124,000)
Seat 4: 4e9c4c34 (big blind) folded on the Flop
Seat 5: 4e67c452 folded before Flop
Seat 6: 1eb12e7b folded before Flop
Seat 7: 57a49ef4 folded before Flop
Seat 8: Hero folded before Flop


Poker Hand #TM3552710976: Tournament #156543396, Bounty Hunters Special $1.08 Hold'em No Limit - Level28(10,000/20,000) - 2024/08/05 14:03:12
Table '77' 8-max Seat #1 is the button
Seat 1: fece3a3c (679,361 in chips)
Seat 2: 92ecd93c (293,174 in chips)
Seat 3: a117c86b (563,776 in chips)
Seat 4: 4e9c4c34 (837,860 in chips)
Seat 5: 4e67c452 (170,926 in chips)
Seat 6: 1eb12e7b (793,538 in chips)
Seat 7: 57a49ef4 (357,235 in chips)
Seat 8: Hero (1,422,121 in chips)
4e67c452: posts the ante 3,000
4e9c4c34: posts the ante 3,000
a117c86b: posts the ante 3,000
fece3a3c: posts the ante 3,000
57a49ef4: posts the ante 3,000
1eb12e7b: posts the ante 3,000
92ecd93c: posts the ante 3,000
Hero: posts the ante 3,000
92ecd93c: posts small blind 10,000
a117c86b: posts big blind 20,000
*** HOLE CARDS ***
Dealt to fece3a3c 
Dealt to 92ecd93c 
Dealt to a117c86b 
Dealt to 4e9c4c34 
Dealt to 4e67c452 
Dealt to 1eb12e7b 
Dealt to 57a49ef4 
Dealt to Hero [Qh 4s]
4e9c4c34: folds
4e67c452: folds
1eb12e7b: folds
57a49ef4: folds
Hero: folds
fece3a3c: folds
92ecd93c: raises 20,000 to 40,000
a117c86b: calls 20,000
*** FLOP *** [7s 7h Jc]
92ecd93c: checks
a117c86b: checks
*** TURN *** [7s 7h Jc] [5h]
92ecd93c: checks
a117c86b: bets 45,760
92ecd93c: folds
Uncalled bet (45,760) returned to a117c86b
*** SHOWDOWN ***
a117c86b collected 104,000 from pot
*** SUMMARY ***
Total pot 104,000 | Rake 0 | Jackpot 0 | Bingo 0 | Fortune 0 | Tax 0
Board [7s 7h Jc 5h]
Seat 1: fece3a3c (button) folded before Flop
Seat 2: 92ecd93c (small blind) folded on the Turn
Seat 3: a117c86b (big blind) won (104,000)
Seat 4: 4e9c4c34 folded before Flop
Seat 5: 4e67c452 folded before Flop
Seat 6: 1eb12e7b folded before Flop
Seat 7: 57a49ef4 folded before Flop
Seat 8: Hero folded before Flop


Poker Hand #TM3552710969: Tournament #156543396, Bounty Hunters Special $1.08 Hold'em No Limit - Level28(10,000/20,000) - 2024/08/05 14:02:45
Table '77' 8-max Seat #8 is the button
Seat 1: fece3a3c (692,361 in chips)
Seat 2: 92ecd93c (316,174 in chips)
Seat 3: a117c86b (566,776 in chips)
Seat 4: 4e9c4c34 (840,860 in chips)
Seat 5: 4e67c452 (173,926 in chips)
Seat 6: 1eb12e7b (796,538 in chips)
Seat 7: 57a49ef4 (360,235 in chips)
Seat 8: Hero (1,371,121 in chips)
4e67c452: posts the ante 3,000
4e9c4c34: posts the ante 3,000
a117c86b: posts the ante 3,000
fece3a3c: posts the ante 3,000
57a49ef4: posts the ante 3,000
1eb12e7b: posts the ante 3,000
92ecd93c: posts the ante 3,000
Hero: posts the ante 3,000
fece3a3c: posts small blind 10,000
92ecd93c: posts big blind 20,000
*** HOLE CARDS ***
Dealt to fece3a3c 
Dealt to 92ecd93c 
Dealt to a117c86b 
Dealt to 4e9c4c34 
Dealt to 4e67c452 
Dealt to 1eb12e7b 
Dealt to 57a49ef4 
Dealt to Hero [Tc Qc]
a117c86b: folds
4e9c4c34: folds
4e67c452: folds
1eb12e7b: folds
57a49ef4: folds
Hero: raises 20,000 to 40,000
fece3a3c: folds
92ecd93c: folds
Uncalled bet (20,000) returned to Hero
*** SHOWDOWN ***
Hero collected 74,000 from pot
*** SUMMARY ***
Total pot 74,000 | Rake 0 | Jackpot 0 | Bingo 0 | Fortune 0 | Tax 0
Seat 1: fece3a3c (small blind) folded before Flop
Seat 2: 92ecd93c (big blind) folded before Flop
Seat 3: a117c86b folded before Flop
Seat 4: 4e9c4c34 folded before Flop
Seat 5: 4e67c452 folded before Flop
Seat 6: 1eb12e7b folded before Flop
Seat 7: 57a49ef4 folded before Flop
Seat 8: Hero (button) collected (74,000)


Poker Hand #TM3552710964: Tournament #156543396, Bounty Hunters Special $1.08 Hold'em No Limit - Level27(8,000/16,000) - 2024/08/05 14:02:10
Table '77' 8-max Seat #7 is the button
Seat 1: fece3a3c (734,861 in chips)
Seat 2: 92ecd93c (318,674 in chips)
Seat 3: a117c86b (569,276 in chips)
Seat 4: 4e9c4c34 (843,360 in chips)
Seat 5: 4e67c452 (176,426 in chips)
Seat 6: 1eb12e7b (799,038 in chips)
Seat 7: 57a49ef4 (362,735 in chips)
Seat 8: Hero (1,313,621 in chips)
4e67c452: posts the ante 2,500
4e9c4c34: posts the ante 2,500
a117c86b: posts the ante 2,500
fece3a3c: posts the ante 2,500
57a49ef4: posts the ante 2,500
1eb12e7b: posts the ante 2,500
92ecd93c: posts the ante 2,500
Hero: posts the ante 2,500
Hero: posts small blind 8,000
fece3a3c: posts big blind 16,000
*** HOLE CARDS ***
Dealt to fece3a3c 
Dealt to 92ecd93c 
Dealt to a117c86b 
Dealt to 4e9c4c34 
Dealt to 4e67c452 
Dealt to 1eb12e7b 
Dealt to 57a49ef4 
Dealt to Hero [Ac 8c]
92ecd93c: folds
a117c86b: folds
4e9c4c34: folds
4e67c452: folds
1eb12e7b: folds
57a49ef4: folds
Hero: raises 24,000 to 40,000
fece3a3c: calls 24,000
*** FLOP *** [4d Th 9d]
Hero: checks
fece3a3c: checks
*** TURN *** [4d Th 9d] [As]
Hero: bets 50,000
fece3a3c: folds
Uncalled bet (50,000) returned to Hero
*** SHOWDOWN ***
Hero collected 100,000 from pot
*** SUMMARY ***
Total pot 100,000 | Rake 0 | Jackpot 0 | Bingo 0 | Fortune 0 | Tax 0
Board [4d Th 9d As]
Seat 1: fece3a3c (big blind) folded on the Turn
Seat 2: 92ecd93c folded before Flop
Seat 3: a117c86b folded before Flop
Seat 4: 4e9c4c34 folded before Flop
Seat 5: 4e67c452 folded before Flop
Seat 6: 1eb12e7b folded before Flop
Seat 7: 57a49ef4 (button) folded before Flop
Seat 8: Hero (small blind) won (100,000)


Poker Hand #TM3552710961: Tournament #156543396, Bounty Hunters Special $1.08 Hold'em No Limit - Level27(8,000/16,000) - 2024/08/05 14:01:47
Table '77' 8-max Seat #6 is the button
Seat 1: fece3a3c (737,361 in chips)
Seat 2: 92ecd93c (277,174 in chips)
Seat 3: a117c86b (571,776 in chips)
Seat 4: 4e9c4c34 (845,860 in chips)
Seat 5: 4e67c452 (178,926 in chips)
Seat 6: 1eb12e7b (801,538 in chips)
Seat 7: 57a49ef4 (373,235 in chips)
Seat 8: Hero (1,332,121 in chips)
4e67c452: posts the ante 2,500
4e9c4c34: posts the ante 2,500
a117c86b: posts the ante 2,500
fece3a3c: posts the ante 2,500
1eb12e7b: posts the ante 2,500
57a49ef4: posts the ante 2,500
92ecd93c: posts the ante 2,500
Hero: posts the ante 2,500
57a49ef4: posts small blind 8,000
Hero: posts big blind 16,000
*** HOLE CARDS ***
Dealt to fece3a3c 
Dealt to 92ecd93c 
Dealt to a117c86b 
Dealt to 4e9c4c34 
Dealt to 4e67c452 
Dealt to 1eb12e7b 
Dealt to 57a49ef4 
Dealt to Hero [4s 6d]
fece3a3c: folds
92ecd93c: raises 16,000 to 32,000
a117c86b: folds
4e9c4c34: folds
4e67c452: folds
1eb12e7b: folds
57a49ef4: folds
Hero: folds
Uncalled bet (16,000) returned to 92ecd93c
*** SHOWDOWN ***
92ecd93c collected 60,000 from pot
*** SUMMARY ***
Total pot 60,000 | Rake 0 | Jackpot 0 | Bingo 0 | Fortune 0 | Tax 0
Seat 1: fece3a3c folded before Flop
Seat 2: 92ecd93c collected (60,000)
Seat 3: a117c86b folded before Flop
Seat 4: 4e9c4c34 folded before Flop
Seat 5: 4e67c452 folded before Flop
Seat 6: 1eb12e7b (button) folded before Flop
Seat 7: 57a49ef4 (small blind) folded before Flop
Seat 8: Hero (big blind) folded before Flop


Poker Hand #TM3552710948: Tournament #156543396, Bounty Hunters Special $1.08 Hold'em No Limit - Level27(8,000/16,000) - 2024/08/05 14:00:55
Table '77' 8-max Seat #5 is the button
Seat 1: fece3a3c (739,861 in chips)
Seat 2: 92ecd93c (279,674 in chips)
Seat 3: a117c86b (574,276 in chips)
Seat 4: 4e9c4c34 (804,360 in chips)
Seat 5: 4e67c452 (181,426 in chips)
Seat 6: 1eb12e7b (812,038 in chips)
Seat 7: 57a49ef4 (391,735 in chips)
Seat 8: Hero (1,334,621 in chips)
4e67c452: posts the ante 2,500
4e9c4c34: posts the ante 2,500
a117c86b: posts the ante 2,500
fece3a3c: posts the ante 2,500
57a49ef4: posts the ante 2,500
1eb12e7b: posts the ante 2,500
92ecd93c: posts the ante 2,500
Hero: posts the ante 2,500
1eb12e7b: posts small blind 8,000
57a49ef4: posts big blind 16,000
*** HOLE CARDS ***
Dealt to fece3a3c 
Dealt to 92ecd93c 
Dealt to a117c86b 
Dealt to 4e9c4c34 
Dealt to 4e67c452 
Dealt to 1eb12e7b 
Dealt to 57a49ef4 
Dealt to Hero [Kh 7d]
Hero: folds
fece3a3c: folds
92ecd93c: folds
a117c86b: folds
4e9c4c34: raises 16,000 to 32,000
4e67c452: folds
1eb12e7b: folds
57a49ef4: folds
Uncalled bet (16,000) returned to 4e9c4c34
*** SHOWDOWN ***
4e9c4c34 collected 60,000 from pot
*** SUMMARY ***
Total pot 60,000 | Rake 0 | Jackpot 0 | Bingo 0 | Fortune 0 | Tax 0
Seat 1: fece3a3c folded before Flop
Seat 2: 92ecd93c folded before Flop
Seat 3: a117c86b folded before Flop
Seat 4: 4e9c4c34 collected (60,000)
Seat 5: 4e67c452 (button) folded before Flop
Seat 6: 1eb12e7b (small blind) folded before Flop
Seat 7: 57a49ef4 (big blind) folded before Flop
Seat 8: Hero folded before Flop


Poker Hand #TM3552710932: Tournament #156543396, Bounty Hunters Special $1.08 Hold'em No Limit - Level27(8,000/16,000) - 2024/08/05 13:54:36
Table '77' 8-max Seat #4 is the button
Seat 1: fece3a3c (742,361 in chips)
Seat 2: 92ecd93c (282,174 in chips)
Seat 3: a117c86b (516,776 in chips)
Seat 4: 4e9c4c34 (806,860 in chips)
Seat 5: 4e67c452 (191,926 in chips)
Seat 6: 1eb12e7b (846,538 in chips)
Seat 7: 57a49ef4 (394,235 in chips)
Seat 8: Hero (1,337,121 in chips)
4e9c4c34: posts the ante 2,500
4e67c452: posts the ante 2,500
a117c86b: posts the ante 2,500
fece3a3c: posts the ante 2,500
57a49ef4: posts the ante 2,500
1eb12e7b: posts the ante 2,500
92ecd93c: posts the ante 2,500
Hero: posts the ante 2,500
4e67c452: posts small blind 8,000
1eb12e7b: posts big blind 16,000
*** HOLE CARDS ***
Dealt to fece3a3c 
Dealt to 92ecd93c 
Dealt to a117c86b 
Dealt to 4e9c4c34 
Dealt to 4e67c452 
Dealt to 1eb12e7b 
Dealt to 57a49ef4 
Dealt to Hero [5s 7h]
57a49ef4: folds
Hero: folds
fece3a3c: folds
92ecd93c: folds
a117c86b: raises 16,000 to 32,000
4e9c4c34: folds
4e67c452: folds
1eb12e7b: calls 16,000
*** FLOP *** [As Ac Kh]
1eb12e7b: checks
a117c86b: bets 16,000
1eb12e7b: folds
Uncalled bet (16,000) returned to a117c86b
*** SHOWDOWN ***
a117c86b collected 92,000 from pot
*** SUMMARY ***
Total pot 92,000 | Rake 0 | Jackpot 0 | Bingo 0 | Fortune 0 | Tax 0
Board [As Ac Kh]
Seat 1: fece3a3c folded before Flop
Seat 2: 92ecd93c folded before Flop
Seat 3: a117c86b won (92,000)
Seat 4: 4e9c4c34 (button) folded before Flop
Seat 5: 4e67c452 (small blind) folded before Flop
Seat 6: 1eb12e7b (big blind) folded on the Flop
Seat 7: 57a49ef4 folded before Flop
Seat 8: Hero folded before Flop


Poker Hand #TM3552710923: Tournament #156543396, Bounty Hunters Special $1.08 Hold'em No Limit - Level27(8,000/16,000) - 2024/08/05 13:54:06
Table '77' 8-max Seat #3 is the button
Seat 1: fece3a3c (744,861 in chips)
Seat 2: 92ecd93c (240,674 in chips)
Seat 3: a117c86b (519,276 in chips)
Seat 4: 4e9c4c34 (817,360 in chips)
Seat 5: 4e67c452 (210,426 in chips)
Seat 6: 1eb12e7b (849,038 in chips)
Seat 7: 57a49ef4 (396,735 in chips)
Seat 8: Hero (1,339,621 in chips)
4e67c452: posts the ante 2,500
4e9c4c34: posts the ante 2,500
a117c86b: posts the ante 2,500
fece3a3c: posts the ante 2,500
57a49ef4: posts the ante 2,500
1eb12e7b: posts the ante 2,500
92ecd93c: posts the ante 2,500
Hero: posts the ante 2,500
4e9c4c34: posts small blind 8,000
4e67c452: posts big blind 16,000
*** HOLE CARDS ***
Dealt to fece3a3c 
Dealt to 92ecd93c 
Dealt to a117c86b 
Dealt to 4e9c4c34 
Dealt to 4e67c452 
Dealt to 1eb12e7b 
Dealt to 57a49ef4 
Dealt to Hero [9d 7d]
1eb12e7b: folds
57a49ef4: folds
Hero: folds
fece3a3c: folds
92ecd93c: raises 222,174 to 238,174 and is all-in
a117c86b: folds
4e9c4c34: folds
4e67c452: folds
Uncalled bet (222,174) returned to 92ecd93c
*** SHOWDOWN ***
92ecd93c collected 60,000 from pot
*** SUMMARY ***
Total pot 60,000 | Rake 0 | Jackpot 0 | Bingo 0 | Fortune 0 | Tax 0
Seat 1: fece3a3c folded before Flop
Seat 2: 92ecd93c collected (60,000)
Seat 3: a117c86b (button) folded before Flop
Seat 4: 4e9c4c34 (small blind) folded before Flop
Seat 5: 4e67c452 (big blind) folded before Flop
Seat 6: 1eb12e7b folded before Flop
Seat 7: 57a49ef4 folded before Flop
Seat 8: Hero folded before Flop


Poker Hand #TM3552710918: Tournament #156543396, Bounty Hunters Special $1.08 Hold'em No Limit - Level27(8,000/16,000) - 2024/08/05 13:53:40
Table '77' 8-max Seat #2 is the button
Seat 1: fece3a3c (747,361 in chips)
Seat 2: 92ecd93c (243,174 in chips)
Seat 3: a117c86b (529,776 in chips)
Seat 4: 4e9c4c34 (835,860 in chips)
Seat 5: 4e67c452 (212,926 in chips)
Seat 6: 1eb12e7b (851,538 in chips)
Seat 7: 57a49ef4 (355,235 in chips)
Seat 8: Hero (1,342,121 in chips)
4e67c452: posts the ante 2,500
4e9c4c34: posts the ante 2,500
a117c86b: posts the ante 2,500
fece3a3c: posts the ante 2,500
57a49ef4: posts the ante 2,500
1eb12e7b: posts the ante 2,500
92ecd93c: posts the ante 2,500
Hero: posts the ante 2,500
a117c86b: posts small blind 8,000
4e9c4c34: posts big blind 16,000
*** HOLE CARDS ***
Dealt to fece3a3c 
Dealt to 92ecd93c 
Dealt to a117c86b 
Dealt to 4e9c4c34 
Dealt to 4e67c452 
Dealt to 1eb12e7b 
Dealt to 57a49ef4 
Dealt to Hero [Ah 4d]
4e67c452: folds
1eb12e7b: folds
57a49ef4: raises 48,000 to 64,000
Hero: folds
fece3a3c: folds
92ecd93c: folds
a117c86b: folds
4e9c4c34: folds
Uncalled bet (48,000) returned to 57a49ef4
*** SHOWDOWN ***
57a49ef4 collected 60,000 from pot
*** SUMMARY ***
Total pot 60,000 | Rake 0 | Jackpot 0 | Bingo 0 | Fortune 0 | Tax 0
Seat 1: fece3a3c folded before Flop
Seat 2: 92ecd93c (button) folded before Flop
Seat 3: a117c86b (small blind) folded before Flop
Seat 4: 4e9c4c34 (big blind) folded before Flop
Seat 5: 4e67c452 folded before Flop
Seat 6: 1eb12e7b folded before Flop
Seat 7: 57a49ef4 collected (60,000)
Seat 8: Hero folded before Flop


Poker Hand #TM3552710907: Tournament #156543396, Bounty Hunters Special $1.08 Hold'em No Limit - Level27(8,000/16,000) - 2024/08/05 13:53:02
Table '77' 8-max Seat #1 is the button
Seat 1: fece3a3c (749,861 in chips)
Seat 2: 92ecd93c (253,674 in chips)
Seat 3: a117c86b (548,276 in chips)
Seat 4: 4e9c4c34 (838,360 in chips)
Seat 5: 4e67c452 (215,426 in chips)
Seat 6: 1eb12e7b (810,038 in chips)
Seat 7: 57a49ef4 (357,735 in chips)
Seat 8: Hero (1,344,621 in chips)
4e67c452: posts the ante 2,500
4e9c4c34: posts the ante 2,500
a117c86b: posts the ante 2,500
fece3a3c: posts the ante 2,500
57a49ef4: posts the ante 2,500
1eb12e7b: posts the ante 2,500
92ecd93c: posts the ante 2,500
Hero: posts the ante 2,500
92ecd93c: posts small blind 8,000
a117c86b: posts big blind 16,000
*** HOLE CARDS ***
Dealt to fece3a3c 
Dealt to 92ecd93c 
Dealt to a117c86b 
Dealt to 4e9c4c34 
Dealt to 4e67c452 
Dealt to 1eb12e7b 
Dealt to 57a49ef4 
Dealt to Hero [5c 2c]
4e9c4c34: folds
4e67c452: folds
1eb12e7b: raises 48,000 to 64,000
57a49ef4: folds
Hero: folds
fece3a3c: folds
92ecd93c: folds
a117c86b: folds
Uncalled bet (48,000) returned to 1eb12e7b
*** SHOWDOWN ***
1eb12e7b collected 60,000 from pot
*** SUMMARY ***
Total pot 60,000 | Rake 0 | Jackpot 0 | Bingo 0 | Fortune 0 | Tax 0
Seat 1: fece3a3c (button) folded before Flop
Seat 2: 92ecd93c (small blind) folded before Flop
Seat 3: a117c86b (big blind) folded before Flop
Seat 4: 4e9c4c34 folded before Flop
Seat 5: 4e67c452 folded before Flop
Seat 6: 1eb12e7b collected (60,000)
Seat 7: 57a49ef4 folded before Flop
Seat 8: Hero folded before Flop


Poker Hand #TM3552632022: Tournament #156543396, Bounty Hunters Special $1.08 Hold'em No Limit - Level27(8,000/16,000) - 2024/08/05 13:50:47
Table '81' 8-max Seat #1 is the button
Seat 1: 33e312cf (214,182 in chips)
Seat 2: 37ff5d80 (279,453 in chips)
Seat 3: 3ac46d19 (344,731 in chips)
Seat 4: d1b96748 (717,038 in chips)
Seat 5: Hero (1,347,121 in chips)
Seat 6: 1f76886 (42,624 in chips)
Seat 7: 3100482d (278,280 in chips)
d1b96748: posts the ante 2,500
1f76886: posts the ante 2,500
33e312cf: posts the ante 2,500
37ff5d80: posts the ante 2,500
3100482d: posts the ante 2,500
3ac46d19: posts the ante 2,500
Hero: posts the ante 2,500
37ff5d80: posts small blind 8,000
3ac46d19: posts big blind 16,000
*** HOLE CARDS ***
Dealt to 33e312cf 
Dealt to 37ff5d80 
Dealt to 3ac46d19 
Dealt to d1b96748 
Dealt to Hero [As 8d]
Dealt to 1f76886 
Dealt to 3100482d 
d1b96748: folds
Hero: folds
1f76886: raises 24,124 to 40,124 and is all-in
3100482d: folds
33e312cf: folds
37ff5d80: folds
3ac46d19: calls 24,124
1f76886: shows [7h 7c]
3ac46d19: shows [5d Qc]
*** FLOP *** [3s Jd 2s]
*** TURN *** [3s Jd 2s] [4s]
*** RIVER *** [3s Jd 2s 4s] [Qd]
*** SHOWDOWN ***
3ac46d19 collected 105,748 from pot
*** SUMMARY ***
Total pot 105,748 | Rake 0 | Jackpot 0 | Bingo 0 | Fortune 0 | Tax 0
Board [3s Jd 2s 4s Qd]
Seat 1: 33e312cf (button) folded before Flop
Seat 2: 37ff5d80 (small blind) folded before Flop
Seat 3: 3ac46d19 (big blind) showed [5d Qc] and won (105,748) with Pair of Queens
Seat 4: d1b96748 folded before Flop
Seat 5: Hero folded before Flop
Seat 6: 1f76886 showed [7h 7c] and lost with Pair of Sevens
Seat 7: 3100482d folded before Flop


Poker Hand #TM3552631997: Tournament #156543396, Bounty Hunters Special $1.08 Hold'em No Limit - Level27(8,000/16,000) - 2024/08/05 13:48:45
Table '81' 8-max Seat #7 is the button
Seat 1: 33e312cf (248,682 in chips)
Seat 2: 37ff5d80 (281,953 in chips)
Seat 3: 3ac46d19 (347,231 in chips)
Seat 4: d1b96748 (875,726 in chips)
Seat 5: Hero (985,245 in chips)
Seat 6: 1f76886 (45,124 in chips)
Seat 7: 3100482d (280,780 in chips)
Seat 8: 3869dcbd (158,688 in chips)
d1b96748: posts the ante 2,500
1f76886: posts the ante 2,500
3869dcbd: posts the ante 2,500
33e312cf: posts the ante 2,500
37ff5d80: posts the ante 2,500
3100482d: posts the ante 2,500
3ac46d19: posts the ante 2,500
Hero: posts the ante 2,500
3869dcbd: posts small blind 8,000
33e312cf: posts big blind 16,000
*** HOLE CARDS ***
Dealt to 33e312cf 
Dealt to 37ff5d80 
Dealt to 3ac46d19 
Dealt to d1b96748 
Dealt to Hero [Js Ad]
Dealt to 1f76886 
Dealt to 3100482d 
Dealt to 3869dcbd 
37ff5d80: folds
3ac46d19: folds
d1b96748: raises 16,000 to 32,000
Hero: calls 32,000
1f76886: folds
3100482d: folds
3869dcbd: calls 24,000
33e312cf: calls 16,000
*** FLOP *** [Ah Td Th]
3869dcbd: checks
33e312cf: checks
d1b96748: checks
Hero: bets 48,840
3869dcbd: raises 75,348 to 124,188 and is all-in
33e312cf: folds
d1b96748: calls 124,188
Hero: calls 75,348
*** TURN *** [Ah Td Th] [As]
d1b96748: checks
Hero: bets 171,787
d1b96748: folds
Uncalled bet (171,787) returned to Hero
Hero: shows [Js Ad] (Aces Full over Tens)
3869dcbd: shows [Ks Ts] (Tens Full over Aces)
*** RIVER *** [Ah Td Th As] [7c]
*** SHOWDOWN ***
Hero collected 520,564 from pot
*** SUMMARY ***
Total pot 520,564 | Rake 0 | Jackpot 0 | Bingo 0 | Fortune 0 | Tax 0
Board [Ah Td Th As 7c]
Seat 1: 33e312cf (big blind) folded on the Flop
Seat 2: 37ff5d80 folded before Flop
Seat 3: 3ac46d19 folded before Flop
Seat 4: d1b96748 folded on the Turn
Seat 5: Hero showed [Js Ad] and won (520,564) with Aces Full over Tens
Seat 6: 1f76886 folded before Flop
Seat 7: 3100482d (button) folded before Flop
Seat 8: 3869dcbd (small blind) showed [Ks Ts] and lost with Tens Full over Aces


Poker Hand #TM3552631983: Tournament #156543396, Bounty Hunters Special $1.08 Hold'em No Limit - Level26(6,000/12,000) - 2024/08/05 13:48:06
Table '81' 8-max Seat #5 is the button
Seat 1: 33e312cf (250,482 in chips)
Seat 2: 37ff5d80 (283,753 in chips)
Seat 3: 3ac46d19 (349,031 in chips)
Seat 4: d1b96748 (877,526 in chips)
Seat 5: Hero (987,045 in chips)
Seat 7: 3100482d (294,580 in chips)
Seat 8: 3869dcbd (135,888 in chips)
d1b96748: posts the ante 1,800
3869dcbd: posts the ante 1,800
33e312cf: posts the ante 1,800
37ff5d80: posts the ante 1,800
3100482d: posts the ante 1,800
3ac46d19: posts the ante 1,800
Hero: posts the ante 1,800
3100482d: posts small blind 6,000
3869dcbd: posts big blind 12,000
*** HOLE CARDS ***
Dealt to 33e312cf 
Dealt to 37ff5d80 
Dealt to 3ac46d19 
Dealt to d1b96748 
Dealt to Hero [6s 5c]
Dealt to 3100482d 
Dealt to 3869dcbd 
33e312cf: folds
37ff5d80: folds
3ac46d19: folds
d1b96748: folds
Hero: folds
3100482d: calls 6,000
3869dcbd: raises 122,088 to 134,088 and is all-in
3100482d: folds
Uncalled bet (122,088) returned to 3869dcbd
*** SHOWDOWN ***
3869dcbd collected 36,600 from pot
*** SUMMARY ***
Total pot 36,600 | Rake 0 | Jackpot 0 | Bingo 0 | Fortune 0 | Tax 0
Seat 1: 33e312cf folded before Flop
Seat 2: 37ff5d80 folded before Flop
Seat 3: 3ac46d19 folded before Flop
Seat 4: d1b96748 folded before Flop
Seat 5: Hero (button) folded before Flop
Seat 7: 3100482d (small blind) folded before Flop
Seat 8: 3869dcbd (big blind) collected (36,600)


Poker Hand #TM3552631959: Tournament #156543396, Bounty Hunters Special $1.08 Hold'em No Limit - Level26(6,000/12,000) - 2024/08/05 13:46:44
Table '81' 8-max Seat #4 is the button
Seat 1: 33e312cf (252,282 in chips)
Seat 2: 37ff5d80 (285,553 in chips)
Seat 3: 3ac46d19 (374,831 in chips)
Seat 4: d1b96748 (824,726 in chips)
Seat 5: Hero (994,845 in chips)
Seat 7: 3100482d (308,380 in chips)
Seat 8: 3869dcbd (137,688 in chips)
d1b96748: posts the ante 1,800
3869dcbd: posts the ante 1,800
33e312cf: posts the ante 1,800
37ff5d80: posts the ante 1,800
3100482d: posts the ante 1,800
3ac46d19: posts the ante 1,800
Hero: posts the ante 1,800
Hero: posts small blind 6,000
3100482d: posts big blind 12,000
*** HOLE CARDS ***
Dealt to 33e312cf 
Dealt to 37ff5d80 
Dealt to 3ac46d19 
Dealt to d1b96748 
Dealt to Hero [8h Kc]
Dealt to 3100482d 
Dealt to 3869dcbd 
3869dcbd: folds
33e312cf: folds
37ff5d80: folds
3ac46d19: raises 12,000 to 24,000
d1b96748: raises 58,950 to 82,950
Hero: folds
3100482d: folds
3ac46d19: folds
Uncalled bet (58,950) returned to d1b96748
*** SHOWDOWN ***
d1b96748 collected 78,600 from pot
*** SUMMARY ***
Total pot 78,600 | Rake 0 | Jackpot 0 | Bingo 0 | Fortune 0 | Tax 0
Seat 1: 33e312cf folded before Flop
Seat 2: 37ff5d80 folded before Flop
Seat 3: 3ac46d19 folded before Flop
Seat 4: d1b96748 (button) collected (78,600)
Seat 5: Hero (small blind) folded before Flop
Seat 7: 3100482d (big blind) folded before Flop
Seat 8: 3869dcbd folded before Flop


Poker Hand #TM3552631938: Tournament #156543396, Bounty Hunters Special $1.08 Hold'em No Limit - Level26(6,000/12,000) - 2024/08/05 13:45:30
Table '81' 8-max Seat #3 is the button
Seat 1: 33e312cf (254,082 in chips)
Seat 2: 37ff5d80 (287,353 in chips)
Seat 3: 3ac46d19 (376,631 in chips)
Seat 4: d1b96748 (832,526 in chips)
Seat 5: Hero (841,689 in chips)
Seat 6: e037ac5c (306,475 in chips)
Seat 7: 3100482d (310,180 in chips)
Seat 8: 3869dcbd (139,488 in chips)
d1b96748: posts the ante 1,800
3869dcbd: posts the ante 1,800
33e312cf: posts the ante 1,800
37ff5d80: posts the ante 1,800
e037ac5c: posts the ante 1,800
3100482d: posts the ante 1,800
3ac46d19: posts the ante 1,800
Hero: posts the ante 1,800
d1b96748: posts small blind 6,000
Hero: posts big blind 12,000
*** HOLE CARDS ***
Dealt to 33e312cf 
Dealt to 37ff5d80 
Dealt to 3ac46d19 
Dealt to d1b96748 
Dealt to Hero [Qs Js]
Dealt to e037ac5c 
Dealt to 3100482d 
Dealt to 3869dcbd 
e037ac5c: raises 14,400 to 26,400
3100482d: folds
3869dcbd: folds
33e312cf: folds
37ff5d80: folds
3ac46d19: folds
d1b96748: folds
Hero: calls 14,400
*** FLOP *** [6s 9d 5s]
Hero: bets 24,156
e037ac5c: calls 24,156
*** TURN *** [6s 9d 5s] [Ks]
Hero: checks
e037ac5c: bets 84,000
Hero: raises 84,000 to 168,000
e037ac5c: folds
Uncalled bet (84,000) returned to Hero
*** SHOWDOWN ***
Hero collected 289,512 from pot
*** SUMMARY ***
Total pot 289,512 | Rake 0 | Jackpot 0 | Bingo 0 | Fortune 0 | Tax 0
Board [6s 9d 5s Ks]
Seat 1: 33e312cf folded before Flop
Seat 2: 37ff5d80 folded before Flop
Seat 3: 3ac46d19 (button) folded before Flop
Seat 4: d1b96748 (small blind) folded before Flop
Seat 5: Hero (big blind) won (289,512)
Seat 6: e037ac5c folded on the Turn
Seat 7: 3100482d folded before Flop
Seat 8: 3869dcbd folded before Flop


Poker Hand #TM3552631893: Tournament #156543396, Bounty Hunters Special $1.08 Hold'em No Limit - Level26(6,000/12,000) - 2024/08/05 13:43:00
Table '81' 8-max Seat #2 is the button
Seat 1: 33e312cf (255,882 in chips)
Seat 2: 37ff5d80 (350,353 in chips)
Seat 3: 3ac46d19 (384,431 in chips)
Seat 4: d1b96748 (377,263 in chips)
Seat 5: Hero (843,489 in chips)
Seat 6: e037ac5c (683,738 in chips)
Seat 7: 3100482d (311,980 in chips)
Seat 8: 3869dcbd (141,288 in chips)
d1b96748: posts the ante 1,800
3869dcbd: posts the ante 1,800
33e312cf: posts the ante 1,800
37ff5d80: posts the ante 1,800
e037ac5c: posts the ante 1,800
3100482d: posts the ante 1,800
3ac46d19: posts the ante 1,800
Hero: posts the ante 1,800
3ac46d19: posts small blind 6,000
d1b96748: posts big blind 12,000
*** HOLE CARDS ***
Dealt to 33e312cf 
Dealt to 37ff5d80 
Dealt to 3ac46d19 
Dealt to d1b96748 
Dealt to Hero [As 8h]
Dealt to e037ac5c 
Dealt to 3100482d 
Dealt to 3869dcbd 
Hero: folds
e037ac5c: raises 14,400 to 26,400
3100482d: folds
3869dcbd: folds
33e312cf: folds
37ff5d80: calls 26,400
3ac46d19: folds
d1b96748: calls 14,400
*** FLOP *** [5c 5s 3c]
d1b96748: checks
e037ac5c: bets 34,800
37ff5d80: calls 34,800
d1b96748: calls 34,800
*** TURN *** [5c 5s 3c] [Qd]
d1b96748: bets 102,000
e037ac5c: raises 102,000 to 204,000
37ff5d80: folds
d1b96748: raises 110,263 to 314,263 and is all-in
e037ac5c: calls 110,263
d1b96748: shows [Ks Qc] (Pair of Queens and Pair of Fives)
e037ac5c: shows [Kh Jd] (Pair of Fives)
*** RIVER *** [5c 5s 3c Qd] [6d]
*** SHOWDOWN ***
d1b96748 collected 832,526 from pot
*** SUMMARY ***
Total pot 832,526 | Rake 0 | Jackpot 0 | Bingo 0 | Fortune 0 | Tax 0
Board [5c 5s 3c Qd 6d]
Seat 1: 33e312cf folded before Flop
Seat 2: 37ff5d80 (button) folded on the Turn
Seat 3: 3ac46d19 (small blind) folded before Flop
Seat 4: d1b96748 (big blind) showed [Ks Qc] and won (832,526) with Pair of Queens and Pair of Fives
Seat 5: Hero folded before Flop
Seat 6: e037ac5c showed [Kh Jd] and lost with Pair of Fives
Seat 7: 3100482d folded before Flop
Seat 8: 3869dcbd folded before Flop


Poker Hand #TM3552631876: Tournament #156543396, Bounty Hunters Special $1.08 Hold'em No Limit - Level26(6,000/12,000) - 2024/08/05 13:42:01
Table '81' 8-max Seat #1 is the button
Seat 1: 33e312cf (281,682 in chips)
Seat 2: 37ff5d80 (358,153 in chips)
Seat 3: 3ac46d19 (398,231 in chips)
Seat 4: d1b96748 (322,663 in chips)
Seat 5: Hero (845,289 in chips)
Seat 6: e037ac5c (685,538 in chips)
Seat 7: 3100482d (313,780 in chips)
Seat 8: 3869dcbd (143,088 in chips)
d1b96748: posts the ante 1,800
3869dcbd: posts the ante 1,800
33e312cf: posts the ante 1,800
37ff5d80: posts the ante 1,800
e037ac5c: posts the ante 1,800
3100482d: posts the ante 1,800
3ac46d19: posts the ante 1,800
Hero: posts the ante 1,800
37ff5d80: posts small blind 6,000
3ac46d19: posts big blind 12,000
*** HOLE CARDS ***
Dealt to 33e312cf 
Dealt to 37ff5d80 
Dealt to 3ac46d19 
Dealt to d1b96748 
Dealt to Hero [Kd 8d]
Dealt to e037ac5c 
Dealt to 3100482d 
Dealt to 3869dcbd 
d1b96748: raises 12,000 to 24,000
Hero: folds
e037ac5c: folds
3100482d: folds
3869dcbd: folds
33e312cf: calls 24,000
37ff5d80: folds
3ac46d19: folds
*** FLOP *** [9d 8c 4d]
d1b96748: bets 80,400
33e312cf: folds
Uncalled bet (80,400) returned to d1b96748
*** SHOWDOWN ***
d1b96748 collected 80,400 from pot
*** SUMMARY ***
Total pot 80,400 | Rake 0 | Jackpot 0 | Bingo 0 | Fortune 0 | Tax 0
Board [9d 8c 4d]
Seat 1: 33e312cf (button) folded on the Flop
Seat 2: 37ff5d80 (small blind) folded before Flop
Seat 3: 3ac46d19 (big blind) folded before Flop
Seat 4: d1b96748 won (80,400)
Seat 5: Hero folded before Flop
Seat 6: e037ac5c folded before Flop
Seat 7: 3100482d folded before Flop
Seat 8: 3869dcbd folded before Flop


Poker Hand #TM3552631847: Tournament #156543396, Bounty Hunters Special $1.08 Hold'em No Limit - Level25(5,000/10,000) - 2024/08/05 13:40:29
Table '81' 8-max Seat #8 is the button
Seat 1: 33e312cf (288,182 in chips)
Seat 2: 37ff5d80 (369,653 in chips)
Seat 3: 3ac46d19 (399,731 in chips)
Seat 4: d1b96748 (344,163 in chips)
Seat 5: Hero (846,789 in chips)
Seat 6: e037ac5c (747,038 in chips)
Seat 7: 3100482d (208,280 in chips)
Seat 8: 3869dcbd (144,588 in chips)
d1b96748: posts the ante 1,500
3869dcbd: posts the ante 1,500
33e312cf: posts the ante 1,500
37ff5d80: posts the ante 1,500
e037ac5c: posts the ante 1,500
3100482d: posts the ante 1,500
3ac46d19: posts the ante 1,500
Hero: posts the ante 1,500
33e312cf: posts small blind 5,000
37ff5d80: posts big blind 10,000
*** HOLE CARDS ***
Dealt to 33e312cf 
Dealt to 37ff5d80 
Dealt to 3ac46d19 
Dealt to d1b96748 
Dealt to Hero [2d 8d]
Dealt to e037ac5c 
Dealt to 3100482d 
Dealt to 3869dcbd 
3ac46d19: folds
d1b96748: raises 10,000 to 20,000
Hero: folds
e037ac5c: raises 40,000 to 60,000
3100482d: raises 146,780 to 206,780 and is all-in
3869dcbd: folds
33e312cf: folds
37ff5d80: folds
d1b96748: folds
e037ac5c: folds
Uncalled bet (146,780) returned to 3100482d
*** SHOWDOWN ***
3100482d collected 167,000 from pot
*** SUMMARY ***
Total pot 167,000 | Rake 0 | Jackpot 0 | Bingo 0 | Fortune 0 | Tax 0
Seat 1: 33e312cf (small blind) folded before Flop
Seat 2: 37ff5d80 (big blind) folded before Flop
Seat 3: 3ac46d19 folded before Flop
Seat 4: d1b96748 folded before Flop
Seat 5: Hero folded before Flop
Seat 6: e037ac5c folded before Flop
Seat 7: 3100482d collected (167,000)
Seat 8: 3869dcbd (button) folded before Flop


Poker Hand #TM3552631829: Tournament #156543396, Bounty Hunters Special $1.08 Hold'em No Limit - Level25(5,000/10,000) - 2024/08/05 13:39:38
Table '81' 8-max Seat #7 is the button
Seat 1: 33e312cf (299,682 in chips)
Seat 2: 37ff5d80 (371,153 in chips)
Seat 3: 3ac46d19 (401,231 in chips)
Seat 4: d1b96748 (345,663 in chips)
Seat 5: Hero (848,289 in chips)
Seat 6: e037ac5c (748,538 in chips)
Seat 7: 3100482d (182,780 in chips)
Seat 8: 3869dcbd (151,088 in chips)
d1b96748: posts the ante 1,500
3869dcbd: posts the ante 1,500
33e312cf: posts the ante 1,500
37ff5d80: posts the ante 1,500
e037ac5c: posts the ante 1,500
3100482d: posts the ante 1,500
3ac46d19: posts the ante 1,500
Hero: posts the ante 1,500
3869dcbd: posts small blind 5,000
33e312cf: posts big blind 10,000
*** HOLE CARDS ***
Dealt to 33e312cf 
Dealt to 37ff5d80 
Dealt to 3ac46d19 
Dealt to d1b96748 
Dealt to Hero [3c 4c]
Dealt to e037ac5c 
Dealt to 3100482d 
Dealt to 3869dcbd 
37ff5d80: folds
3ac46d19: folds
d1b96748: folds
Hero: folds
e037ac5c: folds
3100482d: raises 37,000 to 47,000
3869dcbd: folds
33e312cf: folds
Uncalled bet (37,000) returned to 3100482d
*** SHOWDOWN ***
3100482d collected 37,000 from pot
*** SUMMARY ***
Total pot 37,000 | Rake 0 | Jackpot 0 | Bingo 0 | Fortune 0 | Tax 0
Seat 1: 33e312cf (big blind) folded before Flop
Seat 2: 37ff5d80 folded before Flop
Seat 3: 3ac46d19 folded before Flop
Seat 4: d1b96748 folded before Flop
Seat 5: Hero folded before Flop
Seat 6: e037ac5c folded before Flop
Seat 7: 3100482d (button) collected (37,000)
Seat 8: 3869dcbd (small blind) folded before Flop


Poker Hand #TM3552631812: Tournament #156543396, Bounty Hunters Special $1.08 Hold'em No Limit - Level25(5,000/10,000) - 2024/08/05 13:38:41
Table '81' 8-max Seat #6 is the button
Seat 1: 33e312cf (301,182 in chips)
Seat 2: 37ff5d80 (372,653 in chips)
Seat 3: 3ac46d19 (402,731 in chips)
Seat 4: d1b96748 (347,163 in chips)
Seat 5: Hero (849,789 in chips)
Seat 6: e037ac5c (772,038 in chips)
Seat 7: 3100482d (189,280 in chips)
Seat 8: 3869dcbd (113,588 in chips)
d1b96748: posts the ante 1,500
3869dcbd: posts the ante 1,500
33e312cf: posts the ante 1,500
37ff5d80: posts the ante 1,500
e037ac5c: posts the ante 1,500
3100482d: posts the ante 1,500
3ac46d19: posts the ante 1,500
Hero: posts the ante 1,500
3100482d: posts small blind 5,000
3869dcbd: posts big blind 10,000
*** HOLE CARDS ***
Dealt to 33e312cf 
Dealt to 37ff5d80 
Dealt to 3ac46d19 
Dealt to d1b96748 
Dealt to Hero [5h Kh]
Dealt to e037ac5c 
Dealt to 3100482d 
Dealt to 3869dcbd 
33e312cf: folds
37ff5d80: folds
3ac46d19: folds
d1b96748: folds
Hero: folds
e037ac5c: raises 12,000 to 22,000
3100482d: folds
3869dcbd: calls 12,000
*** FLOP *** [9d Qs Qc]
3869dcbd: bets 20,130
e037ac5c: folds
Uncalled bet (20,130) returned to 3869dcbd
*** SHOWDOWN ***
3869dcbd collected 61,000 from pot
*** SUMMARY ***
Total pot 61,000 | Rake 0 | Jackpot 0 | Bingo 0 | Fortune 0 | Tax 0
Board [9d Qs Qc]
Seat 1: 33e312cf folded before Flop
Seat 2: 37ff5d80 folded before Flop
Seat 3: 3ac46d19 folded before Flop
Seat 4: d1b96748 folded before Flop
Seat 5: Hero folded before Flop
Seat 6: e037ac5c (button) folded on the Flop
Seat 7: 3100482d (small blind) folded before Flop
Seat 8: 3869dcbd (big blind) won (61,000)


Poker Hand #TM3552631797: Tournament #156543396, Bounty Hunters Special $1.08 Hold'em No Limit - Level25(5,000/10,000) - 2024/08/05 13:38:00
Table '81' 8-max Seat #5 is the button
Seat 1: 33e312cf (302,682 in chips)
Seat 2: 37ff5d80 (347,153 in chips)
Seat 3: 3ac46d19 (404,231 in chips)
Seat 4: d1b96748 (348,663 in chips)
Seat 5: Hero (851,289 in chips)
Seat 6: e037ac5c (778,538 in chips)
Seat 7: 3100482d (200,780 in chips)
Seat 8: 3869dcbd (115,088 in chips)
d1b96748: posts the ante 1,500
3869dcbd: posts the ante 1,500
33e312cf: posts the ante 1,500
37ff5d80: posts the ante 1,500
e037ac5c: posts the ante 1,500
3100482d: posts the ante 1,500
3ac46d19: posts the ante 1,500
Hero: posts the ante 1,500
e037ac5c: posts small blind 5,000
3100482d: posts big blind 10,000
*** HOLE CARDS ***
Dealt to 33e312cf 
Dealt to 37ff5d80 
Dealt to 3ac46d19 
Dealt to d1b96748 
Dealt to Hero [8c 7d]
Dealt to e037ac5c 
Dealt to 3100482d 
Dealt to 3869dcbd 
3869dcbd: folds
33e312cf: folds
37ff5d80: raises 12,000 to 22,000
3ac46d19: folds
d1b96748: folds
Hero: folds
e037ac5c: folds
3100482d: folds
Uncalled bet (12,000) returned to 37ff5d80
*** SHOWDOWN ***
37ff5d80 collected 37,000 from pot
*** SUMMARY ***
Total pot 37,000 | Rake 0 | Jackpot 0 | Bingo 0 | Fortune 0 | Tax 0
Seat 1: 33e312cf folded before Flop
Seat 2: 37ff5d80 collected (37,000)
Seat 3: 3ac46d19 folded before Flop
Seat 4: d1b96748 folded before Flop
Seat 5: Hero (button) folded before Flop
Seat 6: e037ac5c (small blind) folded before Flop
Seat 7: 3100482d (big blind) folded before Flop
Seat 8: 3869dcbd folded before Flop


Poker Hand #TM3552631789: Tournament #156543396, Bounty Hunters Special $1.08 Hold'em No Limit - Level25(5,000/10,000) - 2024/08/05 13:37:37
Table '81' 8-max Seat #4 is the button
Seat 1: 33e312cf (304,182 in chips)
Seat 2: 37ff5d80 (348,653 in chips)
Seat 3: 3ac46d19 (405,731 in chips)
Seat 4: d1b96748 (350,163 in chips)
Seat 5: Hero (857,789 in chips)
Seat 6: e037ac5c (763,038 in chips)
Seat 7: 3100482d (202,280 in chips)
Seat 8: 3869dcbd (116,588 in chips)
d1b96748: posts the ante 1,500
3869dcbd: posts the ante 1,500
33e312cf: posts the ante 1,500
37ff5d80: posts the ante 1,500
e037ac5c: posts the ante 1,500
3100482d: posts the ante 1,500
3ac46d19: posts the ante 1,500
Hero: posts the ante 1,500
Hero: posts small blind 5,000
e037ac5c: posts big blind 10,000
*** HOLE CARDS ***
Dealt to 33e312cf 
Dealt to 37ff5d80 
Dealt to 3ac46d19 
Dealt to d1b96748 
Dealt to Hero [2h 4c]
Dealt to e037ac5c 
Dealt to 3100482d 
Dealt to 3869dcbd 
3100482d: folds
3869dcbd: folds
33e312cf: folds
37ff5d80: folds
3ac46d19: folds
d1b96748: folds
Hero: folds
Uncalled bet (5,000) returned to e037ac5c
Hero: shows [2h 4c]
*** SHOWDOWN ***
e037ac5c collected 22,000 from pot
*** SUMMARY ***
Total pot 22,000 | Rake 0 | Jackpot 0 | Bingo 0 | Fortune 0 | Tax 0
Seat 1: 33e312cf folded before Flop
Seat 2: 37ff5d80 folded before Flop
Seat 3: 3ac46d19 folded before Flop
Seat 4: d1b96748 (button) folded before Flop
Seat 5: Hero (small blind) folded before Flop
Seat 6: e037ac5c (big blind) collected (22,000)
Seat 7: 3100482d folded before Flop
Seat 8: 3869dcbd folded before Flop


Poker Hand #TM3552631768: Tournament #156543396, Bounty Hunters Special $1.08 Hold'em No Limit - Level25(5,000/10,000) - 2024/08/05 13:36:41
Table '81' 8-max Seat #3 is the button
Seat 1: 33e312cf (305,682 in chips)
Seat 2: 37ff5d80 (350,153 in chips)
Seat 3: 3ac46d19 (407,231 in chips)
Seat 4: d1b96748 (356,663 in chips)
Seat 5: Hero (832,289 in chips)
Seat 6: e037ac5c (764,538 in chips)
Seat 7: 3100482d (213,780 in chips)
Seat 8: 3869dcbd (118,088 in chips)
d1b96748: posts the ante 1,500
3869dcbd: posts the ante 1,500
33e312cf: posts the ante 1,500
37ff5d80: posts the ante 1,500
e037ac5c: posts the ante 1,500
3100482d: posts the ante 1,500
3ac46d19: posts the ante 1,500
Hero: posts the ante 1,500
d1b96748: posts small blind 5,000
Hero: posts big blind 10,000
*** HOLE CARDS ***
Dealt to 33e312cf 
Dealt to 37ff5d80 
Dealt to 3ac46d19 
Dealt to d1b96748 
Dealt to Hero [Th Td]
Dealt to e037ac5c 
Dealt to 3100482d 
Dealt to 3869dcbd 
e037ac5c: folds
3100482d: calls 10,000
3869dcbd: folds
33e312cf: folds
37ff5d80: folds
3ac46d19: folds
d1b96748: folds
Hero: raises 230,000 to 240,000
3100482d: folds
Uncalled bet (230,000) returned to Hero
Hero: shows [Th Td]
3100482d: shows [9c Ac]
*** SHOWDOWN ***
Hero collected 37,000 from pot
*** SUMMARY ***
Total pot 37,000 | Rake 0 | Jackpot 0 | Bingo 0 | Fortune 0 | Tax 0
Seat 1: 33e312cf folded before Flop
Seat 2: 37ff5d80 folded before Flop
Seat 3: 3ac46d19 (button) folded before Flop
Seat 4: d1b96748 (small blind) folded before Flop
Seat 5: Hero (big blind) showed [Th Td] and collected (37,000)
Seat 6: e037ac5c folded before Flop
Seat 7: 3100482d folded before Flop
Seat 8: 3869dcbd folded before Flop


Poker Hand #TM3552631748: Tournament #156543396, Bounty Hunters Special $1.08 Hold'em No Limit - Level25(5,000/10,000) - 2024/08/05 13:35:51
Table '81' 8-max Seat #2 is the button
Seat 1: 33e312cf (307,182 in chips)
Seat 2: 37ff5d80 (351,653 in chips)
Seat 3: 3ac46d19 (418,731 in chips)
Seat 4: d1b96748 (368,163 in chips)
Seat 5: Hero (833,789 in chips)
Seat 6: e037ac5c (766,038 in chips)
Seat 7: 3100482d (183,280 in chips)
Seat 8: 3869dcbd (119,588 in chips)
d1b96748: posts the ante 1,500
3869dcbd: posts the ante 1,500
33e312cf: posts the ante 1,500
37ff5d80: posts the ante 1,500
e037ac5c: posts the ante 1,500
3100482d: posts the ante 1,500
3ac46d19: posts the ante 1,500
Hero: posts the ante 1,500
3ac46d19: posts small blind 5,000
d1b96748: posts big blind 10,000
*** HOLE CARDS ***
Dealt to 33e312cf 
Dealt to 37ff5d80 
Dealt to 3ac46d19 
Dealt to d1b96748 
Dealt to Hero [8d 7d]
Dealt to e037ac5c 
Dealt to 3100482d 
Dealt to 3869dcbd 
Hero: folds
e037ac5c: folds
3100482d: calls 10,000
3869dcbd: folds
33e312cf: folds
37ff5d80: folds
3ac46d19: calls 5,000
d1b96748: checks
*** FLOP *** [8c 4d 2c]
3ac46d19: checks
d1b96748: checks
3100482d: bets 13,860
3ac46d19: folds
d1b96748: folds
Uncalled bet (13,860) returned to 3100482d
*** SHOWDOWN ***
3100482d collected 42,000 from pot
*** SUMMARY ***
Total pot 42,000 | Rake 0 | Jackpot 0 | Bingo 0 | Fortune 0 | Tax 0
Board [8c 4d 2c]
Seat 1: 33e312cf folded before Flop
Seat 2: 37ff5d80 (button) folded before Flop
Seat 3: 3ac46d19 (small blind) folded on the Flop
Seat 4: d1b96748 (big blind) folded on the Flop
Seat 5: Hero folded before Flop
Seat 6: e037ac5c folded before Flop
Seat 7: 3100482d won (42,000)
Seat 8: 3869dcbd folded before Flop


Poker Hand #TM3552631714: Tournament #156543396, Bounty Hunters Special $1.08 Hold'em No Limit - Level25(5,000/10,000) - 2024/08/05 13:34:20
Table '81' 8-max Seat #1 is the button
Seat 1: 33e312cf (236,682 in chips)
Seat 2: 37ff5d80 (373,153 in chips)
Seat 3: 3ac46d19 (440,231 in chips)
Seat 4: d1b96748 (369,663 in chips)
Seat 5: Hero (835,289 in chips)
Seat 6: e037ac5c (767,538 in chips)
Seat 7: 3100482d (184,780 in chips)
Seat 8: 3869dcbd (141,088 in chips)
d1b96748: posts the ante 1,500
3869dcbd: posts the ante 1,500
33e312cf: posts the ante 1,500
37ff5d80: posts the ante 1,500
e037ac5c: posts the ante 1,500
3100482d: posts the ante 1,500
3ac46d19: posts the ante 1,500
Hero: posts the ante 1,500
37ff5d80: posts small blind 5,000
3ac46d19: posts big blind 10,000
*** HOLE CARDS ***
Dealt to 33e312cf 
Dealt to 37ff5d80 
Dealt to 3ac46d19 
Dealt to d1b96748 
Dealt to Hero [Qh Tc]
Dealt to e037ac5c 
Dealt to 3100482d 
Dealt to 3869dcbd 
d1b96748: folds
Hero: folds
e037ac5c: folds
3100482d: folds
3869dcbd: raises 10,000 to 20,000
33e312cf: calls 20,000
37ff5d80: calls 15,000
3ac46d19: calls 10,000
*** FLOP *** [6h Ks Qs]
37ff5d80: checks
3ac46d19: checks
3869dcbd: checks
33e312cf: checks
*** TURN *** [6h Ks Qs] [5d]
37ff5d80: checks
3ac46d19: checks
3869dcbd: checks
33e312cf: bets 46,000
37ff5d80: folds
3ac46d19: folds
3869dcbd: folds
Uncalled bet (46,000) returned to 33e312cf
*** SHOWDOWN ***
33e312cf collected 92,000 from pot
*** SUMMARY ***
Total pot 92,000 | Rake 0 | Jackpot 0 | Bingo 0 | Fortune 0 | Tax 0
Board [6h Ks Qs 5d]
Seat 1: 33e312cf (button) won (92,000)
Seat 2: 37ff5d80 (small blind) folded on the Turn
Seat 3: 3ac46d19 (big blind) folded on the Turn
Seat 4: d1b96748 folded before Flop
Seat 5: Hero folded before Flop
Seat 6: e037ac5c folded before Flop
Seat 7: 3100482d folded before Flop
Seat 8: 3869dcbd folded on the Turn


Poker Hand #TM3552631680: Tournament #156543396, Bounty Hunters Special $1.08 Hold'em No Limit - Level25(5,000/10,000) - 2024/08/05 13:32:58
Table '81' 8-max Seat #8 is the button
Seat 1: 33e312cf (293,432 in chips)
Seat 2: 37ff5d80 (288,903 in chips)
Seat 3: 3ac46d19 (441,731 in chips)
Seat 5: Hero (836,789 in chips)
Seat 6: e037ac5c (769,038 in chips)
Seat 7: 3100482d (206,280 in chips)
Seat 8: 3869dcbd (142,588 in chips)
3869dcbd: posts the ante 1,500
33e312cf: posts the ante 1,500
37ff5d80: posts the ante 1,500
e037ac5c: posts the ante 1,500
3100482d: posts the ante 1,500
3ac46d19: posts the ante 1,500
Hero: posts the ante 1,500
33e312cf: posts small blind 5,000
37ff5d80: posts big blind 10,000
*** HOLE CARDS ***
Dealt to 33e312cf 
Dealt to 37ff5d80 
Dealt to 3ac46d19 
Dealt to Hero [2c 9s]
Dealt to e037ac5c 
Dealt to 3100482d 
Dealt to 3869dcbd 
3ac46d19: folds
Hero: folds
e037ac5c: folds
3100482d: raises 10,000 to 20,000
3869dcbd: folds
33e312cf: calls 15,000
37ff5d80: calls 10,000
*** FLOP *** [Js 9d Jd]
33e312cf: checks
37ff5d80: checks
3100482d: checks
*** TURN *** [Js 9d Jd] [3c]
33e312cf: bets 35,250
37ff5d80: calls 35,250
3100482d: folds
*** RIVER *** [Js 9d Jd 3c] [9h]
33e312cf: checks
37ff5d80: checks
33e312cf: shows [Ts As] (Pair of Jacks and Pair of Nines)
37ff5d80: shows [3h 3d] (Treys Full over Jacks)
*** SHOWDOWN ***
37ff5d80 collected 141,000 from pot
*** SUMMARY ***
Total pot 141,000 | Rake 0 | Jackpot 0 | Bingo 0 | Fortune 0 | Tax 0
Board [Js 9d Jd 3c 9h]
Seat 1: 33e312cf (small blind) showed [Ts As] and lost with Pair of Jacks and Pair of Nines
Seat 2: 37ff5d80 (big blind) showed [3h 3d] and won (141,000) with Treys Full over Jacks
Seat 3: 3ac46d19 folded before Flop
Seat 5: Hero folded before Flop
Seat 6: e037ac5c folded before Flop
Seat 7: 3100482d folded on the Turn
Seat 8: 3869dcbd (button) folded before Flop


Poker Hand #TM3552631666: Tournament #156543396, Bounty Hunters Special $1.08 Hold'em No Limit - Level24(4,000/8,000) - 2024/08/05 13:32:21
Table '81' 8-max Seat #7 is the button
Seat 1: 33e312cf (302,632 in chips)
Seat 2: 37ff5d80 (290,103 in chips)
Seat 3: 3ac46d19 (442,931 in chips)
Seat 5: Hero (817,589 in chips)
Seat 6: e037ac5c (770,238 in chips)
Seat 7: 3100482d (207,480 in chips)
Seat 8: 3869dcbd (147,788 in chips)
3869dcbd: posts the ante 1,200
33e312cf: posts the ante 1,200
37ff5d80: posts the ante 1,200
e037ac5c: posts the ante 1,200
3100482d: posts the ante 1,200
3ac46d19: posts the ante 1,200
Hero: posts the ante 1,200
3869dcbd: posts small blind 4,000
33e312cf: posts big blind 8,000
*** HOLE CARDS ***
Dealt to 33e312cf 
Dealt to 37ff5d80 
Dealt to 3ac46d19 
Dealt to Hero [Kc Kd]
Dealt to e037ac5c 
Dealt to 3100482d 
Dealt to 3869dcbd 
37ff5d80: folds
3ac46d19: folds
Hero: raises 16,000 to 24,000
e037ac5c: folds
3100482d: folds
3869dcbd: folds
33e312cf: folds
Uncalled bet (16,000) returned to Hero
*** SHOWDOWN ***
Hero collected 28,400 from pot
*** SUMMARY ***
Total pot 28,400 | Rake 0 | Jackpot 0 | Bingo 0 | Fortune 0 | Tax 0
Seat 1: 33e312cf (big blind) folded before Flop
Seat 2: 37ff5d80 folded before Flop
Seat 3: 3ac46d19 folded before Flop
Seat 5: Hero collected (28,400)
Seat 6: e037ac5c folded before Flop
Seat 7: 3100482d (button) folded before Flop
Seat 8: 3869dcbd (small blind) folded before Flop


Poker Hand #TM3552631655: Tournament #156543396, Bounty Hunters Special $1.08 Hold'em No Limit - Level24(4,000/8,000) - 2024/08/05 13:31:48
Table '81' 8-max Seat #6 is the button
Seat 1: 33e312cf (303,832 in chips)
Seat 2: 37ff5d80 (291,303 in chips)
Seat 3: 3ac46d19 (444,131 in chips)
Seat 5: Hero (818,789 in chips)
Seat 6: e037ac5c (789,038 in chips)
Seat 7: 3100482d (174,680 in chips)
Seat 8: 3869dcbd (156,988 in chips)
3869dcbd: posts the ante 1,200
33e312cf: posts the ante 1,200
37ff5d80: posts the ante 1,200
e037ac5c: posts the ante 1,200
3100482d: posts the ante 1,200
3ac46d19: posts the ante 1,200
Hero: posts the ante 1,200
3100482d: posts small blind 4,000
3869dcbd: posts big blind 8,000
*** HOLE CARDS ***
Dealt to 33e312cf 
Dealt to 37ff5d80 
Dealt to 3ac46d19 
Dealt to Hero [3c Tc]
Dealt to e037ac5c 
Dealt to 3100482d 
Dealt to 3869dcbd 
33e312cf: folds
37ff5d80: folds
3ac46d19: folds
Hero: folds
e037ac5c: raises 9,600 to 17,600
3100482d: raises 155,880 to 173,480 and is all-in
3869dcbd: folds
e037ac5c: folds
Uncalled bet (155,880) returned to 3100482d
*** SHOWDOWN ***
3100482d collected 51,600 from pot
*** SUMMARY ***
Total pot 51,600 | Rake 0 | Jackpot 0 | Bingo 0 | Fortune 0 | Tax 0
Seat 1: 33e312cf folded before Flop
Seat 2: 37ff5d80 folded before Flop
Seat 3: 3ac46d19 folded before Flop
Seat 5: Hero folded before Flop
Seat 6: e037ac5c (button) folded before Flop
Seat 7: 3100482d (small blind) collected (51,600)
Seat 8: 3869dcbd (big blind) folded before Flop


Poker Hand #TM3552631624: Tournament #156543396, Bounty Hunters Special $1.08 Hold'em No Limit - Level24(4,000/8,000) - 2024/08/05 13:30:33
Table '81' 8-max Seat #5 is the button
Seat 1: 33e312cf (305,032 in chips)
Seat 2: 37ff5d80 (292,503 in chips)
Seat 3: 3ac46d19 (445,331 in chips)
Seat 5: Hero (819,989 in chips)
Seat 6: e037ac5c (709,866 in chips)
Seat 7: 3100482d (183,880 in chips)
Seat 8: 3869dcbd (222,160 in chips)
3869dcbd: posts the ante 1,200
33e312cf: posts the ante 1,200
37ff5d80: posts the ante 1,200
e037ac5c: posts the ante 1,200
3100482d: posts the ante 1,200
3ac46d19: posts the ante 1,200
Hero: posts the ante 1,200
e037ac5c: posts small blind 4,000
3100482d: posts big blind 8,000
*** HOLE CARDS ***
Dealt to 33e312cf 
Dealt to 37ff5d80 
Dealt to 3ac46d19 
Dealt to Hero [7d 4c]
Dealt to e037ac5c 
Dealt to 3100482d 
Dealt to 3869dcbd 
3869dcbd: raises 8,000 to 16,000
33e312cf: folds
37ff5d80: folds
3ac46d19: folds
Hero: folds
e037ac5c: calls 12,000
3100482d: folds
*** FLOP *** [Tc Th 4s]
e037ac5c: checks
3869dcbd: bets 15,972
e037ac5c: calls 15,972
*** TURN *** [Tc Th 4s] [3c]
e037ac5c: bets 32,000
3869dcbd: calls 32,000
*** RIVER *** [Tc Th 4s 3c] [6d]
e037ac5c: checks
3869dcbd: checks
e037ac5c: shows [5d 5s] (Pair of Tens and Pair of Fives)
3869dcbd: shows [Qs Kd] (Pair of Tens)
*** SHOWDOWN ***
e037ac5c collected 144,344 from pot
*** SUMMARY ***
Total pot 144,344 | Rake 0 | Jackpot 0 | Bingo 0 | Fortune 0 | Tax 0
Board [Tc Th 4s 3c 6d]
Seat 1: 33e312cf folded before Flop
Seat 2: 37ff5d80 folded before Flop
Seat 3: 3ac46d19 folded before Flop
Seat 5: Hero (button) folded before Flop
Seat 6: e037ac5c (small blind) showed [5d 5s] and won (144,344) with Pair of Tens and Pair of Fives
Seat 7: 3100482d (big blind) folded before Flop
Seat 8: 3869dcbd showed [Qs Kd] and lost with Pair of Tens


Poker Hand #TM3552631605: Tournament #156543396, Bounty Hunters Special $1.08 Hold'em No Limit - Level24(4,000/8,000) - 2024/08/05 13:29:35
Table '81' 8-max Seat #3 is the button
Seat 1: 33e312cf (306,232 in chips)
Seat 2: 37ff5d80 (293,703 in chips)
Seat 3: 3ac46d19 (446,531 in chips)
Seat 5: Hero (825,189 in chips)
Seat 6: e037ac5c (596,922 in chips)
Seat 7: 3100482d (185,080 in chips)
Seat 8: ce70777b (102,944 in chips)
ce70777b: posts the ante 1,200
33e312cf: posts the ante 1,200
37ff5d80: posts the ante 1,200
e037ac5c: posts the ante 1,200
3100482d: posts the ante 1,200
3ac46d19: posts the ante 1,200
Hero: posts the ante 1,200
Hero: posts small blind 4,000
e037ac5c: posts big blind 8,000
*** HOLE CARDS ***
Dealt to 33e312cf 
Dealt to 37ff5d80 
Dealt to 3ac46d19 
Dealt to Hero [4d 5s]
Dealt to e037ac5c 
Dealt to 3100482d 
Dealt to ce70777b 
3100482d: folds
ce70777b: raises 93,744 to 101,744 and is all-in
33e312cf: folds
37ff5d80: folds
3ac46d19: folds
Hero: folds
e037ac5c: calls 93,744
ce70777b: shows [Th Ad]
e037ac5c: shows [7d 7s]
*** FLOP *** [Kd Qh 6s]
*** TURN *** [Kd Qh 6s] [6h]
*** RIVER *** [Kd Qh 6s 6h] [8h]
*** SHOWDOWN ***
e037ac5c collected 215,888 from pot
*** SUMMARY ***
Total pot 215,888 | Rake 0 | Jackpot 0 | Bingo 0 | Fortune 0 | Tax 0
Board [Kd Qh 6s 6h 8h]
Seat 1: 33e312cf folded before Flop
Seat 2: 37ff5d80 folded before Flop
Seat 3: 3ac46d19 (button) folded before Flop
Seat 5: Hero (small blind) folded before Flop
Seat 6: e037ac5c (big blind) showed [7d 7s] and won (215,888) with Pair of Sevens and Pair of Sixes
Seat 7: 3100482d folded before Flop
Seat 8: ce70777b showed [Th Ad] and lost with Pair of Sixes


Poker Hand #TM3552631583: Tournament #156543396, Bounty Hunters Special $1.08 Hold'em No Limit - Level24(4,000/8,000) - 2024/08/05 13:28:46
Table '81' 8-max Seat #2 is the button
Seat 1: 33e312cf (325,032 in chips)
Seat 2: 37ff5d80 (294,903 in chips)
Seat 3: 3ac46d19 (413,731 in chips)
Seat 5: Hero (834,389 in chips)
Seat 6: e037ac5c (598,122 in chips)
Seat 7: 3100482d (186,280 in chips)
Seat 8: ce70777b (104,144 in chips)
ce70777b: posts the ante 1,200
33e312cf: posts the ante 1,200
37ff5d80: posts the ante 1,200
e037ac5c: posts the ante 1,200
3100482d: posts the ante 1,200
3ac46d19: posts the ante 1,200
Hero: posts the ante 1,200
3ac46d19: posts small blind 4,000
Hero: posts big blind 8,000
*** HOLE CARDS ***
Dealt to 33e312cf 
Dealt to 37ff5d80 
Dealt to 3ac46d19 
Dealt to Hero [7h Qd]
Dealt to e037ac5c 
Dealt to 3100482d 
Dealt to ce70777b 
e037ac5c: folds
3100482d: folds
ce70777b: folds
33e312cf: raises 9,600 to 17,600
37ff5d80: folds
3ac46d19: raises 38,700 to 56,300
Hero: folds
33e312cf: folds
Uncalled bet (38,700) returned to 3ac46d19
*** SHOWDOWN ***
3ac46d19 collected 51,600 from pot
*** SUMMARY ***
Total pot 51,600 | Rake 0 | Jackpot 0 | Bingo 0 | Fortune 0 | Tax 0
Seat 1: 33e312cf folded before Flop
Seat 2: 37ff5d80 (button) folded before Flop
Seat 3: 3ac46d19 (small blind) collected (51,600)
Seat 5: Hero (big blind) folded before Flop
Seat 6: e037ac5c folded before Flop
Seat 7: 3100482d folded before Flop
Seat 8: ce70777b folded before Flop


Poker Hand #TM3552631570: Tournament #156543396, Bounty Hunters Special $1.08 Hold'em No Limit - Level24(4,000/8,000) - 2024/08/05 13:28:14
Table '81' 8-max Seat #1 is the button
Seat 1: 33e312cf (326,232 in chips)
Seat 2: 37ff5d80 (300,103 in chips)
Seat 3: 3ac46d19 (422,931 in chips)
Seat 5: Hero (815,189 in chips)
Seat 6: e037ac5c (599,322 in chips)
Seat 7: 3100482d (187,480 in chips)
Seat 8: ce70777b (105,344 in chips)
ce70777b: posts the ante 1,200
33e312cf: posts the ante 1,200
37ff5d80: posts the ante 1,200
e037ac5c: posts the ante 1,200
3100482d: posts the ante 1,200
3ac46d19: posts the ante 1,200
Hero: posts the ante 1,200
37ff5d80: posts small blind 4,000
3ac46d19: posts big blind 8,000
*** HOLE CARDS ***
Dealt to 33e312cf 
Dealt to 37ff5d80 
Dealt to 3ac46d19 
Dealt to Hero [Ad Td]
Dealt to e037ac5c 
Dealt to 3100482d 
Dealt to ce70777b 
Hero: raises 12,000 to 20,000
e037ac5c: folds
3100482d: folds
ce70777b: folds
33e312cf: folds
37ff5d80: folds
3ac46d19: folds
Uncalled bet (12,000) returned to Hero
Hero: shows [Ad Td]
*** SHOWDOWN ***
Hero collected 28,400 from pot
*** SUMMARY ***
Total pot 28,400 | Rake 0 | Jackpot 0 | Bingo 0 | Fortune 0 | Tax 0
Seat 1: 33e312cf (button) folded before Flop
Seat 2: 37ff5d80 (small blind) folded before Flop
Seat 3: 3ac46d19 (big blind) folded before Flop
Seat 5: Hero showed [Ad Td] and collected (28,400)
Seat 6: e037ac5c folded before Flop
Seat 7: 3100482d folded before Flop
Seat 8: ce70777b folded before Flop


Poker Hand #TM3552631551: Tournament #156543396, Bounty Hunters Special $1.08 Hold'em No Limit - Level24(4,000/8,000) - 2024/08/05 13:27:26
Table '81' 8-max Seat #8 is the button
Seat 1: 33e312cf (331,432 in chips)
Seat 2: 37ff5d80 (309,303 in chips)
Seat 3: 3ac46d19 (424,131 in chips)
Seat 4: d61fe11f (92,295 in chips)
Seat 5: Hero (703,694 in chips)
Seat 6: e037ac5c (600,522 in chips)
Seat 7: 3100482d (188,680 in chips)
Seat 8: ce70777b (106,544 in chips)
ce70777b: posts the ante 1,200
d61fe11f: posts the ante 1,200
33e312cf: posts the ante 1,200
37ff5d80: posts the ante 1,200
e037ac5c: posts the ante 1,200
3100482d: posts the ante 1,200
3ac46d19: posts the ante 1,200
Hero: posts the ante 1,200
33e312cf: posts small blind 4,000
37ff5d80: posts big blind 8,000
*** HOLE CARDS ***
Dealt to 33e312cf 
Dealt to 37ff5d80 
Dealt to 3ac46d19 
Dealt to d61fe11f 
Dealt to Hero [As Ah]
Dealt to e037ac5c 
Dealt to 3100482d 
Dealt to ce70777b 
3ac46d19: folds
d61fe11f: raises 83,095 to 91,095 and is all-in
Hero: raises 83,095 to 174,190
e037ac5c: folds
3100482d: folds
ce70777b: folds
33e312cf: folds
37ff5d80: folds
Uncalled bet (83,095) returned to Hero
Hero: shows [As Ah]
d61fe11f: shows [8c 8s]
*** FLOP *** [Js Kd 5d]
*** TURN *** [Js Kd 5d] [4c]
*** RIVER *** [Js Kd 5d 4c] [Kh]
ce70777b: shows [5s Ks] (Kings Full over Fives)
*** SHOWDOWN ***
Hero collected 203,790 from pot
*** SUMMARY ***
Total pot 203,790 | Rake 0 | Jackpot 0 | Bingo 0 | Fortune 0 | Tax 0
Board [Js Kd 5d 4c Kh]
Seat 1: 33e312cf (small blind) folded before Flop
Seat 2: 37ff5d80 (big blind) folded before Flop
Seat 3: 3ac46d19 folded before Flop
Seat 4: d61fe11f showed [8c 8s] and lost with Pair of Kings and Pair of Eights
Seat 5: Hero showed [As Ah] and won (203,790) with Pair of Aces and Pair of Kings
Seat 6: e037ac5c folded before Flop
Seat 7: 3100482d folded before Flop
Seat 8: ce70777b (button) folded before Flop


Poker Hand #TM3552631516: Tournament #156543396, Bounty Hunters Special $1.08 Hold'em No Limit - Level24(4,000/8,000) - 2024/08/05 13:26:20
Table '81' 8-max Seat #7 is the button
Seat 1: 33e312cf (340,632 in chips)
Seat 2: 37ff5d80 (310,503 in chips)
Seat 3: 3ac46d19 (425,331 in chips)
Seat 4: d61fe11f (93,495 in chips)
Seat 5: Hero (704,894 in chips)
Seat 6: e037ac5c (550,522 in chips)
Seat 7: 3100482d (189,880 in chips)
Seat 8: ce70777b (141,344 in chips)
ce70777b: posts the ante 1,200
d61fe11f: posts the ante 1,200
33e312cf: posts the ante 1,200
37ff5d80: posts the ante 1,200
e037ac5c: posts the ante 1,200
3100482d: posts the ante 1,200
3ac46d19: posts the ante 1,200
Hero: posts the ante 1,200
ce70777b: posts small blind 4,000
33e312cf: posts big blind 8,000
*** HOLE CARDS ***
Dealt to 33e312cf 
Dealt to 37ff5d80 
Dealt to 3ac46d19 
Dealt to d61fe11f 
Dealt to Hero [4s As]
Dealt to e037ac5c 
Dealt to 3100482d 
Dealt to ce70777b 
37ff5d80: folds
3ac46d19: folds
d61fe11f: folds
Hero: folds
e037ac5c: raises 9,600 to 17,600
3100482d: folds
ce70777b: calls 13,600
33e312cf: folds
*** FLOP *** [Jd Qc Kd]
ce70777b: checks
e037ac5c: bets 16,000
ce70777b: calls 16,000
*** TURN *** [Jd Qc Kd] [5s]
ce70777b: checks
e037ac5c: bets 32,000
ce70777b: folds
Uncalled bet (32,000) returned to e037ac5c
ce70777b: shows [Tc] (King-High)
*** SHOWDOWN ***
e037ac5c collected 84,800 from pot
*** SUMMARY ***
Total pot 84,800 | Rake 0 | Jackpot 0 | Bingo 0 | Fortune 0 | Tax 0
Board [Jd Qc Kd 5s]
Seat 1: 33e312cf (big blind) folded before Flop
Seat 2: 37ff5d80 folded before Flop
Seat 3: 3ac46d19 folded before Flop
Seat 4: d61fe11f folded before Flop
Seat 5: Hero folded before Flop
Seat 6: e037ac5c won (84,800)
Seat 7: 3100482d (button) folded before Flop
Seat 8: ce70777b (small blind) folded on the Turn


Poker Hand #TM3552631491: Tournament #156543396, Bounty Hunters Special $1.08 Hold'em No Limit - Level24(4,000/8,000) - 2024/08/05 13:25:19
Table '81' 8-max Seat #6 is the button
Seat 1: 33e312cf (341,832 in chips)
Seat 3: 3ac46d19 (426,531 in chips)
Seat 4: d61fe11f (25,565 in chips)
Seat 5: Hero (746,824 in chips)
Seat 6: e037ac5c (559,722 in chips)
Seat 7: 3100482d (195,080 in chips)
Seat 8: ce70777b (150,544 in chips)
ce70777b: posts the ante 1,200
d61fe11f: posts the ante 1,200
33e312cf: posts the ante 1,200
e037ac5c: posts the ante 1,200
3100482d: posts the ante 1,200
3ac46d19: posts the ante 1,200
Hero: posts the ante 1,200
3100482d: posts small blind 4,000
ce70777b: posts big blind 8,000
*** HOLE CARDS ***
Dealt to 33e312cf 
Dealt to 3ac46d19 
Dealt to d61fe11f 
Dealt to Hero [Ac 4s]
Dealt to e037ac5c 
Dealt to 3100482d 
Dealt to ce70777b 
33e312cf: folds
3ac46d19: folds
d61fe11f: raises 16,365 to 24,365 and is all-in
Hero: raises 16,365 to 40,730
e037ac5c: raises 55,270 to 96,000
3100482d: folds
ce70777b: folds
Hero: folds
Uncalled bet (55,270) returned to e037ac5c
e037ac5c: shows [Js 3d]
d61fe11f: shows [8s 6c]
*** FLOP *** [Qh 5s Td]
*** TURN *** [Qh 5s Td] [4d]
*** RIVER *** [Qh 5s Td 4d] [7c]
Hero: shows [Ac 4s] (Pair of Fours)
*** SHOWDOWN ***
d61fe11f collected 93,495 from pot
e037ac5c collected 32,730 from pot
*** SUMMARY ***
Total pot 126,225 | Rake 0 | Jackpot 0 | Bingo 0 | Fortune 0 | Tax 0
Board [Qh 5s Td 4d 7c]
Seat 1: 33e312cf folded before Flop
Seat 3: 3ac46d19 folded before Flop
Seat 4: d61fe11f showed [8s 6c] and won (93,495) with Eights-High Straight
Seat 5: Hero folded before Flop
Seat 6: e037ac5c (button) showed [Js 3d] and won (32,730) with Queen-High
Seat 7: 3100482d (small blind) folded before Flop
Seat 8: ce70777b (big blind) folded before Flop


Poker Hand #TM3552631473: Tournament #156543396, Bounty Hunters Special $1.08 Hold'em No Limit - Level23(3,500/7,000) - 2024/08/05 13:24:41
Table '81' 8-max Seat #5 is the button
Seat 1: 33e312cf (342,832 in chips)
Seat 3: 3ac46d19 (427,531 in chips)
Seat 5: Hero (731,324 in chips)
Seat 6: e037ac5c (564,222 in chips)
Seat 7: 3100482d (203,080 in chips)
Seat 8: ce70777b (151,544 in chips)
ce70777b: posts the ante 1,000
33e312cf: posts the ante 1,000
e037ac5c: posts the ante 1,000
3100482d: posts the ante 1,000
3ac46d19: posts the ante 1,000
Hero: posts the ante 1,000
e037ac5c: posts small blind 3,500
3100482d: posts big blind 7,000
*** HOLE CARDS ***
Dealt to 33e312cf 
Dealt to 3ac46d19 
Dealt to Hero [Ks Kd]
Dealt to e037ac5c 
Dealt to 3100482d 
Dealt to ce70777b 
ce70777b: folds
33e312cf: folds
3ac46d19: folds
Hero: raises 21,000 to 28,000
e037ac5c: folds
3100482d: folds
Uncalled bet (21,000) returned to Hero
*** SHOWDOWN ***
Hero collected 23,500 from pot
*** SUMMARY ***
Total pot 23,500 | Rake 0 | Jackpot 0 | Bingo 0 | Fortune 0 | Tax 0
Seat 1: 33e312cf folded before Flop
Seat 3: 3ac46d19 folded before Flop
Seat 5: Hero (button) collected (23,500)
Seat 6: e037ac5c (small blind) folded before Flop
Seat 7: 3100482d (big blind) folded before Flop
Seat 8: ce70777b folded before Flop


Poker Hand #TM3552631451: Tournament #156543396, Bounty Hunters Special $1.08 Hold'em No Limit - Level23(3,500/7,000) - 2024/08/05 13:23:55
Table '81' 8-max Seat #3 is the button
Seat 1: 33e312cf (343,832 in chips)
Seat 2: b7ffda6e (36,326 in chips)
Seat 3: 3ac46d19 (428,531 in chips)
Seat 5: Hero (682,998 in chips)
Seat 6: e037ac5c (572,222 in chips)
Seat 7: 3100482d (204,080 in chips)
Seat 8: ce70777b (152,544 in chips)
ce70777b: posts the ante 1,000
33e312cf: posts the ante 1,000
b7ffda6e: posts the ante 1,000
e037ac5c: posts the ante 1,000
3100482d: posts the ante 1,000
3ac46d19: posts the ante 1,000
Hero: posts the ante 1,000
Hero: posts small blind 3,500
e037ac5c: posts big blind 7,000
*** HOLE CARDS ***
Dealt to 33e312cf 
Dealt to b7ffda6e 
Dealt to 3ac46d19 
Dealt to Hero [Js Qd]
Dealt to e037ac5c 
Dealt to 3100482d 
Dealt to ce70777b 
3100482d: folds
ce70777b: folds
33e312cf: folds
b7ffda6e: raises 28,326 to 35,326 and is all-in
3ac46d19: folds
Hero: raises 28,326 to 63,652
e037ac5c: folds
Uncalled bet (28,326) returned to Hero
Hero: shows [Js Qd]
b7ffda6e: shows [Ts 9s]
*** FLOP *** [5s 3d 7c]
*** TURN *** [5s 3d 7c] [4s]
*** RIVER *** [5s 3d 7c 4s] [Jc]
3100482d: shows [As 2c] (Fives-High Straight)
*** SHOWDOWN ***
Hero collected 84,652 from pot
*** SUMMARY ***
Total pot 84,652 | Rake 0 | Jackpot 0 | Bingo 0 | Fortune 0 | Tax 0
Board [5s 3d 7c 4s Jc]
Seat 1: 33e312cf folded before Flop
Seat 2: b7ffda6e showed [Ts 9s] and lost with Jack-High
Seat 3: 3ac46d19 (button) folded before Flop
Seat 5: Hero (small blind) showed [Js Qd] and won (84,652) with Pair of Jacks
Seat 6: e037ac5c (big blind) folded before Flop
Seat 7: 3100482d folded before Flop
Seat 8: ce70777b folded before Flop


Poker Hand #TM3552631435: Tournament #156543396, Bounty Hunters Special $1.08 Hold'em No Limit - Level23(3,500/7,000) - 2024/08/05 13:23:19
Table '81' 8-max Seat #2 is the button
Seat 1: 33e312cf (318,932 in chips)
Seat 2: b7ffda6e (37,326 in chips)
Seat 3: 3ac46d19 (433,031 in chips)
Seat 5: Hero (699,398 in chips)
Seat 6: e037ac5c (573,222 in chips)
Seat 7: 3100482d (205,080 in chips)
Seat 8: ce70777b (153,544 in chips)
ce70777b: posts the ante 1,000
33e312cf: posts the ante 1,000
b7ffda6e: posts the ante 1,000
e037ac5c: posts the ante 1,000
3100482d: posts the ante 1,000
3ac46d19: posts the ante 1,000
Hero: posts the ante 1,000
3ac46d19: posts small blind 3,500
Hero: posts big blind 7,000
*** HOLE CARDS ***
Dealt to 33e312cf 
Dealt to b7ffda6e 
Dealt to 3ac46d19 
Dealt to Hero [3h Ah]
Dealt to e037ac5c 
Dealt to 3100482d 
Dealt to ce70777b 
e037ac5c: folds
3100482d: folds
ce70777b: folds
33e312cf: raises 8,400 to 15,400
b7ffda6e: folds
3ac46d19: folds
Hero: calls 8,400
*** FLOP *** [Jh Jd Kc]
Hero: checks
33e312cf: bets 13,629
Hero: folds
Uncalled bet (13,629) returned to 33e312cf
*** SHOWDOWN ***
33e312cf collected 41,300 from pot
*** SUMMARY ***
Total pot 41,300 | Rake 0 | Jackpot 0 | Bingo 0 | Fortune 0 | Tax 0
Board [Jh Jd Kc]
Seat 1: 33e312cf won (41,300)
Seat 2: b7ffda6e (button) folded before Flop
Seat 3: 3ac46d19 (small blind) folded before Flop
Seat 5: Hero (big blind) folded on the Flop
Seat 6: e037ac5c folded before Flop
Seat 7: 3100482d folded before Flop
Seat 8: ce70777b folded before Flop


Poker Hand #TM3552631413: Tournament #156543396, Bounty Hunters Special $1.08 Hold'em No Limit - Level23(3,500/7,000) - 2024/08/05 13:22:33
Table '81' 8-max Seat #1 is the button
Seat 1: 33e312cf (319,932 in chips)
Seat 2: b7ffda6e (34,826 in chips)
Seat 3: 3ac46d19 (430,531 in chips)
Seat 5: Hero (700,398 in chips)
Seat 6: e037ac5c (574,222 in chips)
Seat 7: 3100482d (206,080 in chips)
Seat 8: ce70777b (154,544 in chips)
ce70777b: posts the ante 1,000
33e312cf: posts the ante 1,000
e037ac5c: posts the ante 1,000
b7ffda6e: posts the ante 1,000
3100482d: posts the ante 1,000
3ac46d19: posts the ante 1,000
Hero: posts the ante 1,000
b7ffda6e: posts small blind 3,500
3ac46d19: posts big blind 7,000
*** HOLE CARDS ***
Dealt to 33e312cf 
Dealt to b7ffda6e 
Dealt to 3ac46d19 
Dealt to Hero [Ks 4h]
Dealt to e037ac5c 
Dealt to 3100482d 
Dealt to ce70777b 
Hero: folds
e037ac5c: folds
3100482d: folds
ce70777b: folds
33e312cf: folds
b7ffda6e: raises 26,826 to 33,826 and is all-in
3ac46d19: calls 26,826
b7ffda6e: shows [7d As]
3ac46d19: shows [4c Ah]
*** FLOP *** [2h 2c Kd]
*** TURN *** [2h 2c Kd] [Kc]
*** RIVER *** [2h 2c Kd Kc] [3c]
*** SHOWDOWN ***
3ac46d19 collected 37,326 from pot
b7ffda6e collected 37,326 from pot
*** SUMMARY ***
Total pot 74,652 | Rake 0 | Jackpot 0 | Bingo 0 | Fortune 0 | Tax 0
Board [2h 2c Kd Kc 3c]
Seat 1: 33e312cf (button) folded before Flop
Seat 2: b7ffda6e (small blind) showed [7d As] and won (37,326) with Pair of Kings and Pair of Twos
Seat 3: 3ac46d19 (big blind) showed [4c Ah] and won (37,326) with Pair of Kings and Pair of Twos
Seat 5: Hero folded before Flop
Seat 6: e037ac5c folded before Flop
Seat 7: 3100482d folded before Flop
Seat 8: ce70777b folded before Flop


Poker Hand #TM3552631402: Tournament #156543396, Bounty Hunters Special $1.08 Hold'em No Limit - Level23(3,500/7,000) - 2024/08/05 13:22:03
Table '81' 8-max Seat #8 is the button
Seat 1: 33e312cf (324,432 in chips)
Seat 2: b7ffda6e (42,826 in chips)
Seat 3: 3ac46d19 (431,531 in chips)
Seat 5: Hero (701,398 in chips)
Seat 6: e037ac5c (590,622 in chips)
Seat 7: 3100482d (207,080 in chips)
Seat 8: ce70777b (122,644 in chips)
ce70777b: posts the ante 1,000
33e312cf: posts the ante 1,000
e037ac5c: posts the ante 1,000
b7ffda6e: posts the ante 1,000
3100482d: posts the ante 1,000
3ac46d19: posts the ante 1,000
Hero: posts the ante 1,000
33e312cf: posts small blind 3,500
b7ffda6e: posts big blind 7,000
*** HOLE CARDS ***
Dealt to 33e312cf 
Dealt to b7ffda6e 
Dealt to 3ac46d19 
Dealt to Hero [3h Th]
Dealt to e037ac5c 
Dealt to 3100482d 
Dealt to ce70777b 
3ac46d19: folds
Hero: folds
e037ac5c: raises 8,400 to 15,400
3100482d: folds
ce70777b: raises 106,244 to 121,644 and is all-in
33e312cf: folds
b7ffda6e: folds
e037ac5c: folds
Uncalled bet (106,244) returned to ce70777b
*** SHOWDOWN ***
ce70777b collected 48,300 from pot
*** SUMMARY ***
Total pot 48,300 | Rake 0 | Jackpot 0 | Bingo 0 | Fortune 0 | Tax 0
Seat 1: 33e312cf (small blind) folded before Flop
Seat 2: b7ffda6e (big blind) folded before Flop
Seat 3: 3ac46d19 folded before Flop
Seat 5: Hero folded before Flop
Seat 6: e037ac5c folded before Flop
Seat 7: 3100482d folded before Flop
Seat 8: ce70777b (button) collected (48,300)


Poker Hand #TM3552631338: Tournament #156543396, Bounty Hunters Special $1.08 Hold'em No Limit - Level23(3,500/7,000) - 2024/08/05 13:19:55
Table '81' 8-max Seat #7 is the button
Seat 1: 33e312cf (157,966 in chips)
Seat 2: b7ffda6e (43,826 in chips)
Seat 3: 3ac46d19 (432,531 in chips)
Seat 5: Hero (702,398 in chips)
Seat 6: e037ac5c (748,588 in chips)
Seat 7: 3100482d (208,080 in chips)
Seat 8: ce70777b (127,144 in chips)
ce70777b: posts the ante 1,000
33e312cf: posts the ante 1,000
e037ac5c: posts the ante 1,000
b7ffda6e: posts the ante 1,000
3100482d: posts the ante 1,000
3ac46d19: posts the ante 1,000
Hero: posts the ante 1,000
ce70777b: posts small blind 3,500
33e312cf: posts big blind 7,000
*** HOLE CARDS ***
Dealt to 33e312cf 
Dealt to b7ffda6e 
Dealt to 3ac46d19 
Dealt to Hero [2d 6d]
Dealt to e037ac5c 
Dealt to 3100482d 
Dealt to ce70777b 
b7ffda6e: folds
3ac46d19: folds
Hero: folds
e037ac5c: raises 8,400 to 15,400
3100482d: folds
ce70777b: folds
33e312cf: calls 8,400
*** FLOP *** [9c 9s 4d]
33e312cf: checks
e037ac5c: bets 14,700
33e312cf: calls 14,700
*** TURN *** [9c 9s 4d] [Ts]
33e312cf: checks
e037ac5c: bets 56,000
33e312cf: raises 70,866 to 126,866 and is all-in
e037ac5c: calls 70,866
33e312cf: shows [9h Ac] (Three Nines)
e037ac5c: shows [Ah 2s] (Pair of Nines)
*** RIVER *** [9c 9s 4d Ts] [Qh]
*** SHOWDOWN ***
33e312cf collected 324,432 from pot
*** SUMMARY ***
Total pot 324,432 | Rake 0 | Jackpot 0 | Bingo 0 | Fortune 0 | Tax 0
Board [9c 9s 4d Ts Qh]
Seat 1: 33e312cf (big blind) showed [9h Ac] and won (324,432) with Three Nines
Seat 2: b7ffda6e folded before Flop
Seat 3: 3ac46d19 folded before Flop
Seat 5: Hero folded before Flop
Seat 6: e037ac5c showed [Ah 2s] and lost with Pair of Nines
Seat 7: 3100482d (button) folded before Flop
Seat 8: ce70777b (small blind) folded before Flop


Poker Hand #TM3552631325: Tournament #156543396, Bounty Hunters Special $1.08 Hold'em No Limit - Level23(3,500/7,000) - 2024/08/05 13:19:27
Table '81' 8-max Seat #6 is the button
Seat 1: 33e312cf (158,966 in chips)
Seat 2: b7ffda6e (44,826 in chips)
Seat 3: 3ac46d19 (433,531 in chips)
Seat 5: Hero (703,398 in chips)
Seat 6: e037ac5c (732,088 in chips)
Seat 7: 3100482d (212,580 in chips)
Seat 8: ce70777b (135,144 in chips)
ce70777b: posts the ante 1,000
33e312cf: posts the ante 1,000
e037ac5c: posts the ante 1,000
b7ffda6e: posts the ante 1,000
3100482d: posts the ante 1,000
3ac46d19: posts the ante 1,000
Hero: posts the ante 1,000
3100482d: posts small blind 3,500
ce70777b: posts big blind 7,000
*** HOLE CARDS ***
Dealt to 33e312cf 
Dealt to b7ffda6e 
Dealt to 3ac46d19 
Dealt to Hero [9h 8d]
Dealt to e037ac5c 
Dealt to 3100482d 
Dealt to ce70777b 
33e312cf: folds
b7ffda6e: folds
3ac46d19: folds
Hero: folds
e037ac5c: raises 8,400 to 15,400
3100482d: folds
ce70777b: folds
Uncalled bet (8,400) returned to e037ac5c
*** SHOWDOWN ***
e037ac5c collected 24,500 from pot
*** SUMMARY ***
Total pot 24,500 | Rake 0 | Jackpot 0 | Bingo 0 | Fortune 0 | Tax 0
Seat 1: 33e312cf folded before Flop
Seat 2: b7ffda6e folded before Flop
Seat 3: 3ac46d19 folded before Flop
Seat 5: Hero folded before Flop
Seat 6: e037ac5c (button) collected (24,500)
Seat 7: 3100482d (small blind) folded before Flop
Seat 8: ce70777b (big blind) folded before Flop


Poker Hand #TM3552631309: Tournament #156543396, Bounty Hunters Special $1.08 Hold'em No Limit - Level23(3,500/7,000) - 2024/08/05 13:19:00
Table '81' 8-max Seat #5 is the button
Seat 1: 33e312cf (159,966 in chips)
Seat 2: b7ffda6e (45,826 in chips)
Seat 3: 3ac46d19 (434,531 in chips)
Seat 5: Hero (704,398 in chips)
Seat 6: e037ac5c (719,088 in chips)
Seat 7: 3100482d (220,580 in chips)
Seat 8: ce70777b (136,144 in chips)
ce70777b: posts the ante 1,000
33e312cf: posts the ante 1,000
b7ffda6e: posts the ante 1,000
e037ac5c: posts the ante 1,000
3100482d: posts the ante 1,000
3ac46d19: posts the ante 1,000
Hero: posts the ante 1,000
e037ac5c: posts small blind 3,500
3100482d: posts big blind 7,000
*** HOLE CARDS ***
Dealt to 33e312cf 
Dealt to b7ffda6e 
Dealt to 3ac46d19 
Dealt to Hero [4d 2s]
Dealt to e037ac5c 
Dealt to 3100482d 
Dealt to ce70777b 
ce70777b: folds
33e312cf: folds
b7ffda6e: folds
3ac46d19: folds
Hero: folds
e037ac5c: raises 14,000 to 21,000
3100482d: folds
Uncalled bet (14,000) returned to e037ac5c
*** SHOWDOWN ***
e037ac5c collected 21,000 from pot
*** SUMMARY ***
Total pot 21,000 | Rake 0 | Jackpot 0 | Bingo 0 | Fortune 0 | Tax 0
Seat 1: 33e312cf folded before Flop
Seat 2: b7ffda6e folded before Flop
Seat 3: 3ac46d19 folded before Flop
Seat 5: Hero (button) folded before Flop
Seat 6: e037ac5c (small blind) collected (21,000)
Seat 7: 3100482d (big blind) folded before Flop
Seat 8: ce70777b folded before Flop


Poker Hand #TM3552631300: Tournament #156543396, Bounty Hunters Special $1.08 Hold'em No Limit - Level23(3,500/7,000) - 2024/08/05 13:18:40
Table '81' 8-max Seat #3 is the button
Seat 1: 33e312cf (160,966 in chips)
Seat 2: b7ffda6e (46,826 in chips)
Seat 3: 3ac46d19 (435,531 in chips)
Seat 5: Hero (708,898 in chips)
Seat 6: e037ac5c (727,088 in chips)
Seat 7: 3100482d (204,080 in chips)
Seat 8: ce70777b (137,144 in chips)
ce70777b: posts the ante 1,000
33e312cf: posts the ante 1,000
b7ffda6e: posts the ante 1,000
e037ac5c: posts the ante 1,000
3100482d: posts the ante 1,000
3ac46d19: posts the ante 1,000
Hero: posts the ante 1,000
Hero: posts small blind 3,500
e037ac5c: posts big blind 7,000
*** HOLE CARDS ***
Dealt to 33e312cf 
Dealt to b7ffda6e 
Dealt to 3ac46d19 
Dealt to Hero [Qd 3d]
Dealt to e037ac5c 
Dealt to 3100482d 
Dealt to ce70777b 
3100482d: raises 14,000 to 21,000
ce70777b: folds
33e312cf: folds
b7ffda6e: folds
3ac46d19: folds
Hero: folds
e037ac5c: folds
Uncalled bet (14,000) returned to 3100482d
*** SHOWDOWN ***
3100482d collected 24,500 from pot
*** SUMMARY ***
Total pot 24,500 | Rake 0 | Jackpot 0 | Bingo 0 | Fortune 0 | Tax 0
Seat 1: 33e312cf folded before Flop
Seat 2: b7ffda6e folded before Flop
Seat 3: 3ac46d19 (button) folded before Flop
Seat 5: Hero (small blind) folded before Flop
Seat 6: e037ac5c (big blind) folded before Flop
Seat 7: 3100482d collected (24,500)
Seat 8: ce70777b folded before Flop


Poker Hand #TM3552631279: Tournament #156543396, Bounty Hunters Special $1.08 Hold'em No Limit - Level23(3,500/7,000) - 2024/08/05 13:18:01
Table '81' 8-max Seat #2 is the button
Seat 1: 33e312cf (161,966 in chips)
Seat 2: b7ffda6e (47,826 in chips)
Seat 3: 3ac46d19 (440,031 in chips)
Seat 4: 49db3a58 (67,232 in chips)
Seat 5: Hero (709,898 in chips)
Seat 6: e037ac5c (743,488 in chips)
Seat 7: 3100482d (111,948 in chips)
Seat 8: ce70777b (138,144 in chips)
ce70777b: posts the ante 1,000
33e312cf: posts the ante 1,000
49db3a58: posts the ante 1,000
b7ffda6e: posts the ante 1,000
e037ac5c: posts the ante 1,000
3100482d: posts the ante 1,000
3ac46d19: posts the ante 1,000
Hero: posts the ante 1,000
3ac46d19: posts small blind 3,500
49db3a58: posts big blind 7,000
*** HOLE CARDS ***
Dealt to 33e312cf 
Dealt to b7ffda6e 
Dealt to 3ac46d19 
Dealt to 49db3a58 
Dealt to Hero [3c 9s]
Dealt to e037ac5c 
Dealt to 3100482d 
Dealt to ce70777b 
Hero: folds
e037ac5c: raises 8,400 to 15,400
3100482d: raises 95,548 to 110,948 and is all-in
ce70777b: folds
33e312cf: folds
b7ffda6e: folds
3ac46d19: folds
49db3a58: calls 59,232 and is all-in
e037ac5c: folds
Uncalled bet (44,716) returned to 3100482d
3100482d: shows [Qc Qd]
49db3a58: shows [3s Qs]
*** FLOP *** [8h 2h 6c]
*** TURN *** [8h 2h 6c] [Ac]
*** RIVER *** [8h 2h 6c Ac] [Ks]
Hero: shows [3c] (Ace-High)
e037ac5c: shows [Kc] (Pair of Kings)
*** SHOWDOWN ***
3100482d collected 159,364 from pot
*** SUMMARY ***
Total pot 159,364 | Rake 0 | Jackpot 0 | Bingo 0 | Fortune 0 | Tax 0
Board [8h 2h 6c Ac Ks]
Seat 1: 33e312cf folded before Flop
Seat 2: b7ffda6e (button) folded before Flop
Seat 3: 3ac46d19 (small blind) folded before Flop
Seat 4: 49db3a58 (big blind) showed [3s Qs] and lost with Ace-High
Seat 5: Hero folded before Flop
Seat 6: e037ac5c folded before Flop
Seat 7: 3100482d showed [Qc Qd] and won (159,364) with Pair of Queens
Seat 8: ce70777b folded before Flop


Poker Hand #TM3552503968: Tournament #156543396, Bounty Hunters Special $1.08 Hold'em No Limit - Level23(3,500/7,000) - 2024/08/05 13:16:51
Table '76' 8-max Seat #8 is the button
Seat 1: 6f8884c (340,558 in chips)
Seat 2: 61e408a2 (116,966 in chips)
Seat 3: 7f1a035 (424,788 in chips)
Seat 4: 93b8065c (538,026 in chips)
Seat 5: Hero (529,470 in chips)
Seat 6: 1f76886 (82,962 in chips)
Seat 7: 3027fab9 (149,928 in chips)
Seat 8: fb9d1cf2 (88,264 in chips)
61e408a2: posts the ante 1,000
7f1a035: posts the ante 1,000
1f76886: posts the ante 1,000
93b8065c: posts the ante 1,000
fb9d1cf2: posts the ante 1,000
3027fab9: posts the ante 1,000
Hero: posts the ante 1,000
6f8884c: posts the ante 1,000
6f8884c: posts small blind 3,500
61e408a2: posts big blind 7,000
*** HOLE CARDS ***
Dealt to 6f8884c 
Dealt to 61e408a2 
Dealt to 7f1a035 
Dealt to 93b8065c 
Dealt to Hero [Jh Ad]
Dealt to 1f76886 
Dealt to 3027fab9 
Dealt to fb9d1cf2 
7f1a035: folds
93b8065c: raises 7,000 to 14,000
Hero: calls 14,000
1f76886: folds
3027fab9: raises 134,928 to 148,928 and is all-in
fb9d1cf2: folds
6f8884c: folds
61e408a2: folds
93b8065c: folds
Hero: calls 134,928
3027fab9: shows [Ah Ks]
Hero: shows [Jh Ad]
*** FLOP *** [Td 6h 5h]
*** TURN *** [Td 6h 5h] [Jc]
*** RIVER *** [Td 6h 5h Jc] [5c]
*** SHOWDOWN ***
Hero collected 330,356 from pot
*** SUMMARY ***
Total pot 330,356 | Rake 0 | Jackpot 0 | Bingo 0 | Fortune 0 | Tax 0
Board [Td 6h 5h Jc 5c]
Seat 1: 6f8884c (small blind) folded before Flop
Seat 2: 61e408a2 (big blind) folded before Flop
Seat 3: 7f1a035 folded before Flop
Seat 4: 93b8065c folded before Flop
Seat 5: Hero showed [Jh Ad] and won (330,356) with Pair of Jacks and Pair of Fives
Seat 6: 1f76886 folded before Flop
Seat 7: 3027fab9 showed [Ah Ks] and lost with Pair of Fives
Seat 8: fb9d1cf2 (button) folded before Flop


Poker Hand #TM3552503955: Tournament #156543396, Bounty Hunters Special $1.08 Hold'em No Limit - Level22(3,000/6,000) - 2024/08/05 13:16:24
Table '76' 8-max Seat #7 is the button
Seat 1: 6f8884c (347,458 in chips)
Seat 2: 61e408a2 (101,666 in chips)
Seat 3: 7f1a035 (425,688 in chips)
Seat 4: 93b8065c (538,926 in chips)
Seat 5: Hero (530,370 in chips)
Seat 6: 1f76886 (83,862 in chips)
Seat 7: 3027fab9 (150,828 in chips)
Seat 8: fb9d1cf2 (92,164 in chips)
61e408a2: posts the ante 900
7f1a035: posts the ante 900
1f76886: posts the ante 900
93b8065c: posts the ante 900
3027fab9: posts the ante 900
fb9d1cf2: posts the ante 900
Hero: posts the ante 900
6f8884c: posts the ante 900
fb9d1cf2: posts small blind 3,000
6f8884c: posts big blind 6,000
*** HOLE CARDS ***
Dealt to 6f8884c 
Dealt to 61e408a2 
Dealt to 7f1a035 
Dealt to 93b8065c 
Dealt to Hero [7c Ks]
Dealt to 1f76886 
Dealt to 3027fab9 
Dealt to fb9d1cf2 
61e408a2: raises 6,000 to 12,000
7f1a035: folds
93b8065c: folds
Hero: folds
1f76886: folds
3027fab9: folds
fb9d1cf2: folds
6f8884c: folds
Uncalled bet (6,000) returned to 61e408a2
*** SHOWDOWN ***
61e408a2 collected 22,200 from pot
*** SUMMARY ***
Total pot 22,200 | Rake 0 | Jackpot 0 | Bingo 0 | Fortune 0 | Tax 0
Seat 1: 6f8884c (big blind) folded before Flop
Seat 2: 61e408a2 collected (22,200)
Seat 3: 7f1a035 folded before Flop
Seat 4: 93b8065c folded before Flop
Seat 5: Hero folded before Flop
Seat 6: 1f76886 folded before Flop
Seat 7: 3027fab9 (button) folded before Flop
Seat 8: fb9d1cf2 (small blind) folded before Flop


Poker Hand #TM3552503941: Tournament #156543396, Bounty Hunters Special $1.08 Hold'em No Limit - Level22(3,000/6,000) - 2024/08/05 13:16:02
Table '76' 8-max Seat #6 is the button
Seat 1: 6f8884c (348,358 in chips)
Seat 2: 61e408a2 (102,566 in chips)
Seat 3: 7f1a035 (426,588 in chips)
Seat 4: 93b8065c (523,626 in chips)
Seat 5: Hero (531,270 in chips)
Seat 6: 1f76886 (84,762 in chips)
Seat 7: 3027fab9 (154,728 in chips)
Seat 8: fb9d1cf2 (99,064 in chips)
61e408a2: posts the ante 900
7f1a035: posts the ante 900
1f76886: posts the ante 900
93b8065c: posts the ante 900
fb9d1cf2: posts the ante 900
3027fab9: posts the ante 900
Hero: posts the ante 900
6f8884c: posts the ante 900
3027fab9: posts small blind 3,000
fb9d1cf2: posts big blind 6,000
*** HOLE CARDS ***
Dealt to 6f8884c 
Dealt to 61e408a2 
Dealt to 7f1a035 
Dealt to 93b8065c 
Dealt to Hero [6d Kd]
Dealt to 1f76886 
Dealt to 3027fab9 
Dealt to fb9d1cf2 
6f8884c: folds
61e408a2: folds
7f1a035: folds
93b8065c: raises 6,000 to 12,000
Hero: folds
1f76886: folds
3027fab9: folds
fb9d1cf2: folds
Uncalled bet (6,000) returned to 93b8065c
*** SHOWDOWN ***
93b8065c collected 22,200 from pot
*** SUMMARY ***
Total pot 22,200 | Rake 0 | Jackpot 0 | Bingo 0 | Fortune 0 | Tax 0
Seat 1: 6f8884c folded before Flop
Seat 2: 61e408a2 folded before Flop
Seat 3: 7f1a035 folded before Flop
Seat 4: 93b8065c collected (22,200)
Seat 5: Hero folded before Flop
Seat 6: 1f76886 (button) folded before Flop
Seat 7: 3027fab9 (small blind) folded before Flop
Seat 8: fb9d1cf2 (big blind) folded before Flop


Poker Hand #TM3552503907: Tournament #156543396, Bounty Hunters Special $1.08 Hold'em No Limit - Level22(3,000/6,000) - 2024/08/05 13:14:56
Table '76' 8-max Seat #5 is the button
Seat 2: 61e408a2 (109,466 in chips)
Seat 3: 7f1a035 (377,988 in chips)
Seat 4: 93b8065c (524,526 in chips)
Seat 5: Hero (560,370 in chips)
Seat 6: 1f76886 (88,662 in chips)
Seat 7: 3027fab9 (161,628 in chips)
Seat 8: fb9d1cf2 (99,964 in chips)
61e408a2: posts the ante 900
7f1a035: posts the ante 900
93b8065c: posts the ante 900
1f76886: posts the ante 900
fb9d1cf2: posts the ante 900
3027fab9: posts the ante 900
Hero: posts the ante 900
1f76886: posts small blind 3,000
3027fab9: posts big blind 6,000
*** HOLE CARDS ***
Dealt to 61e408a2 
Dealt to 7f1a035 
Dealt to 93b8065c 
Dealt to Hero [Kc Jc]
Dealt to 1f76886 
Dealt to 3027fab9 
Dealt to fb9d1cf2 
fb9d1cf2: folds
61e408a2: calls 6,000
7f1a035: raises 22,200 to 28,200
93b8065c: folds
Hero: calls 28,200
1f76886: folds
3027fab9: folds
61e408a2: folds
*** FLOP *** [6h As Ac]
7f1a035: checks
Hero: checks
*** TURN *** [6h As Ac] [Qd]
7f1a035: checks
Hero: checks
*** RIVER *** [6h As Ac Qd] [Qc]
7f1a035: checks
Hero: checks
7f1a035: shows [Qs Ks] (Queens Full over Aces)
Hero: shows [Kc Jc] (Pair of Aces and Pair of Queens)
*** SHOWDOWN ***
7f1a035 collected 77,700 from pot
*** SUMMARY ***
Total pot 77,700 | Rake 0 | Jackpot 0 | Bingo 0 | Fortune 0 | Tax 0
Board [6h As Ac Qd Qc]
Seat 2: 61e408a2 folded before Flop
Seat 3: 7f1a035 showed [Qs Ks] and won (77,700) with Queens Full over Aces
Seat 4: 93b8065c folded before Flop
Seat 5: Hero (button) showed [Kc Jc] and lost with Pair of Aces and Pair of Queens
Seat 6: 1f76886 (small blind) folded before Flop
Seat 7: 3027fab9 (big blind) folded before Flop
Seat 8: fb9d1cf2 folded before Flop


Poker Hand #TM3552503890: Tournament #156543396, Bounty Hunters Special $1.08 Hold'em No Limit - Level22(3,000/6,000) - 2024/08/05 13:14:22
Table '76' 8-max Seat #4 is the button
Seat 2: 61e408a2 (110,366 in chips)
Seat 3: 7f1a035 (378,888 in chips)
Seat 4: 93b8065c (525,426 in chips)
Seat 5: Hero (548,970 in chips)
Seat 6: 1f76886 (95,562 in chips)
Seat 7: 3027fab9 (162,528 in chips)
Seat 8: fb9d1cf2 (100,864 in chips)
61e408a2: posts the ante 900
7f1a035: posts the ante 900
93b8065c: posts the ante 900
1f76886: posts the ante 900
fb9d1cf2: posts the ante 900
3027fab9: posts the ante 900
Hero: posts the ante 900
Hero: posts small blind 3,000
1f76886: posts big blind 6,000
*** HOLE CARDS ***
Dealt to 61e408a2 
Dealt to 7f1a035 
Dealt to 93b8065c 
Dealt to Hero [Js Ad]
Dealt to 1f76886 
Dealt to 3027fab9 
Dealt to fb9d1cf2 
3027fab9: folds
fb9d1cf2: folds
61e408a2: folds
7f1a035: folds
93b8065c: folds
Hero: raises 102,000 to 108,000
1f76886: folds
Uncalled bet (102,000) returned to Hero
*** SHOWDOWN ***
Hero collected 18,300 from pot
*** SUMMARY ***
Total pot 18,300 | Rake 0 | Jackpot 0 | Bingo 0 | Fortune 0 | Tax 0
Seat 2: 61e408a2 folded before Flop
Seat 3: 7f1a035 folded before Flop
Seat 4: 93b8065c (button) folded before Flop
Seat 5: Hero (small blind) collected (18,300)
Seat 6: 1f76886 (big blind) folded before Flop
Seat 7: 3027fab9 folded before Flop
Seat 8: fb9d1cf2 folded before Flop


Poker Hand #TM3552503843: Tournament #156543396, Bounty Hunters Special $1.08 Hold'em No Limit - Level22(3,000/6,000) - 2024/08/05 13:13:02
Table '76' 8-max Seat #3 is the button
Seat 2: 61e408a2 (111,266 in chips)
Seat 3: 7f1a035 (379,788 in chips)
Seat 4: 93b8065c (529,326 in chips)
Seat 5: Hero (555,870 in chips)
Seat 6: 1f76886 (81,162 in chips)
Seat 7: 3027fab9 (163,428 in chips)
Seat 8: fb9d1cf2 (101,764 in chips)
61e408a2: posts the ante 900
7f1a035: posts the ante 900
1f76886: posts the ante 900
93b8065c: posts the ante 900
fb9d1cf2: posts the ante 900
3027fab9: posts the ante 900
Hero: posts the ante 900
93b8065c: posts small blind 3,000
Hero: posts big blind 6,000
*** HOLE CARDS ***
Dealt to 61e408a2 
Dealt to 7f1a035 
Dealt to 93b8065c 
Dealt to Hero [2h Jh]
Dealt to 1f76886 
Dealt to 3027fab9 
Dealt to fb9d1cf2 
1f76886: raises 74,262 to 80,262 and is all-in
3027fab9: folds
fb9d1cf2: folds
61e408a2: folds
7f1a035: folds
93b8065c: folds
Hero: folds
Uncalled bet (74,262) returned to 1f76886
*** SHOWDOWN ***
1f76886 collected 21,300 from pot
*** SUMMARY ***
Total pot 21,300 | Rake 0 | Jackpot 0 | Bingo 0 | Fortune 0 | Tax 0
Seat 2: 61e408a2 folded before Flop
Seat 3: 7f1a035 (button) folded before Flop
Seat 4: 93b8065c (small blind) folded before Flop
Seat 5: Hero (big blind) folded before Flop
Seat 6: 1f76886 collected (21,300)
Seat 7: 3027fab9 folded before Flop
Seat 8: fb9d1cf2 folded before Flop


Poker Hand #TM3552503777: Tournament #156543396, Bounty Hunters Special $1.08 Hold'em No Limit - Level22(3,000/6,000) - 2024/08/05 13:10:57
Table '10' 8-max Seat #8 is the button
Seat 1: fb11d1f8 (379,099 in chips)
Seat 2: 2b9fad02 (557,043 in chips)
Seat 3: 8296d653 (117,206 in chips)
Seat 4: Hero (425,164 in chips)
Seat 5: f5943517 (221,782 in chips)
Seat 6: 5884d2db (168,749 in chips)
Seat 8: 3100482d (136,148 in chips)
8296d653: posts the ante 900
fb11d1f8: posts the ante 900
2b9fad02: posts the ante 900
3100482d: posts the ante 900
5884d2db: posts the ante 900
f5943517: posts the ante 900
Hero: posts the ante 900
fb11d1f8: posts small blind 3,000
2b9fad02: posts big blind 6,000
*** HOLE CARDS ***
Dealt to fb11d1f8 
Dealt to 2b9fad02 
Dealt to 8296d653 
Dealt to Hero [Kd Kc]
Dealt to f5943517 
Dealt to 5884d2db 
Dealt to 3100482d 
8296d653: raises 110,306 to 116,306 and is all-in
Hero: raises 307,958 to 424,264 and is all-in
f5943517: folds
5884d2db: folds
3100482d: folds
fb11d1f8: folds
2b9fad02: folds
Uncalled bet (307,958) returned to Hero
Hero: shows [Kd Kc]
8296d653: shows [Ac Jd]
*** FLOP *** [Js 3d 9h]
*** TURN *** [Js 3d 9h] [Qs]
*** RIVER *** [Js 3d 9h Qs] [Kh]
f5943517: shows [As] (Ace-High)
2b9fad02: shows [Ah] (Ace-High)
*** SHOWDOWN ***
Hero collected 247,912 from pot
*** SUMMARY ***
Total pot 247,912 | Rake 0 | Jackpot 0 | Bingo 0 | Fortune 0 | Tax 0
Board [Js 3d 9h Qs Kh]
Seat 1: fb11d1f8 (small blind) folded before Flop
Seat 2: 2b9fad02 (big blind) folded before Flop
Seat 3: 8296d653 showed [Ac Jd] and lost with Pair of Jacks
Seat 4: Hero showed [Kd Kc] and won (247,912) with Three Kings
Seat 5: f5943517 folded before Flop
Seat 6: 5884d2db folded before Flop
Seat 8: 3100482d (button) folded before Flop


Poker Hand #TM3552503742: Tournament #156543396, Bounty Hunters Special $1.08 Hold'em No Limit - Level22(3,000/6,000) - 2024/08/05 13:09:46
Table '10' 8-max Seat #6 is the button
Seat 1: fb11d1f8 (379,999 in chips)
Seat 2: 2b9fad02 (557,943 in chips)
Seat 3: 8296d653 (130,106 in chips)
Seat 4: Hero (349,460 in chips)
Seat 5: f5943517 (222,682 in chips)
Seat 6: 5884d2db (169,649 in chips)
Seat 7: 9f3f486a (52,304 in chips)
Seat 8: 3100482d (143,048 in chips)
9f3f486a: posts the ante 900
8296d653: posts the ante 900
fb11d1f8: posts the ante 900
2b9fad02: posts the ante 900
3100482d: posts the ante 900
5884d2db: posts the ante 900
f5943517: posts the ante 900
Hero: posts the ante 900
9f3f486a: posts small blind 3,000
3100482d: posts big blind 6,000
*** HOLE CARDS ***
Dealt to fb11d1f8 
Dealt to 2b9fad02 
Dealt to 8296d653 
Dealt to Hero [Jd Jc]
Dealt to f5943517 
Dealt to 5884d2db 
Dealt to 9f3f486a 
Dealt to 3100482d 
fb11d1f8: folds
2b9fad02: folds
8296d653: raises 6,000 to 12,000
Hero: raises 13,266 to 25,266
f5943517: folds
5884d2db: folds
9f3f486a: raises 26,138 to 51,404 and is all-in
3100482d: folds
8296d653: folds
Hero: calls 26,138
9f3f486a: shows [Qh Ad]
Hero: shows [Jd Jc]
*** FLOP *** [Th 6d 9s]
*** TURN *** [Th 6d 9s] [Jh]
*** RIVER *** [Th 6d 9s Jh] [6h]
*** SHOWDOWN ***
Hero collected 128,008 from pot
*** SUMMARY ***
Total pot 128,008 | Rake 0 | Jackpot 0 | Bingo 0 | Fortune 0 | Tax 0
Board [Th 6d 9s Jh 6h]
Seat 1: fb11d1f8 folded before Flop
Seat 2: 2b9fad02 folded before Flop
Seat 3: 8296d653 folded before Flop
Seat 4: Hero showed [Jd Jc] and won (128,008) with Jacks Full over Sixes
Seat 5: f5943517 folded before Flop
Seat 6: 5884d2db (button) folded before Flop
Seat 7: 9f3f486a (small blind) showed [Qh Ad] and lost with Pair of Sixes
Seat 8: 3100482d (big blind) folded before Flop


Poker Hand #TM3552503704: Tournament #156543396, Bounty Hunters Special $1.08 Hold'em No Limit - Level21(2,500/5,000) - 2024/08/05 13:08:30
Table '10' 8-max Seat #5 is the button
Seat 1: fb11d1f8 (380,749 in chips)
Seat 2: 2b9fad02 (558,693 in chips)
Seat 3: 8296d653 (130,856 in chips)
Seat 4: Hero (350,210 in chips)
Seat 5: f5943517 (175,220 in chips)
Seat 6: 5884d2db (207,611 in chips)
Seat 7: 9f3f486a (58,054 in chips)
Seat 8: 3100482d (143,798 in chips)
9f3f486a: posts the ante 750
8296d653: posts the ante 750
fb11d1f8: posts the ante 750
2b9fad02: posts the ante 750
3100482d: posts the ante 750
f5943517: posts the ante 750
5884d2db: posts the ante 750
Hero: posts the ante 750
5884d2db: posts small blind 2,500
9f3f486a: posts big blind 5,000
*** HOLE CARDS ***
Dealt to fb11d1f8 
Dealt to 2b9fad02 
Dealt to 8296d653 
Dealt to Hero [5h Kh]
Dealt to f5943517 
Dealt to 5884d2db 
Dealt to 9f3f486a 
Dealt to 3100482d 
3100482d: folds
fb11d1f8: folds
2b9fad02: folds
8296d653: folds
Hero: folds
f5943517: raises 5,000 to 10,000
5884d2db: calls 7,500
9f3f486a: folds
*** FLOP *** [9d 6h Th]
5884d2db: checks
f5943517: bets 10,230
5884d2db: calls 10,230
*** TURN *** [9d 6h Th] [Qc]
5884d2db: checks
f5943517: bets 16,982
5884d2db: calls 16,982
*** RIVER *** [9d 6h Th Qc] [4d]
5884d2db: checks
f5943517: checks
5884d2db: shows [9s Js] (Pair of Nines)
f5943517: shows [Jd Tc] (Pair of Tens)
*** SHOWDOWN ***
f5943517 collected 85,424 from pot
*** SUMMARY ***
Total pot 85,424 | Rake 0 | Jackpot 0 | Bingo 0 | Fortune 0 | Tax 0
Board [9d 6h Th Qc 4d]
Seat 1: fb11d1f8 folded before Flop
Seat 2: 2b9fad02 folded before Flop
Seat 3: 8296d653 folded before Flop
Seat 4: Hero folded before Flop
Seat 5: f5943517 (button) showed [Jd Tc] and won (85,424) with Pair of Tens
Seat 6: 5884d2db (small blind) showed [9s Js] and lost with Pair of Nines
Seat 7: 9f3f486a (big blind) folded before Flop
Seat 8: 3100482d folded before Flop


Poker Hand #TM3552532597: Tournament #156543396, Bounty Hunters Special $1.08 Hold'em No Limit - Level21(2,500/5,000) - 2024/08/05 13:06:21
Table '72' 8-max Seat #1 is the button
Seat 1: 516045fd (121,424 in chips)
Seat 2: ec640bab (77,118 in chips)
Seat 3: 7966ecdb (27,179 in chips)
Seat 4: Hero (350,960 in chips)
Seat 5: 67a6e167 (148,008 in chips)
Seat 6: c50c4803 (596,149 in chips)
Seat 7: b5d5a24c (83,572 in chips)
Seat 8: 4e67c452 (270,140 in chips)
4e67c452: posts the ante 750
b5d5a24c: posts the ante 750
7966ecdb: posts the ante 750
516045fd: posts the ante 750
ec640bab: posts the ante 750
c50c4803: posts the ante 750
67a6e167: posts the ante 750
Hero: posts the ante 750
ec640bab: posts small blind 2,500
7966ecdb: posts big blind 5,000
*** HOLE CARDS ***
Dealt to 516045fd 
Dealt to ec640bab 
Dealt to 7966ecdb 
Dealt to Hero [7c 6h]
Dealt to 67a6e167 
Dealt to c50c4803 
Dealt to b5d5a24c 
Dealt to 4e67c452 
Hero: folds
67a6e167: raises 7,500 to 12,500
c50c4803: calls 12,500
b5d5a24c: raises 70,322 to 82,822 and is all-in
4e67c452: folds
516045fd: folds
ec640bab: folds
7966ecdb: folds
67a6e167: calls 70,322
c50c4803: raises 167,178 to 250,000
67a6e167: calls 64,436 and is all-in
Uncalled bet (102,742) returned to c50c4803
c50c4803: shows [Th Ts]
b5d5a24c: shows [5h 5d]
67a6e167: shows [Qc As]
*** FLOP *** [9c Kc Kh]
*** TURN *** [9c Kc Kh] [8c]
*** RIVER *** [9c Kc Kh 8c] [7d]
*** SHOWDOWN ***
c50c4803 collected 261,966 from pot
c50c4803 collected 128,872 from pot
*** SUMMARY ***
Total pot 390,838 | Rake 0 | Jackpot 0 | Bingo 0 | Fortune 0 | Tax 0
Board [9c Kc Kh 8c 7d]
Seat 1: 516045fd (button) folded before Flop
Seat 2: ec640bab (small blind) folded before Flop
Seat 3: 7966ecdb (big blind) folded before Flop
Seat 4: Hero folded before Flop
Seat 5: 67a6e167 showed [Qc As] and lost with Pair of Kings
Seat 6: c50c4803 showed [Th Ts] and won (390,838) with Pair of Kings and Pair of Tens
Seat 7: b5d5a24c showed [5h 5d] and lost with Pair of Kings and Pair of Fives
Seat 8: 4e67c452 folded before Flop


Poker Hand #TM3552532586: Tournament #156543396, Bounty Hunters Special $1.08 Hold'em No Limit - Level21(2,500/5,000) - 2024/08/05 13:05:53
Table '72' 8-max Seat #8 is the button
Seat 1: 516045fd (124,674 in chips)
Seat 2: ec640bab (82,868 in chips)
Seat 3: 7966ecdb (27,929 in chips)
Seat 4: Hero (338,210 in chips)
Seat 5: 67a6e167 (148,758 in chips)
Seat 6: c50c4803 (596,899 in chips)
Seat 7: b5d5a24c (84,322 in chips)
Seat 8: 4e67c452 (270,890 in chips)
4e67c452: posts the ante 750
b5d5a24c: posts the ante 750
7966ecdb: posts the ante 750
516045fd: posts the ante 750
ec640bab: posts the ante 750
c50c4803: posts the ante 750
67a6e167: posts the ante 750
Hero: posts the ante 750
516045fd: posts small blind 2,500
ec640bab: posts big blind 5,000
*** HOLE CARDS ***
Dealt to 516045fd 
Dealt to ec640bab 
Dealt to 7966ecdb 
Dealt to Hero [Ks Qh]
Dealt to 67a6e167 
Dealt to c50c4803 
Dealt to b5d5a24c 
Dealt to 4e67c452 
7966ecdb: folds
Hero: raises 7,500 to 12,500
67a6e167: folds
c50c4803: folds
b5d5a24c: folds
4e67c452: folds
516045fd: folds
ec640bab: folds
Uncalled bet (7,500) returned to Hero
*** SHOWDOWN ***
Hero collected 18,500 from pot
*** SUMMARY ***
Total pot 18,500 | Rake 0 | Jackpot 0 | Bingo 0 | Fortune 0 | Tax 0
Seat 1: 516045fd (small blind) folded before Flop
Seat 2: ec640bab (big blind) folded before Flop
Seat 3: 7966ecdb folded before Flop
Seat 4: Hero collected (18,500)
Seat 5: 67a6e167 folded before Flop
Seat 6: c50c4803 folded before Flop
Seat 7: b5d5a24c folded before Flop
Seat 8: 4e67c452 (button) folded before Flop


Poker Hand #TM3552532544: Tournament #156543396, Bounty Hunters Special $1.08 Hold'em No Limit - Level21(2,500/5,000) - 2024/08/05 13:04:25
Table '72' 8-max Seat #7 is the button
Seat 1: 516045fd (130,424 in chips)
Seat 2: ec640bab (83,618 in chips)
Seat 3: 7966ecdb (28,679 in chips)
Seat 4: Hero (338,960 in chips)
Seat 5: 67a6e167 (154,508 in chips)
Seat 6: c50c4803 (561,649 in chips)
Seat 7: b5d5a24c (100,072 in chips)
Seat 8: 4e67c452 (276,640 in chips)
b5d5a24c: posts the ante 750
4e67c452: posts the ante 750
7966ecdb: posts the ante 750
516045fd: posts the ante 750
ec640bab: posts the ante 750
c50c4803: posts the ante 750
67a6e167: posts the ante 750
Hero: posts the ante 750
4e67c452: posts small blind 2,500
516045fd: posts big blind 5,000
*** HOLE CARDS ***
Dealt to 516045fd 
Dealt to ec640bab 
Dealt to 7966ecdb 
Dealt to Hero [6d 3h]
Dealt to 67a6e167 
Dealt to c50c4803 
Dealt to b5d5a24c 
Dealt to 4e67c452 
ec640bab: folds
7966ecdb: folds
Hero: folds
67a6e167: calls 5,000
c50c4803: calls 5,000
b5d5a24c: calls 5,000
4e67c452: calls 2,500
516045fd: checks
*** FLOP *** [Qs Jd Ah]
4e67c452: checks
516045fd: checks
67a6e167: checks
c50c4803: checks
b5d5a24c: bets 10,000
4e67c452: folds
516045fd: folds
67a6e167: folds
c50c4803: calls 10,000
*** TURN *** [Qs Jd Ah] [4d]
c50c4803: checks
b5d5a24c: checks
*** RIVER *** [Qs Jd Ah 4d] [Th]
c50c4803: bets 85,000
b5d5a24c: folds
Uncalled bet (85,000) returned to c50c4803
*** SHOWDOWN ***
c50c4803 collected 51,000 from pot
*** SUMMARY ***
Total pot 51,000 | Rake 0 | Jackpot 0 | Bingo 0 | Fortune 0 | Tax 0
Board [Qs Jd Ah 4d Th]
Seat 1: 516045fd (big blind) folded on the Flop
Seat 2: ec640bab folded before Flop
Seat 3: 7966ecdb folded before Flop
Seat 4: Hero folded before Flop
Seat 5: 67a6e167 folded on the Flop
Seat 6: c50c4803 won (51,000)
Seat 7: b5d5a24c (button) folded on the River
Seat 8: 4e67c452 (small blind) folded on the Flop


Poker Hand #TM3552532523: Tournament #156543396, Bounty Hunters Special $1.08 Hold'em No Limit - Level21(2,500/5,000) - 2024/08/05 13:03:32
Table '72' 8-max Seat #6 is the button
Seat 1: 516045fd (131,174 in chips)
Seat 2: ec640bab (84,368 in chips)
Seat 3: 7966ecdb (29,429 in chips)
Seat 4: Hero (339,710 in chips)
Seat 5: 67a6e167 (155,258 in chips)
Seat 6: c50c4803 (562,399 in chips)
Seat 7: b5d5a24c (89,822 in chips)
Seat 8: 4e67c452 (282,390 in chips)
4e67c452: posts the ante 750
b5d5a24c: posts the ante 750
7966ecdb: posts the ante 750
516045fd: posts the ante 750
ec640bab: posts the ante 750
c50c4803: posts the ante 750
67a6e167: posts the ante 750
Hero: posts the ante 750
b5d5a24c: posts small blind 2,500
4e67c452: posts big blind 5,000
*** HOLE CARDS ***
Dealt to 516045fd 
Dealt to ec640bab 
Dealt to 7966ecdb 
Dealt to Hero [9h Qh]
Dealt to 67a6e167 
Dealt to c50c4803 
Dealt to b5d5a24c 
Dealt to 4e67c452 
516045fd: folds
ec640bab: folds
7966ecdb: folds
Hero: folds
67a6e167: folds
c50c4803: folds
b5d5a24c: calls 2,500
4e67c452: checks
*** FLOP *** [Jh 5h 7s]
b5d5a24c: checks
4e67c452: checks
*** TURN *** [Jh 5h 7s] [2d]
b5d5a24c: checks
4e67c452: checks
*** RIVER *** [Jh 5h 7s 2d] [6c]
b5d5a24c: checks
4e67c452: checks
b5d5a24c: shows [Kd 8h] (King-High)
4e67c452: shows [4c Kh] (King-High)
*** SHOWDOWN ***
b5d5a24c collected 16,000 from pot
*** SUMMARY ***
Total pot 16,000 | Rake 0 | Jackpot 0 | Bingo 0 | Fortune 0 | Tax 0
Board [Jh 5h 7s 2d 6c]
Seat 1: 516045fd folded before Flop
Seat 2: ec640bab folded before Flop
Seat 3: 7966ecdb folded before Flop
Seat 4: Hero folded before Flop
Seat 5: 67a6e167 folded before Flop
Seat 6: c50c4803 (button) folded before Flop
Seat 7: b5d5a24c (small blind) showed [Kd 8h] and won (16,000) with King-High
Seat 8: 4e67c452 (big blind) showed [4c Kh] and lost with King-High


Poker Hand #TM3552532507: Tournament #156543396, Bounty Hunters Special $1.08 Hold'em No Limit - Level21(2,500/5,000) - 2024/08/05 13:02:57
Table '72' 8-max Seat #5 is the button
Seat 1: 516045fd (131,924 in chips)
Seat 2: ec640bab (85,118 in chips)
Seat 3: 7966ecdb (30,179 in chips)
Seat 4: Hero (340,460 in chips)
Seat 5: 67a6e167 (156,008 in chips)
Seat 6: c50c4803 (552,149 in chips)
Seat 7: b5d5a24c (95,572 in chips)
Seat 8: 4e67c452 (283,140 in chips)
4e67c452: posts the ante 750
b5d5a24c: posts the ante 750
7966ecdb: posts the ante 750
516045fd: posts the ante 750
ec640bab: posts the ante 750
c50c4803: posts the ante 750
67a6e167: posts the ante 750
Hero: posts the ante 750
c50c4803: posts small blind 2,500
b5d5a24c: posts big blind 5,000
*** HOLE CARDS ***
Dealt to 516045fd 
Dealt to ec640bab 
Dealt to 7966ecdb 
Dealt to Hero [9h Ac]
Dealt to 67a6e167 
Dealt to c50c4803 
Dealt to b5d5a24c 
Dealt to 4e67c452 
4e67c452: folds
516045fd: folds
ec640bab: folds
7966ecdb: folds
Hero: folds
67a6e167: folds
c50c4803: raises 5,000 to 10,000
b5d5a24c: folds
Uncalled bet (5,000) returned to c50c4803
*** SHOWDOWN ***
c50c4803 collected 16,000 from pot
*** SUMMARY ***
Total pot 16,000 | Rake 0 | Jackpot 0 | Bingo 0 | Fortune 0 | Tax 0
Seat 1: 516045fd folded before Flop
Seat 2: ec640bab folded before Flop
Seat 3: 7966ecdb folded before Flop
Seat 4: Hero folded before Flop
Seat 5: 67a6e167 (button) folded before Flop
Seat 6: c50c4803 (small blind) collected (16,000)
Seat 7: b5d5a24c (big blind) folded before Flop
Seat 8: 4e67c452 folded before Flop


Poker Hand #TM3552532491: Tournament #156543396, Bounty Hunters Special $1.08 Hold'em No Limit - Level21(2,500/5,000) - 2024/08/05 13:02:21
Table '72' 8-max Seat #4 is the button
Seat 1: 516045fd (132,674 in chips)
Seat 2: ec640bab (85,868 in chips)
Seat 3: 7966ecdb (30,929 in chips)
Seat 4: Hero (341,210 in chips)
Seat 5: 67a6e167 (159,258 in chips)
Seat 6: c50c4803 (544,399 in chips)
Seat 7: b5d5a24c (96,322 in chips)
Seat 8: 4e67c452 (283,890 in chips)
4e67c452: posts the ante 750
b5d5a24c: posts the ante 750
7966ecdb: posts the ante 750
516045fd: posts the ante 750
ec640bab: posts the ante 750
c50c4803: posts the ante 750
Hero: posts the ante 750
67a6e167: posts the ante 750
67a6e167: posts small blind 2,500
c50c4803: posts big blind 5,000
*** HOLE CARDS ***
Dealt to 516045fd 
Dealt to ec640bab 
Dealt to 7966ecdb 
Dealt to Hero [8c 7c]
Dealt to 67a6e167 
Dealt to c50c4803 
Dealt to b5d5a24c 
Dealt to 4e67c452 
b5d5a24c: folds
4e67c452: folds
516045fd: folds
ec640bab: folds
7966ecdb: folds
Hero: folds
67a6e167: folds
Uncalled bet (2,500) returned to c50c4803
c50c4803: shows [3d 3h]
*** SHOWDOWN ***
c50c4803 collected 11,000 from pot
*** SUMMARY ***
Total pot 11,000 | Rake 0 | Jackpot 0 | Bingo 0 | Fortune 0 | Tax 0
Seat 1: 516045fd folded before Flop
Seat 2: ec640bab folded before Flop
Seat 3: 7966ecdb folded before Flop
Seat 4: Hero (button) folded before Flop
Seat 5: 67a6e167 (small blind) folded before Flop
Seat 6: c50c4803 (big blind) showed [3d 3h] and collected (11,000)
Seat 7: b5d5a24c folded before Flop
Seat 8: 4e67c452 folded before Flop


Poker Hand #TM3552532476: Tournament #156543396, Bounty Hunters Special $1.08 Hold'em No Limit - Level21(2,500/5,000) - 2024/08/05 13:01:42
Table '72' 8-max Seat #3 is the button
Seat 1: 516045fd (133,424 in chips)
Seat 2: ec640bab (86,618 in chips)
Seat 3: 7966ecdb (31,679 in chips)
Seat 4: Hero (344,460 in chips)
Seat 5: 67a6e167 (165,008 in chips)
Seat 6: c50c4803 (545,149 in chips)
Seat 7: b5d5a24c (83,572 in chips)
Seat 8: 4e67c452 (284,640 in chips)
4e67c452: posts the ante 750
b5d5a24c: posts the ante 750
7966ecdb: posts the ante 750
516045fd: posts the ante 750
ec640bab: posts the ante 750
c50c4803: posts the ante 750
67a6e167: posts the ante 750
Hero: posts the ante 750
Hero: posts small blind 2,500
67a6e167: posts big blind 5,000
*** HOLE CARDS ***
Dealt to 516045fd 
Dealt to ec640bab 
Dealt to 7966ecdb 
Dealt to Hero [2s 6c]
Dealt to 67a6e167 
Dealt to c50c4803 
Dealt to b5d5a24c 
Dealt to 4e67c452 
c50c4803: folds
b5d5a24c: raises 77,822 to 82,822 and is all-in
4e67c452: folds
516045fd: folds
ec640bab: folds
7966ecdb: folds
Hero: folds
67a6e167: folds
Uncalled bet (77,822) returned to b5d5a24c
*** SHOWDOWN ***
b5d5a24c collected 18,500 from pot
*** SUMMARY ***
Total pot 18,500 | Rake 0 | Jackpot 0 | Bingo 0 | Fortune 0 | Tax 0
Seat 1: 516045fd folded before Flop
Seat 2: ec640bab folded before Flop
Seat 3: 7966ecdb (button) folded before Flop
Seat 4: Hero (small blind) folded before Flop
Seat 5: 67a6e167 (big blind) folded before Flop
Seat 6: c50c4803 folded before Flop
Seat 7: b5d5a24c collected (18,500)
Seat 8: 4e67c452 folded before Flop


Poker Hand #TM3552532460: Tournament #156543396, Bounty Hunters Special $1.08 Hold'em No Limit - Level21(2,500/5,000) - 2024/08/05 13:01:02
Table '72' 8-max Seat #1 is the button
Seat 1: 516045fd (134,174 in chips)
Seat 3: 7966ecdb (34,929 in chips)
Seat 4: Hero (337,460 in chips)
Seat 5: 67a6e167 (165,758 in chips)
Seat 6: c50c4803 (545,899 in chips)
Seat 7: b5d5a24c (84,322 in chips)
Seat 8: 4e67c452 (285,390 in chips)
4e67c452: posts the ante 750
b5d5a24c: posts the ante 750
7966ecdb: posts the ante 750
516045fd: posts the ante 750
c50c4803: posts the ante 750
67a6e167: posts the ante 750
Hero: posts the ante 750
7966ecdb: posts small blind 2,500
Hero: posts big blind 5,000
*** HOLE CARDS ***
Dealt to 516045fd 
Dealt to 7966ecdb 
Dealt to Hero [Ah Jc]
Dealt to 67a6e167 
Dealt to c50c4803 
Dealt to b5d5a24c 
Dealt to 4e67c452 
67a6e167: folds
c50c4803: folds
b5d5a24c: folds
4e67c452: folds
516045fd: folds
7966ecdb: folds
Uncalled bet (2,500) returned to Hero
*** SHOWDOWN ***
Hero collected 10,250 from pot
*** SUMMARY ***
Total pot 10,250 | Rake 0 | Jackpot 0 | Bingo 0 | Fortune 0 | Tax 0
Seat 1: 516045fd (button) folded before Flop
Seat 3: 7966ecdb (small blind) folded before Flop
Seat 4: Hero (big blind) collected (10,250)
Seat 5: 67a6e167 folded before Flop
Seat 6: c50c4803 folded before Flop
Seat 7: b5d5a24c folded before Flop
Seat 8: 4e67c452 folded before Flop


Poker Hand #TM3552532430: Tournament #156543396, Bounty Hunters Special $1.08 Hold'em No Limit - Level20(2,000/4,000) - 2024/08/05 12:54:25
Table '72' 8-max Seat #8 is the button
Seat 1: 516045fd (136,774 in chips)
Seat 3: 7966ecdb (39,529 in chips)
Seat 4: Hero (338,060 in chips)
Seat 5: 67a6e167 (166,358 in chips)
Seat 6: c50c4803 (402,424 in chips)
Seat 7: b5d5a24c (84,922 in chips)
Seat 8: c4922e67 (134,475 in chips)
b5d5a24c: posts the ante 600
7966ecdb: posts the ante 600
516045fd: posts the ante 600
c4922e67: posts the ante 600
c50c4803: posts the ante 600
67a6e167: posts the ante 600
Hero: posts the ante 600
516045fd: posts small blind 2,000
7966ecdb: posts big blind 4,000
*** HOLE CARDS ***
Dealt to 516045fd 
Dealt to 7966ecdb 
Dealt to Hero [Th 8s]
Dealt to 67a6e167 
Dealt to c50c4803 
Dealt to b5d5a24c 
Dealt to c4922e67 
Hero: folds
67a6e167: folds
c50c4803: raises 4,000 to 8,000
b5d5a24c: folds
c4922e67: raises 125,875 to 133,875 and is all-in
516045fd: folds
7966ecdb: folds
c50c4803: calls 125,875
c4922e67: shows [5c 5d]
c50c4803: shows [Jc Kc]
*** FLOP *** [4d 7h Ac]
*** TURN *** [4d 7h Ac] [Js]
*** RIVER *** [4d 7h Ac Js] [8d]
*** SHOWDOWN ***
c50c4803 collected 277,950 from pot
*** SUMMARY ***
Total pot 277,950 | Rake 0 | Jackpot 0 | Bingo 0 | Fortune 0 | Tax 0
Board [4d 7h Ac Js 8d]
Seat 1: 516045fd (small blind) folded before Flop
Seat 3: 7966ecdb (big blind) folded before Flop
Seat 4: Hero folded before Flop
Seat 5: 67a6e167 folded before Flop
Seat 6: c50c4803 showed [Jc Kc] and won (277,950) with Pair of Jacks
Seat 7: b5d5a24c folded before Flop
Seat 8: c4922e67 (button) showed [5c 5d] and lost with Pair of Fives


Poker Hand #TM3552532408: Tournament #156543396, Bounty Hunters Special $1.08 Hold'em No Limit - Level20(2,000/4,000) - 2024/08/05 12:53:07
Table '72' 8-max Seat #7 is the button
Seat 1: 516045fd (141,374 in chips)
Seat 2: 1760a0a7 (170,316 in chips)
Seat 3: 7966ecdb (40,129 in chips)
Seat 4: Hero (338,660 in chips)
Seat 5: 67a6e167 (178,958 in chips)
Seat 6: c50c4803 (210,508 in chips)
Seat 7: b5d5a24c (85,522 in chips)
Seat 8: c4922e67 (137,075 in chips)
b5d5a24c: posts the ante 600
7966ecdb: posts the ante 600
516045fd: posts the ante 600
c4922e67: posts the ante 600
1760a0a7: posts the ante 600
c50c4803: posts the ante 600
67a6e167: posts the ante 600
Hero: posts the ante 600
c4922e67: posts small blind 2,000
516045fd: posts big blind 4,000
*** HOLE CARDS ***
Dealt to 516045fd 
Dealt to 1760a0a7 
Dealt to 7966ecdb 
Dealt to Hero [Jd 2h]
Dealt to 67a6e167 
Dealt to c50c4803 
Dealt to b5d5a24c 
Dealt to c4922e67 
1760a0a7: raises 8,000 to 12,000
7966ecdb: folds
Hero: folds
67a6e167: calls 12,000
c50c4803: calls 12,000
b5d5a24c: folds
c4922e67: folds
516045fd: folds
*** FLOP *** [Ts 9h 8s]
1760a0a7: checks
67a6e167: checks
c50c4803: bets 16,000
1760a0a7: calls 16,000
67a6e167: folds
*** TURN *** [Ts 9h 8s] [Qc]
1760a0a7: checks
c50c4803: bets 40,000
1760a0a7: calls 40,000
*** RIVER *** [Ts 9h 8s Qc] [4c]
1760a0a7: checks
c50c4803: bets 100,000
1760a0a7: raises 1,716 to 101,716 and is all-in
c50c4803: calls 1,716
1760a0a7: shows [Qs Kh] (Pair of Queens)
c50c4803: shows [As Jc] (Queens-High Straight)
*** SHOWDOWN ***
c50c4803 collected 362,232 from pot
*** SUMMARY ***
Total pot 362,232 | Rake 0 | Jackpot 0 | Bingo 0 | Fortune 0 | Tax 0
Board [Ts 9h 8s Qc 4c]
Seat 1: 516045fd (big blind) folded before Flop
Seat 2: 1760a0a7 showed [Qs Kh] and lost with Pair of Queens
Seat 3: 7966ecdb folded before Flop
Seat 4: Hero folded before Flop
Seat 5: 67a6e167 folded on the Flop
Seat 6: c50c4803 showed [As Jc] and won (362,232) with Queens-High Straight
Seat 7: b5d5a24c (button) folded before Flop
Seat 8: c4922e67 (small blind) folded before Flop


Poker Hand #TM3552532387: Tournament #156543396, Bounty Hunters Special $1.08 Hold'em No Limit - Level20(2,000/4,000) - 2024/08/05 12:51:42
Table '72' 8-max Seat #6 is the button
Seat 1: 516045fd (141,974 in chips)
Seat 2: 1760a0a7 (170,916 in chips)
Seat 3: 7966ecdb (40,729 in chips)
Seat 4: Hero (343,260 in chips)
Seat 5: 67a6e167 (128,358 in chips)
Seat 6: c50c4803 (211,108 in chips)
Seat 7: b5d5a24c (90,122 in chips)
Seat 8: c4922e67 (176,075 in chips)
b5d5a24c: posts the ante 600
7966ecdb: posts the ante 600
516045fd: posts the ante 600
c4922e67: posts the ante 600
1760a0a7: posts the ante 600
c50c4803: posts the ante 600
67a6e167: posts the ante 600
Hero: posts the ante 600
b5d5a24c: posts small blind 2,000
c4922e67: posts big blind 4,000
*** HOLE CARDS ***
Dealt to 516045fd 
Dealt to 1760a0a7 
Dealt to 7966ecdb 
Dealt to Hero [Ah Jd]
Dealt to 67a6e167 
Dealt to c50c4803 
Dealt to b5d5a24c 
Dealt to c4922e67 
516045fd: folds
1760a0a7: folds
7966ecdb: folds
Hero: calls 4,000
67a6e167: calls 4,000
c50c4803: folds
b5d5a24c: calls 2,000
c4922e67: checks
*** FLOP *** [7d Tc Qh]
b5d5a24c: checks
c4922e67: checks
Hero: checks
67a6e167: bets 12,000
b5d5a24c: folds
c4922e67: calls 12,000
Hero: folds
*** TURN *** [7d Tc Qh] [8d]
c4922e67: checks
67a6e167: bets 22,400
c4922e67: calls 22,400
*** RIVER *** [7d Tc Qh 8d] [5d]
c4922e67: checks
67a6e167: bets 60,000
c4922e67: folds
Uncalled bet (60,000) returned to 67a6e167
*** SHOWDOWN ***
67a6e167 collected 89,600 from pot
*** SUMMARY ***
Total pot 89,600 | Rake 0 | Jackpot 0 | Bingo 0 | Fortune 0 | Tax 0
Board [7d Tc Qh 8d 5d]
Seat 1: 516045fd folded before Flop
Seat 2: 1760a0a7 folded before Flop
Seat 3: 7966ecdb folded before Flop
Seat 4: Hero folded on the Flop
Seat 5: 67a6e167 won (89,600)
Seat 6: c50c4803 (button) folded before Flop
Seat 7: b5d5a24c (small blind) folded on the Flop
Seat 8: c4922e67 (big blind) folded on the River


Poker Hand #TM3552532378: Tournament #156543396, Bounty Hunters Special $1.08 Hold'em No Limit - Level20(2,000/4,000) - 2024/08/05 12:51:01
Table '72' 8-max Seat #5 is the button
Seat 1: 516045fd (142,574 in chips)
Seat 2: 1760a0a7 (171,516 in chips)
Seat 3: 7966ecdb (41,329 in chips)
Seat 4: Hero (331,060 in chips)
Seat 5: 67a6e167 (128,958 in chips)
Seat 6: c50c4803 (215,708 in chips)
Seat 7: b5d5a24c (94,722 in chips)
Seat 8: c4922e67 (176,675 in chips)
b5d5a24c: posts the ante 600
7966ecdb: posts the ante 600
516045fd: posts the ante 600
c4922e67: posts the ante 600
1760a0a7: posts the ante 600
c50c4803: posts the ante 600
67a6e167: posts the ante 600
Hero: posts the ante 600
c50c4803: posts small blind 2,000
b5d5a24c: posts big blind 4,000
*** HOLE CARDS ***
Dealt to 516045fd 
Dealt to 1760a0a7 
Dealt to 7966ecdb 
Dealt to Hero [Qs Ac]
Dealt to 67a6e167 
Dealt to c50c4803 
Dealt to b5d5a24c 
Dealt to c4922e67 
c4922e67: folds
516045fd: folds
1760a0a7: folds
7966ecdb: folds
Hero: calls 4,000
67a6e167: folds
c50c4803: calls 2,000
b5d5a24c: checks
*** FLOP *** [Ah 6d 3c]
c50c4803: checks
b5d5a24c: checks
Hero: bets 5,544
c50c4803: folds
b5d5a24c: folds
Uncalled bet (5,544) returned to Hero
*** SHOWDOWN ***
Hero collected 16,800 from pot
*** SUMMARY ***
Total pot 16,800 | Rake 0 | Jackpot 0 | Bingo 0 | Fortune 0 | Tax 0
Board [Ah 6d 3c]
Seat 1: 516045fd folded before Flop
Seat 2: 1760a0a7 folded before Flop
Seat 3: 7966ecdb folded before Flop
Seat 4: Hero won (16,800)
Seat 5: 67a6e167 (button) folded before Flop
Seat 6: c50c4803 (small blind) folded on the Flop
Seat 7: b5d5a24c (big blind) folded on the Flop
Seat 8: c4922e67 folded before Flop


Poker Hand #TM3552532357: Tournament #156543396, Bounty Hunters Special $1.08 Hold'em No Limit - Level20(2,000/4,000) - 2024/08/05 12:49:56
Table '72' 8-max Seat #4 is the button
Seat 1: 516045fd (143,174 in chips)
Seat 2: 1760a0a7 (172,116 in chips)
Seat 3: 7966ecdb (49,929 in chips)
Seat 4: Hero (331,660 in chips)
Seat 5: 67a6e167 (88,758 in chips)
Seat 6: c50c4803 (220,308 in chips)
Seat 7: b5d5a24c (119,322 in chips)
Seat 8: c4922e67 (177,275 in chips)
b5d5a24c: posts the ante 600
7966ecdb: posts the ante 600
516045fd: posts the ante 600
c4922e67: posts the ante 600
1760a0a7: posts the ante 600
c50c4803: posts the ante 600
Hero: posts the ante 600
67a6e167: posts the ante 600
67a6e167: posts small blind 2,000
c50c4803: posts big blind 4,000
*** HOLE CARDS ***
Dealt to 516045fd 
Dealt to 1760a0a7 
Dealt to 7966ecdb 
Dealt to Hero [Tc 9c]
Dealt to 67a6e167 
Dealt to c50c4803 
Dealt to b5d5a24c 
Dealt to c4922e67 
b5d5a24c: raises 4,000 to 8,000
c4922e67: folds
516045fd: folds
1760a0a7: folds
7966ecdb: calls 8,000
Hero: folds
67a6e167: calls 6,000
c50c4803: folds
*** FLOP *** [2c Ah 4c]
67a6e167: checks
b5d5a24c: bets 8,000
7966ecdb: folds
67a6e167: raises 8,000 to 16,000
b5d5a24c: calls 8,000
*** TURN *** [2c Ah 4c] [Kc]
67a6e167: checks
b5d5a24c: checks
*** RIVER *** [2c Ah 4c Kc] [Kd]
67a6e167: checks
b5d5a24c: checks
67a6e167: shows [7s Ac] (Pair of Aces and Pair of Kings)
b5d5a24c: shows [5s 5d] (Pair of Kings and Pair of Fives)
*** SHOWDOWN ***
67a6e167 collected 64,800 from pot
*** SUMMARY ***
Total pot 64,800 | Rake 0 | Jackpot 0 | Bingo 0 | Fortune 0 | Tax 0
Board [2c Ah 4c Kc Kd]
Seat 1: 516045fd folded before Flop
Seat 2: 1760a0a7 folded before Flop
Seat 3: 7966ecdb folded on the Flop
Seat 4: Hero (button) folded before Flop
Seat 5: 67a6e167 (small blind) showed [7s Ac] and won (64,800) with Pair of Aces and Pair of Kings
Seat 6: c50c4803 (big blind) folded before Flop
Seat 7: b5d5a24c showed [5s 5d] and lost with Pair of Kings and Pair of Fives
Seat 8: c4922e67 folded before Flop


Poker Hand #TM3552532348: Tournament #156543396, Bounty Hunters Special $1.08 Hold'em No Limit - Level20(2,000/4,000) - 2024/08/05 12:49:32
Table '72' 8-max Seat #3 is the button
Seat 1: 516045fd (143,774 in chips)
Seat 2: 1760a0a7 (172,716 in chips)
Seat 3: 7966ecdb (50,529 in chips)
Seat 4: Hero (334,260 in chips)
Seat 5: 67a6e167 (93,358 in chips)
Seat 6: c50c4803 (220,908 in chips)
Seat 8: c4922e67 (167,675 in chips)
7966ecdb: posts the ante 600
516045fd: posts the ante 600
c4922e67: posts the ante 600
1760a0a7: posts the ante 600
c50c4803: posts the ante 600
67a6e167: posts the ante 600
Hero: posts the ante 600
Hero: posts small blind 2,000
67a6e167: posts big blind 4,000
*** HOLE CARDS ***
Dealt to 516045fd 
Dealt to 1760a0a7 
Dealt to 7966ecdb 
Dealt to Hero [Ac 2d]
Dealt to 67a6e167 
Dealt to c50c4803 
Dealt to c4922e67 
c50c4803: folds
c4922e67: raises 4,000 to 8,000
516045fd: folds
1760a0a7: folds
7966ecdb: folds
Hero: folds
67a6e167: folds
Uncalled bet (4,000) returned to c4922e67
*** SHOWDOWN ***
c4922e67 collected 14,200 from pot
*** SUMMARY ***
Total pot 14,200 | Rake 0 | Jackpot 0 | Bingo 0 | Fortune 0 | Tax 0
Seat 1: 516045fd folded before Flop
Seat 2: 1760a0a7 folded before Flop
Seat 3: 7966ecdb (button) folded before Flop
Seat 4: Hero (small blind) folded before Flop
Seat 5: 67a6e167 (big blind) folded before Flop
Seat 6: c50c4803 folded before Flop
Seat 8: c4922e67 collected (14,200)


Poker Hand #TM3552532341: Tournament #156543396, Bounty Hunters Special $1.08 Hold'em No Limit - Level20(2,000/4,000) - 2024/08/05 12:49:10
Table '72' 8-max Seat #2 is the button
Seat 1: 516045fd (144,374 in chips)
Seat 2: 1760a0a7 (163,116 in chips)
Seat 3: 7966ecdb (53,129 in chips)
Seat 4: Hero (338,860 in chips)
Seat 5: 67a6e167 (93,958 in chips)
Seat 6: c50c4803 (221,508 in chips)
Seat 8: c4922e67 (168,275 in chips)
7966ecdb: posts the ante 600
516045fd: posts the ante 600
c4922e67: posts the ante 600
1760a0a7: posts the ante 600
c50c4803: posts the ante 600
67a6e167: posts the ante 600
Hero: posts the ante 600
7966ecdb: posts small blind 2,000
Hero: posts big blind 4,000
*** HOLE CARDS ***
Dealt to 516045fd 
Dealt to 1760a0a7 
Dealt to 7966ecdb 
Dealt to Hero [3h 2c]
Dealt to 67a6e167 
Dealt to c50c4803 
Dealt to c4922e67 
67a6e167: folds
c50c4803: folds
c4922e67: folds
516045fd: folds
1760a0a7: raises 8,000 to 12,000
7966ecdb: folds
Hero: folds
Uncalled bet (8,000) returned to 1760a0a7
*** SHOWDOWN ***
1760a0a7 collected 14,200 from pot
*** SUMMARY ***
Total pot 14,200 | Rake 0 | Jackpot 0 | Bingo 0 | Fortune 0 | Tax 0
Seat 1: 516045fd folded before Flop
Seat 2: 1760a0a7 (button) collected (14,200)
Seat 3: 7966ecdb (small blind) folded before Flop
Seat 4: Hero (big blind) folded before Flop
Seat 5: 67a6e167 folded before Flop
Seat 6: c50c4803 folded before Flop
Seat 8: c4922e67 folded before Flop


Poker Hand #TM3552532326: Tournament #156543396, Bounty Hunters Special $1.08 Hold'em No Limit - Level20(2,000/4,000) - 2024/08/05 12:48:21
Table '72' 8-max Seat #1 is the button
Seat 1: 516045fd (144,974 in chips)
Seat 2: 1760a0a7 (165,716 in chips)
Seat 3: 7966ecdb (57,729 in chips)
Seat 4: Hero (355,460 in chips)
Seat 5: 67a6e167 (94,558 in chips)
Seat 6: c50c4803 (238,108 in chips)
Seat 8: c4922e67 (126,675 in chips)
7966ecdb: posts the ante 600
516045fd: posts the ante 600
c4922e67: posts the ante 600
1760a0a7: posts the ante 600
c50c4803: posts the ante 600
67a6e167: posts the ante 600
Hero: posts the ante 600
1760a0a7: posts small blind 2,000
7966ecdb: posts big blind 4,000
*** HOLE CARDS ***
Dealt to 516045fd 
Dealt to 1760a0a7 
Dealt to 7966ecdb 
Dealt to Hero [4d 4c]
Dealt to 67a6e167 
Dealt to c50c4803 
Dealt to c4922e67 
Hero: calls 4,000
67a6e167: folds
c50c4803: calls 4,000
c4922e67: raises 12,000 to 16,000
516045fd: folds
1760a0a7: folds
7966ecdb: folds
Hero: calls 12,000
c50c4803: calls 12,000
*** FLOP *** [Ts 7c Qs]
Hero: checks
c50c4803: checks
c4922e67: bets 29,100
Hero: folds
c50c4803: folds
Uncalled bet (29,100) returned to c4922e67
*** SHOWDOWN ***
c4922e67 collected 58,200 from pot
*** SUMMARY ***
Total pot 58,200 | Rake 0 | Jackpot 0 | Bingo 0 | Fortune 0 | Tax 0
Board [Ts 7c Qs]
Seat 1: 516045fd (button) folded before Flop
Seat 2: 1760a0a7 (small blind) folded before Flop
Seat 3: 7966ecdb (big blind) folded before Flop
Seat 4: Hero folded on the Flop
Seat 5: 67a6e167 folded before Flop
Seat 6: c50c4803 folded on the Flop
Seat 8: c4922e67 won (58,200)


Poker Hand #TM3552532312: Tournament #156543396, Bounty Hunters Special $1.08 Hold'em No Limit - Level20(2,000/4,000) - 2024/08/05 12:47:27
Table '72' 8-max Seat #8 is the button
Seat 1: 516045fd (147,574 in chips)
Seat 2: 1760a0a7 (170,316 in chips)
Seat 3: 7966ecdb (66,329 in chips)
Seat 4: Hero (259,064 in chips)
Seat 5: 67a6e167 (95,158 in chips)
Seat 6: c50c4803 (238,708 in chips)
Seat 7: f35a242e (78,796 in chips)
Seat 8: c4922e67 (127,275 in chips)
7966ecdb: posts the ante 600
f35a242e: posts the ante 600
516045fd: posts the ante 600
c4922e67: posts the ante 600
1760a0a7: posts the ante 600
c50c4803: posts the ante 600
67a6e167: posts the ante 600
Hero: posts the ante 600
516045fd: posts small blind 2,000
1760a0a7: posts big blind 4,000
*** HOLE CARDS ***
Dealt to 516045fd 
Dealt to 1760a0a7 
Dealt to 7966ecdb 
Dealt to Hero [Qc Qs]
Dealt to 67a6e167 
Dealt to c50c4803 
Dealt to f35a242e 
Dealt to c4922e67 
7966ecdb: raises 4,000 to 8,000
Hero: raises 13,400 to 21,400
67a6e167: folds
c50c4803: folds
f35a242e: raises 56,796 to 78,196 and is all-in
c4922e67: folds
516045fd: folds
1760a0a7: folds
7966ecdb: folds
Hero: calls 56,796
f35a242e: shows [Ad Kd]
Hero: shows [Qc Qs]
*** FLOP *** [Th 2s Tc]
*** TURN *** [Th 2s Tc] [6d]
*** RIVER *** [Th 2s Tc 6d] [Jd]
*** SHOWDOWN ***
Hero collected 175,192 from pot
*** SUMMARY ***
Total pot 175,192 | Rake 0 | Jackpot 0 | Bingo 0 | Fortune 0 | Tax 0
Board [Th 2s Tc 6d Jd]
Seat 1: 516045fd (small blind) folded before Flop
Seat 2: 1760a0a7 (big blind) folded before Flop
Seat 3: 7966ecdb folded before Flop
Seat 4: Hero showed [Qc Qs] and won (175,192) with Pair of Queens and Pair of Tens
Seat 5: 67a6e167 folded before Flop
Seat 6: c50c4803 folded before Flop
Seat 7: f35a242e showed [Ad Kd] and lost with Pair of Tens
Seat 8: c4922e67 (button) folded before Flop


Poker Hand #TM3552532306: Tournament #156543396, Bounty Hunters Special $1.08 Hold'em No Limit - Level20(2,000/4,000) - 2024/08/05 12:47:05
Table '72' 8-max Seat #7 is the button
Seat 1: 516045fd (141,374 in chips)
Seat 2: 1760a0a7 (170,916 in chips)
Seat 3: 7966ecdb (66,929 in chips)
Seat 4: Hero (259,664 in chips)
Seat 5: 67a6e167 (95,758 in chips)
Seat 6: c50c4803 (239,308 in chips)
Seat 7: f35a242e (79,396 in chips)
Seat 8: c4922e67 (129,875 in chips)
7966ecdb: posts the ante 600
f35a242e: posts the ante 600
516045fd: posts the ante 600
c4922e67: posts the ante 600
1760a0a7: posts the ante 600
c50c4803: posts the ante 600
67a6e167: posts the ante 600
Hero: posts the ante 600
c4922e67: posts small blind 2,000
516045fd: posts big blind 4,000
*** HOLE CARDS ***
Dealt to 516045fd 
Dealt to 1760a0a7 
Dealt to 7966ecdb 
Dealt to Hero [6s Td]
Dealt to 67a6e167 
Dealt to c50c4803 
Dealt to f35a242e 
Dealt to c4922e67 
1760a0a7: folds
7966ecdb: folds
Hero: folds
67a6e167: folds
c50c4803: folds
f35a242e: folds
c4922e67: folds
Uncalled bet (2,000) returned to 516045fd
*** SHOWDOWN ***
516045fd collected 8,800 from pot
*** SUMMARY ***
Total pot 8,800 | Rake 0 | Jackpot 0 | Bingo 0 | Fortune 0 | Tax 0
Seat 1: 516045fd (big blind) collected (8,800)
Seat 2: 1760a0a7 folded before Flop
Seat 3: 7966ecdb folded before Flop
Seat 4: Hero folded before Flop
Seat 5: 67a6e167 folded before Flop
Seat 6: c50c4803 folded before Flop
Seat 7: f35a242e (button) folded before Flop
Seat 8: c4922e67 (small blind) folded before Flop


Poker Hand #TM3552532293: Tournament #156543396, Bounty Hunters Special $1.08 Hold'em No Limit - Level19(1,750/3,500) - 2024/08/05 12:45:56
Table '72' 8-max Seat #6 is the button
Seat 1: 516045fd (141,874 in chips)
Seat 2: 1760a0a7 (148,791 in chips)
Seat 3: 7966ecdb (67,429 in chips)
Seat 4: Hero (260,164 in chips)
Seat 5: 67a6e167 (96,258 in chips)
Seat 6: c50c4803 (239,808 in chips)
Seat 7: f35a242e (81,646 in chips)
Seat 8: c4922e67 (147,250 in chips)
7966ecdb: posts the ante 500
f35a242e: posts the ante 500
516045fd: posts the ante 500
c4922e67: posts the ante 500
1760a0a7: posts the ante 500
c50c4803: posts the ante 500
67a6e167: posts the ante 500
Hero: posts the ante 500
f35a242e: posts small blind 1,750
c4922e67: posts big blind 3,500
*** HOLE CARDS ***
Dealt to 516045fd 
Dealt to 1760a0a7 
Dealt to 7966ecdb 
Dealt to Hero [Qh Ts]
Dealt to 67a6e167 
Dealt to c50c4803 
Dealt to f35a242e 
Dealt to c4922e67 
516045fd: folds
1760a0a7: raises 3,500 to 7,000
7966ecdb: folds
Hero: folds
67a6e167: folds
c50c4803: folds
f35a242e: folds
c4922e67: calls 3,500
*** FLOP *** [6d Ks 8d]
c4922e67: checks
1760a0a7: bets 9,875
c4922e67: calls 9,875
*** TURN *** [6d Ks 8d] [Ac]
c4922e67: checks
1760a0a7: bets 19,750
c4922e67: folds
Uncalled bet (19,750) returned to 1760a0a7
*** SHOWDOWN ***
1760a0a7 collected 39,500 from pot
*** SUMMARY ***
Total pot 39,500 | Rake 0 | Jackpot 0 | Bingo 0 | Fortune 0 | Tax 0
Board [6d Ks 8d Ac]
Seat 1: 516045fd folded before Flop
Seat 2: 1760a0a7 won (39,500)
Seat 3: 7966ecdb folded before Flop
Seat 4: Hero folded before Flop
Seat 5: 67a6e167 folded before Flop
Seat 6: c50c4803 (button) folded before Flop
Seat 7: f35a242e (small blind) folded before Flop
Seat 8: c4922e67 (big blind) folded on the Turn


Poker Hand #TM3552532286: Tournament #156543396, Bounty Hunters Special $1.08 Hold'em No Limit - Level19(1,750/3,500) - 2024/08/05 12:45:27
Table '72' 8-max Seat #5 is the button
Seat 1: 516045fd (142,374 in chips)
Seat 2: 1760a0a7 (149,291 in chips)
Seat 3: 7966ecdb (67,929 in chips)
Seat 4: Hero (251,414 in chips)
Seat 5: 67a6e167 (96,758 in chips)
Seat 6: c50c4803 (242,058 in chips)
Seat 7: f35a242e (85,646 in chips)
Seat 8: c4922e67 (147,750 in chips)
7966ecdb: posts the ante 500
f35a242e: posts the ante 500
516045fd: posts the ante 500
c4922e67: posts the ante 500
1760a0a7: posts the ante 500
c50c4803: posts the ante 500
67a6e167: posts the ante 500
Hero: posts the ante 500
c50c4803: posts small blind 1,750
f35a242e: posts big blind 3,500
*** HOLE CARDS ***
Dealt to 516045fd 
Dealt to 1760a0a7 
Dealt to 7966ecdb 
Dealt to Hero [6c 6s]
Dealt to 67a6e167 
Dealt to c50c4803 
Dealt to f35a242e 
Dealt to c4922e67 
c4922e67: folds
516045fd: folds
1760a0a7: folds
7966ecdb: folds
Hero: calls 3,500
67a6e167: folds
c50c4803: folds
f35a242e: checks
*** FLOP *** [2d 4c 3d]
f35a242e: checks
Hero: bets 15,938
f35a242e: folds
Uncalled bet (15,938) returned to Hero
*** SHOWDOWN ***
Hero collected 12,750 from pot
*** SUMMARY ***
Total pot 12,750 | Rake 0 | Jackpot 0 | Bingo 0 | Fortune 0 | Tax 0
Board [2d 4c 3d]
Seat 1: 516045fd folded before Flop
Seat 2: 1760a0a7 folded before Flop
Seat 3: 7966ecdb folded before Flop
Seat 4: Hero won (12,750)
Seat 5: 67a6e167 (button) folded before Flop
Seat 6: c50c4803 (small blind) folded before Flop
Seat 7: f35a242e (big blind) folded on the Flop
Seat 8: c4922e67 folded before Flop


Poker Hand #TM3552532270: Tournament #156543396, Bounty Hunters Special $1.08 Hold'em No Limit - Level19(1,750/3,500) - 2024/08/05 12:44:23
Table '72' 8-max Seat #4 is the button
Seat 1: 516045fd (68,812 in chips)
Seat 2: 1760a0a7 (149,791 in chips)
Seat 3: 7966ecdb (68,429 in chips)
Seat 4: Hero (251,914 in chips)
Seat 5: 67a6e167 (99,008 in chips)
Seat 6: c50c4803 (310,870 in chips)
Seat 7: f35a242e (86,146 in chips)
Seat 8: c4922e67 (148,250 in chips)
7966ecdb: posts the ante 500
f35a242e: posts the ante 500
516045fd: posts the ante 500
c4922e67: posts the ante 500
1760a0a7: posts the ante 500
c50c4803: posts the ante 500
Hero: posts the ante 500
67a6e167: posts the ante 500
67a6e167: posts small blind 1,750
c50c4803: posts big blind 3,500
*** HOLE CARDS ***
Dealt to 516045fd 
Dealt to 1760a0a7 
Dealt to 7966ecdb 
Dealt to Hero [8d 2h]
Dealt to 67a6e167 
Dealt to c50c4803 
Dealt to f35a242e 
Dealt to c4922e67 
f35a242e: folds
c4922e67: folds
516045fd: raises 3,500 to 7,000
1760a0a7: folds
7966ecdb: folds
Hero: folds
67a6e167: folds
c50c4803: calls 3,500
*** FLOP *** [8s Tc Qs]
c50c4803: bets 7,000
516045fd: raises 7,425 to 14,425
c50c4803: raises 139,575 to 154,000
516045fd: calls 46,887 and is all-in
Uncalled bet (92,688) returned to c50c4803
c50c4803: shows [Ts 4s] (Pair of Tens)
516045fd: shows [Ah As] (Pair of Aces)
*** TURN *** [8s Tc Qs] [8h]
*** RIVER *** [8s Tc Qs 8h] [4d]
*** SHOWDOWN ***
516045fd collected 142,374 from pot
*** SUMMARY ***
Total pot 142,374 | Rake 0 | Jackpot 0 | Bingo 0 | Fortune 0 | Tax 0
Board [8s Tc Qs 8h 4d]
Seat 1: 516045fd showed [Ah As] and won (142,374) with Pair of Aces and Pair of Eights
Seat 2: 1760a0a7 folded before Flop
Seat 3: 7966ecdb folded before Flop
Seat 4: Hero (button) folded before Flop
Seat 5: 67a6e167 (small blind) folded before Flop
Seat 6: c50c4803 (big blind) showed [Ts 4s] and lost with Pair of Tens and Pair of Eights
Seat 7: f35a242e folded before Flop
Seat 8: c4922e67 folded before Flop


Poker Hand #TM3552532264: Tournament #156543396, Bounty Hunters Special $1.08 Hold'em No Limit - Level19(1,750/3,500) - 2024/08/05 12:44:02
Table '72' 8-max Seat #3 is the button
Seat 1: 516045fd (69,312 in chips)
Seat 2: 1760a0a7 (141,041 in chips)
Seat 3: 7966ecdb (68,929 in chips)
Seat 4: Hero (254,164 in chips)
Seat 5: 67a6e167 (103,008 in chips)
Seat 6: c50c4803 (311,370 in chips)
Seat 7: f35a242e (86,646 in chips)
Seat 8: c4922e67 (148,750 in chips)
7966ecdb: posts the ante 500
f35a242e: posts the ante 500
516045fd: posts the ante 500
c4922e67: posts the ante 500
1760a0a7: posts the ante 500
c50c4803: posts the ante 500
67a6e167: posts the ante 500
Hero: posts the ante 500
Hero: posts small blind 1,750
67a6e167: posts big blind 3,500
*** HOLE CARDS ***
Dealt to 516045fd 
Dealt to 1760a0a7 
Dealt to 7966ecdb 
Dealt to Hero [Th 7s]
Dealt to 67a6e167 
Dealt to c50c4803 
Dealt to f35a242e 
Dealt to c4922e67 
c50c4803: folds
f35a242e: folds
c4922e67: folds
516045fd: folds
1760a0a7: raises 3,500 to 7,000
7966ecdb: folds
Hero: folds
67a6e167: folds
Uncalled bet (3,500) returned to 1760a0a7
*** SHOWDOWN ***
1760a0a7 collected 12,750 from pot
*** SUMMARY ***
Total pot 12,750 | Rake 0 | Jackpot 0 | Bingo 0 | Fortune 0 | Tax 0
Seat 1: 516045fd folded before Flop
Seat 2: 1760a0a7 collected (12,750)
Seat 3: 7966ecdb (button) folded before Flop
Seat 4: Hero (small blind) folded before Flop
Seat 5: 67a6e167 (big blind) folded before Flop
Seat 6: c50c4803 folded before Flop
Seat 7: f35a242e folded before Flop
Seat 8: c4922e67 folded before Flop


Poker Hand #TM3552532247: Tournament #156543396, Bounty Hunters Special $1.08 Hold'em No Limit - Level19(1,750/3,500) - 2024/08/05 12:43:13
Table '72' 8-max Seat #2 is the button
Seat 1: 516045fd (30,531 in chips)
Seat 2: 1760a0a7 (171,572 in chips)
Seat 3: 7966ecdb (71,179 in chips)
Seat 4: Hero (258,164 in chips)
Seat 5: 67a6e167 (103,508 in chips)
Seat 6: c50c4803 (311,870 in chips)
Seat 7: f35a242e (87,146 in chips)
Seat 8: c4922e67 (149,250 in chips)
7966ecdb: posts the ante 500
f35a242e: posts the ante 500
516045fd: posts the ante 500
c4922e67: posts the ante 500
1760a0a7: posts the ante 500
c50c4803: posts the ante 500
67a6e167: posts the ante 500
Hero: posts the ante 500
7966ecdb: posts small blind 1,750
Hero: posts big blind 3,500
*** HOLE CARDS ***
Dealt to 516045fd 
Dealt to 1760a0a7 
Dealt to 7966ecdb 
Dealt to Hero [3d Tc]
Dealt to 67a6e167 
Dealt to c50c4803 
Dealt to f35a242e 
Dealt to c4922e67 
67a6e167: folds
c50c4803: folds
f35a242e: folds
c4922e67: folds
516045fd: raises 26,531 to 30,031 and is all-in
1760a0a7: calls 30,031
7966ecdb: folds
Hero: folds
516045fd: shows [2h 2c]
1760a0a7: shows [3s 3h]
*** FLOP *** [Ts 2d 5c]
*** TURN *** [Ts 2d 5c] [Jc]
*** RIVER *** [Ts 2d 5c Jc] [6c]
*** SHOWDOWN ***
516045fd collected 69,312 from pot
*** SUMMARY ***
Total pot 69,312 | Rake 0 | Jackpot 0 | Bingo 0 | Fortune 0 | Tax 0
Board [Ts 2d 5c Jc 6c]
Seat 1: 516045fd showed [2h 2c] and won (69,312) with Three Twos
Seat 2: 1760a0a7 (button) showed [3s 3h] and lost with Pair of Treys
Seat 3: 7966ecdb (small blind) folded before Flop
Seat 4: Hero (big blind) folded before Flop
Seat 5: 67a6e167 folded before Flop
Seat 6: c50c4803 folded before Flop
Seat 7: f35a242e folded before Flop
Seat 8: c4922e67 folded before Flop


Poker Hand #TM3552532230: Tournament #156543396, Bounty Hunters Special $1.08 Hold'em No Limit - Level19(1,750/3,500) - 2024/08/05 12:42:15
Table '72' 8-max Seat #1 is the button
Seat 1: 516045fd (31,031 in chips)
Seat 2: 1760a0a7 (173,822 in chips)
Seat 3: 7966ecdb (88,102 in chips)
Seat 4: Hero (258,664 in chips)
Seat 5: 67a6e167 (104,008 in chips)
Seat 6: c50c4803 (312,370 in chips)
Seat 7: f35a242e (87,646 in chips)
Seat 8: c4922e67 (127,577 in chips)
7966ecdb: posts the ante 500
f35a242e: posts the ante 500
516045fd: posts the ante 500
c4922e67: posts the ante 500
1760a0a7: posts the ante 500
c50c4803: posts the ante 500
67a6e167: posts the ante 500
Hero: posts the ante 500
1760a0a7: posts small blind 1,750
7966ecdb: posts big blind 3,500
*** HOLE CARDS ***
Dealt to 516045fd 
Dealt to 1760a0a7 
Dealt to 7966ecdb 
Dealt to Hero [Td Qs]
Dealt to 67a6e167 
Dealt to c50c4803 
Dealt to f35a242e 
Dealt to c4922e67 
Hero: folds
67a6e167: folds
c50c4803: folds
f35a242e: folds
c4922e67: raises 5,250 to 8,750
516045fd: folds
1760a0a7: folds
7966ecdb: calls 5,250
*** FLOP *** [7s 9c 8d]
7966ecdb: bets 7,673
c4922e67: calls 7,673
*** TURN *** [7s 9c 8d] [5c]
7966ecdb: checks
c4922e67: bets 19,298
7966ecdb: folds
Uncalled bet (19,298) returned to c4922e67
*** SHOWDOWN ***
c4922e67 collected 38,596 from pot
*** SUMMARY ***
Total pot 38,596 | Rake 0 | Jackpot 0 | Bingo 0 | Fortune 0 | Tax 0
Board [7s 9c 8d 5c]
Seat 1: 516045fd (button) folded before Flop
Seat 2: 1760a0a7 (small blind) folded before Flop
Seat 3: 7966ecdb (big blind) folded on the Turn
Seat 4: Hero folded before Flop
Seat 5: 67a6e167 folded before Flop
Seat 6: c50c4803 folded before Flop
Seat 7: f35a242e folded before Flop
Seat 8: c4922e67 won (38,596)


Poker Hand #TM3552532218: Tournament #156543396, Bounty Hunters Special $1.08 Hold'em No Limit - Level19(1,750/3,500) - 2024/08/05 12:41:30
Table '72' 8-max Seat #7 is the button
Seat 1: 516045fd (33,281 in chips)
Seat 2: 1760a0a7 (177,822 in chips)
Seat 3: 7966ecdb (40,176 in chips)
Seat 4: Hero (259,164 in chips)
Seat 5: 67a6e167 (104,508 in chips)
Seat 6: c50c4803 (352,546 in chips)
Seat 7: f35a242e (88,146 in chips)
7966ecdb: posts the ante 500
f35a242e: posts the ante 500
516045fd: posts the ante 500
1760a0a7: posts the ante 500
c50c4803: posts the ante 500
67a6e167: posts the ante 500
Hero: posts the ante 500
516045fd: posts small blind 1,750
1760a0a7: posts big blind 3,500
*** HOLE CARDS ***
Dealt to 516045fd 
Dealt to 1760a0a7 
Dealt to 7966ecdb 
Dealt to Hero [5h 6s]
Dealt to 67a6e167 
Dealt to c50c4803 
Dealt to f35a242e 
7966ecdb: raises 36,176 to 39,676 and is all-in
Hero: folds
67a6e167: folds
c50c4803: raises 312,370 to 352,046 and is all-in
f35a242e: folds
516045fd: folds
1760a0a7: folds
Uncalled bet (312,370) returned to c50c4803
c50c4803: shows [Ac Kc]
7966ecdb: shows [3s As]
*** FLOP *** [3d 7c 5c]
*** TURN *** [3d 7c 5c] [Ts]
*** RIVER *** [3d 7c 5c Ts] [Js]
*** SHOWDOWN ***
7966ecdb collected 88,102 from pot
*** SUMMARY ***
Total pot 88,102 | Rake 0 | Jackpot 0 | Bingo 0 | Fortune 0 | Tax 0
Board [3d 7c 5c Ts Js]
Seat 1: 516045fd (small blind) folded before Flop
Seat 2: 1760a0a7 (big blind) folded before Flop
Seat 3: 7966ecdb showed [3s As] and won (88,102) with Pair of Treys
Seat 4: Hero folded before Flop
Seat 5: 67a6e167 folded before Flop
Seat 6: c50c4803 showed [Ac Kc] and lost with Ace-High
Seat 7: f35a242e (button) folded before Flop


Poker Hand #TM3552532208: Tournament #156543396, Bounty Hunters Special $1.08 Hold'em No Limit - Level19(1,750/3,500) - 2024/08/05 12:40:58
Table '72' 8-max Seat #6 is the button
Seat 1: 516045fd (37,281 in chips)
Seat 2: 1760a0a7 (178,322 in chips)
Seat 3: 7966ecdb (40,676 in chips)
Seat 4: Hero (259,664 in chips)
Seat 5: 67a6e167 (105,008 in chips)
Seat 6: c50c4803 (344,296 in chips)
Seat 7: f35a242e (90,396 in chips)
7966ecdb: posts the ante 500
f35a242e: posts the ante 500
516045fd: posts the ante 500
1760a0a7: posts the ante 500
c50c4803: posts the ante 500
67a6e167: posts the ante 500
Hero: posts the ante 500
f35a242e: posts small blind 1,750
516045fd: posts big blind 3,500
*** HOLE CARDS ***
Dealt to 516045fd 
Dealt to 1760a0a7 
Dealt to 7966ecdb 
Dealt to Hero [5h Ad]
Dealt to 67a6e167 
Dealt to c50c4803 
Dealt to f35a242e 
1760a0a7: folds
7966ecdb: folds
Hero: folds
67a6e167: folds
c50c4803: raises 3,500 to 7,000
f35a242e: folds
516045fd: folds
Uncalled bet (3,500) returned to c50c4803
*** SHOWDOWN ***
c50c4803 collected 12,250 from pot
*** SUMMARY ***
Total pot 12,250 | Rake 0 | Jackpot 0 | Bingo 0 | Fortune 0 | Tax 0
Seat 1: 516045fd (big blind) folded before Flop
Seat 2: 1760a0a7 folded before Flop
Seat 3: 7966ecdb folded before Flop
Seat 4: Hero folded before Flop
Seat 5: 67a6e167 folded before Flop
Seat 6: c50c4803 (button) collected (12,250)
Seat 7: f35a242e (small blind) folded before Flop


Poker Hand #TM3552532192: Tournament #156543396, Bounty Hunters Special $1.08 Hold'em No Limit - Level19(1,750/3,500) - 2024/08/05 12:39:45
Table '72' 8-max Seat #5 is the button
Seat 2: 1760a0a7 (117,782 in chips)
Seat 3: 7966ecdb (41,176 in chips)
Seat 4: Hero (260,164 in chips)
Seat 5: 67a6e167 (149,048 in chips)
Seat 6: c50c4803 (351,796 in chips)
Seat 7: f35a242e (97,896 in chips)
Seat 8: 5b10812e (39,246 in chips)
7966ecdb: posts the ante 500
f35a242e: posts the ante 500
1760a0a7: posts the ante 500
c50c4803: posts the ante 500
67a6e167: posts the ante 500
Hero: posts the ante 500
5b10812e: posts the ante 500
c50c4803: posts small blind 1,750
f35a242e: posts big blind 3,500
*** HOLE CARDS ***
Dealt to 1760a0a7 
Dealt to 7966ecdb 
Dealt to Hero [Kc 2h]
Dealt to 67a6e167 
Dealt to c50c4803 
Dealt to f35a242e 
Dealt to 5b10812e 
5b10812e: folds
1760a0a7: raises 3,500 to 7,000
7966ecdb: folds
Hero: folds
67a6e167: calls 7,000
c50c4803: calls 5,250
f35a242e: calls 3,500
*** FLOP *** [3d 2s 2d]
c50c4803: checks
f35a242e: checks
1760a0a7: bets 10,395
67a6e167: calls 10,395
c50c4803: folds
f35a242e: folds
*** TURN *** [3d 2s 2d] [Ah]
1760a0a7: bets 26,145
67a6e167: calls 26,145
*** RIVER *** [3d 2s 2d Ah] [4h]
1760a0a7: checks
67a6e167: checks
1760a0a7: shows [6c Ad] (Pair of Aces and Pair of Twos)
67a6e167: shows [Kd Jd] (Pair of Twos)
Hero: shows [2h] (Three Twos)
*** SHOWDOWN ***
1760a0a7 collected 104,580 from pot
*** SUMMARY ***
Total pot 104,580 | Rake 0 | Jackpot 0 | Bingo 0 | Fortune 0 | Tax 0
Board [3d 2s 2d Ah 4h]
Seat 2: 1760a0a7 showed [6c Ad] and won (104,580) with Pair of Aces and Pair of Twos
Seat 3: 7966ecdb folded before Flop
Seat 4: Hero folded before Flop
Seat 5: 67a6e167 (button) showed [Kd Jd] and lost with Pair of Twos
Seat 6: c50c4803 (small blind) folded on the Flop
Seat 7: f35a242e (big blind) folded on the Flop
Seat 8: 5b10812e folded before Flop


Poker Hand #TM3552532179: Tournament #156543396, Bounty Hunters Special $1.08 Hold'em No Limit - Level19(1,750/3,500) - 2024/08/05 12:38:52
Table '72' 8-max Seat #4 is the button
Seat 1: 7a771626 (37,565 in chips)
Seat 2: 1760a0a7 (118,282 in chips)
Seat 3: 7966ecdb (41,676 in chips)
Seat 4: Hero (214,349 in chips)
Seat 5: 67a6e167 (151,298 in chips)
Seat 6: c50c4803 (355,796 in chips)
Seat 7: f35a242e (98,396 in chips)
Seat 8: 5b10812e (39,746 in chips)
7966ecdb: posts the ante 500
f35a242e: posts the ante 500
1760a0a7: posts the ante 500
7a771626: posts the ante 500
c50c4803: posts the ante 500
Hero: posts the ante 500
67a6e167: posts the ante 500
5b10812e: posts the ante 500
67a6e167: posts small blind 1,750
c50c4803: posts big blind 3,500
*** HOLE CARDS ***
Dealt to 7a771626 
Dealt to 1760a0a7 
Dealt to 7966ecdb 
Dealt to Hero [Qs Qh]
Dealt to 67a6e167 
Dealt to c50c4803 
Dealt to f35a242e 
Dealt to 5b10812e 
f35a242e: folds
5b10812e: folds
7a771626: calls 3,500
1760a0a7: folds
7966ecdb: folds
Hero: raises 16,250 to 19,750
67a6e167: folds
c50c4803: folds
7a771626: calls 16,250
*** FLOP *** [Kc Jh Qc]
7a771626: checks
Hero: checks
*** TURN *** [Kc Jh Qc] [5c]
7a771626: bets 17,315 and is all-in
Hero: calls 17,315
7a771626: shows [Ah Jc] (Pair of Jacks)
Hero: shows [Qs Qh] (Three Queens)
*** RIVER *** [Kc Jh Qc 5c] [6s]
*** SHOWDOWN ***
Hero collected 83,380 from pot
*** SUMMARY ***
Total pot 83,380 | Rake 0 | Jackpot 0 | Bingo 0 | Fortune 0 | Tax 0
Board [Kc Jh Qc 5c 6s]
Seat 1: 7a771626 showed [Ah Jc] and lost with Pair of Jacks
Seat 2: 1760a0a7 folded before Flop
Seat 3: 7966ecdb folded before Flop
Seat 4: Hero (button) showed [Qs Qh] and won (83,380) with Three Queens
Seat 5: 67a6e167 (small blind) folded before Flop
Seat 6: c50c4803 (big blind) folded before Flop
Seat 7: f35a242e folded before Flop
Seat 8: 5b10812e folded before Flop


Poker Hand #TM3552532164: Tournament #156543396, Bounty Hunters Special $1.08 Hold'em No Limit - Level18(1,500/3,000) - 2024/08/05 12:37:45
Table '72' 8-max Seat #3 is the button
Seat 1: 7a771626 (53,123 in chips)
Seat 2: 1760a0a7 (118,732 in chips)
Seat 3: 7966ecdb (42,126 in chips)
Seat 4: Hero (147,521 in chips)
Seat 5: 67a6e167 (194,318 in chips)
Seat 6: c50c4803 (362,246 in chips)
Seat 7: f35a242e (98,846 in chips)
Seat 8: 5b10812e (40,196 in chips)
7966ecdb: posts the ante 450
f35a242e: posts the ante 450
1760a0a7: posts the ante 450
7a771626: posts the ante 450
c50c4803: posts the ante 450
67a6e167: posts the ante 450
Hero: posts the ante 450
5b10812e: posts the ante 450
Hero: posts small blind 1,500
67a6e167: posts big blind 3,000
*** HOLE CARDS ***
Dealt to 7a771626 
Dealt to 1760a0a7 
Dealt to 7966ecdb 
Dealt to Hero [Ac 6c]
Dealt to 67a6e167 
Dealt to c50c4803 
Dealt to f35a242e 
Dealt to 5b10812e 
c50c4803: raises 3,000 to 6,000
f35a242e: folds
5b10812e: folds
7a771626: calls 6,000
1760a0a7: folds
7966ecdb: folds
Hero: calls 4,500
67a6e167: calls 3,000
*** FLOP *** [6s 3c Tc]
Hero: bets 9,108
67a6e167: calls 9,108
c50c4803: folds
7a771626: calls 9,108
*** TURN *** [6s 3c Tc] [2c]
Hero: checks
67a6e167: bets 27,462
7a771626: folds
Hero: calls 27,462
*** RIVER *** [6s 3c Tc 2c] [Kc]
Hero: bets 104,501 and is all-in
67a6e167: folds
Uncalled bet (104,501) returned to Hero
Hero: shows [Ac] (Ace High Flush)
*** SHOWDOWN ***
Hero collected 109,848 from pot
*** SUMMARY ***
Total pot 109,848 | Rake 0 | Jackpot 0 | Bingo 0 | Fortune 0 | Tax 0
Board [6s 3c Tc 2c Kc]
Seat 1: 7a771626 folded on the Turn
Seat 2: 1760a0a7 folded before Flop
Seat 3: 7966ecdb (button) folded before Flop
Seat 4: Hero (small blind) showed [Ac] and won (109,848)
Seat 5: 67a6e167 (big blind) folded on the River
Seat 6: c50c4803 folded on the Flop
Seat 7: f35a242e folded before Flop
Seat 8: 5b10812e folded before Flop


Poker Hand #TM3552532160: Tournament #156543396, Bounty Hunters Special $1.08 Hold'em No Limit - Level18(1,500/3,000) - 2024/08/05 12:37:28
Table '72' 8-max Seat #2 is the button
Seat 1: 7a771626 (53,573 in chips)
Seat 2: 1760a0a7 (119,182 in chips)
Seat 3: 7966ecdb (44,076 in chips)
Seat 4: Hero (142,871 in chips)
Seat 5: 67a6e167 (194,768 in chips)
Seat 6: c50c4803 (362,696 in chips)
Seat 7: f35a242e (99,296 in chips)
Seat 8: 5b10812e (40,646 in chips)
7966ecdb: posts the ante 450
f35a242e: posts the ante 450
1760a0a7: posts the ante 450
7a771626: posts the ante 450
c50c4803: posts the ante 450
67a6e167: posts the ante 450
Hero: posts the ante 450
5b10812e: posts the ante 450
7966ecdb: posts small blind 1,500
Hero: posts big blind 3,000
*** HOLE CARDS ***
Dealt to 7a771626 
Dealt to 1760a0a7 
Dealt to 7966ecdb 
Dealt to Hero [9d Qs]
Dealt to 67a6e167 
Dealt to c50c4803 
Dealt to f35a242e 
Dealt to 5b10812e 
67a6e167: folds
c50c4803: folds
f35a242e: folds
5b10812e: folds
7a771626: folds
1760a0a7: folds
7966ecdb: folds
Uncalled bet (1,500) returned to Hero
*** SHOWDOWN ***
Hero collected 6,600 from pot
*** SUMMARY ***
Total pot 6,600 | Rake 0 | Jackpot 0 | Bingo 0 | Fortune 0 | Tax 0
Seat 1: 7a771626 folded before Flop
Seat 2: 1760a0a7 (button) folded before Flop
Seat 3: 7966ecdb (small blind) folded before Flop
Seat 4: Hero (big blind) collected (6,600)
Seat 5: 67a6e167 folded before Flop
Seat 6: c50c4803 folded before Flop
Seat 7: f35a242e folded before Flop
Seat 8: 5b10812e folded before Flop


Poker Hand #TM3552532144: Tournament #156543396, Bounty Hunters Special $1.08 Hold'em No Limit - Level18(1,500/3,000) - 2024/08/05 12:36:29
Table '72' 8-max Seat #1 is the button
Seat 1: 7a771626 (54,023 in chips)
Seat 2: 1760a0a7 (110,032 in chips)
Seat 3: 7966ecdb (47,526 in chips)
Seat 4: Hero (143,321 in chips)
Seat 5: 67a6e167 (195,218 in chips)
Seat 6: c50c4803 (363,146 in chips)
Seat 7: f35a242e (99,746 in chips)
Seat 8: 5b10812e (44,096 in chips)
7966ecdb: posts the ante 450
f35a242e: posts the ante 450
7a771626: posts the ante 450
1760a0a7: posts the ante 450
c50c4803: posts the ante 450
67a6e167: posts the ante 450
Hero: posts the ante 450
5b10812e: posts the ante 450
1760a0a7: posts small blind 1,500
7966ecdb: posts big blind 3,000
*** HOLE CARDS ***
Dealt to 7a771626 
Dealt to 1760a0a7 
Dealt to 7966ecdb 
Dealt to Hero [Ac 8h]
Dealt to 67a6e167 
Dealt to c50c4803 
Dealt to f35a242e 
Dealt to 5b10812e 
Hero: folds
67a6e167: folds
c50c4803: folds
f35a242e: folds
5b10812e: calls 3,000
7a771626: folds
1760a0a7: raises 106,582 to 109,582 and is all-in
7966ecdb: folds
5b10812e: folds
Uncalled bet (106,582) returned to 1760a0a7
*** SHOWDOWN ***
1760a0a7 collected 12,600 from pot
*** SUMMARY ***
Total pot 12,600 | Rake 0 | Jackpot 0 | Bingo 0 | Fortune 0 | Tax 0
Seat 1: 7a771626 (button) folded before Flop
Seat 2: 1760a0a7 (small blind) collected (12,600)
Seat 3: 7966ecdb (big blind) folded before Flop
Seat 4: Hero folded before Flop
Seat 5: 67a6e167 folded before Flop
Seat 6: c50c4803 folded before Flop
Seat 7: f35a242e folded before Flop
Seat 8: 5b10812e folded before Flop


Poker Hand #TM3552532129: Tournament #156543396, Bounty Hunters Special $1.08 Hold'em No Limit - Level18(1,500/3,000) - 2024/08/05 12:35:30
Table '72' 8-max Seat #8 is the button
Seat 1: 7a771626 (55,973 in chips)
Seat 2: 1760a0a7 (93,382 in chips)
Seat 3: 7966ecdb (47,976 in chips)
Seat 4: Hero (143,771 in chips)
Seat 5: 67a6e167 (195,668 in chips)
Seat 6: c50c4803 (375,596 in chips)
Seat 7: f35a242e (100,196 in chips)
Seat 8: 5b10812e (44,546 in chips)
7966ecdb: posts the ante 450
f35a242e: posts the ante 450
1760a0a7: posts the ante 450
7a771626: posts the ante 450
c50c4803: posts the ante 450
67a6e167: posts the ante 450
Hero: posts the ante 450
5b10812e: posts the ante 450
7a771626: posts small blind 1,500
1760a0a7: posts big blind 3,000
*** HOLE CARDS ***
Dealt to 7a771626 
Dealt to 1760a0a7 
Dealt to 7966ecdb 
Dealt to Hero [2c 7c]
Dealt to 67a6e167 
Dealt to c50c4803 
Dealt to f35a242e 
Dealt to 5b10812e 
7966ecdb: folds
Hero: folds
67a6e167: folds
c50c4803: raises 3,000 to 6,000
f35a242e: folds
5b10812e: folds
7a771626: folds
1760a0a7: calls 3,000
*** FLOP *** [Js Kh 5h]
1760a0a7: checks
c50c4803: checks
*** TURN *** [Js Kh 5h] [As]
1760a0a7: checks
c50c4803: checks
*** RIVER *** [Js Kh 5h As] [4c]
1760a0a7: checks
c50c4803: bets 6,000
1760a0a7: calls 6,000
c50c4803: shows [9h 9d] (Pair of Nines)
1760a0a7: shows [Jd 7d] (Pair of Jacks)
*** SHOWDOWN ***
1760a0a7 collected 29,100 from pot
*** SUMMARY ***
Total pot 29,100 | Rake 0 | Jackpot 0 | Bingo 0 | Fortune 0 | Tax 0
Board [Js Kh 5h As 4c]
Seat 1: 7a771626 (small blind) folded before Flop
Seat 2: 1760a0a7 (big blind) showed [Jd 7d] and won (29,100) with Pair of Jacks
Seat 3: 7966ecdb folded before Flop
Seat 4: Hero folded before Flop
Seat 5: 67a6e167 folded before Flop
Seat 6: c50c4803 showed [9h 9d] and lost with Pair of Nines
Seat 7: f35a242e folded before Flop
Seat 8: 5b10812e (button) folded before Flop


Poker Hand #TM3552532121: Tournament #156543396, Bounty Hunters Special $1.08 Hold'em No Limit - Level18(1,500/3,000) - 2024/08/05 12:34:49
Table '72' 8-max Seat #7 is the button
Seat 1: 7a771626 (59,423 in chips)
Seat 3: 7966ecdb (48,426 in chips)
Seat 4: Hero (144,221 in chips)
Seat 5: 67a6e167 (196,118 in chips)
Seat 6: c50c4803 (376,046 in chips)
Seat 7: f35a242e (92,996 in chips)
Seat 8: 5b10812e (46,496 in chips)
7966ecdb: posts the ante 450
f35a242e: posts the ante 450
7a771626: posts the ante 450
c50c4803: posts the ante 450
67a6e167: posts the ante 450
Hero: posts the ante 450
5b10812e: posts the ante 450
5b10812e: posts small blind 1,500
7a771626: posts big blind 3,000
*** HOLE CARDS ***
Dealt to 7a771626 
Dealt to 7966ecdb 
Dealt to Hero [7c 5c]
Dealt to 67a6e167 
Dealt to c50c4803 
Dealt to f35a242e 
Dealt to 5b10812e 
7966ecdb: folds
Hero: folds
67a6e167: folds
c50c4803: folds
f35a242e: raises 3,000 to 6,000
5b10812e: folds
7a771626: folds
Uncalled bet (3,000) returned to f35a242e
*** SHOWDOWN ***
f35a242e collected 10,650 from pot
*** SUMMARY ***
Total pot 10,650 | Rake 0 | Jackpot 0 | Bingo 0 | Fortune 0 | Tax 0
Seat 1: 7a771626 (big blind) folded before Flop
Seat 3: 7966ecdb folded before Flop
Seat 4: Hero folded before Flop
Seat 5: 67a6e167 folded before Flop
Seat 6: c50c4803 folded before Flop
Seat 7: f35a242e (button) collected (10,650)
Seat 8: 5b10812e (small blind) folded before Flop


Poker Hand #TM3552532098: Tournament #156543396, Bounty Hunters Special $1.08 Hold'em No Limit - Level18(1,500/3,000) - 2024/08/05 12:33:16
Table '72' 8-max Seat #6 is the button
Seat 1: 7a771626 (59,873 in chips)
Seat 2: e94cdfd9 (86,650 in chips)
Seat 3: 7966ecdb (48,876 in chips)
Seat 4: Hero (144,671 in chips)
Seat 5: 67a6e167 (196,568 in chips)
Seat 6: c50c4803 (278,996 in chips)
Seat 7: f35a242e (94,946 in chips)
Seat 8: 5b10812e (53,146 in chips)
7966ecdb: posts the ante 450
f35a242e: posts the ante 450
e94cdfd9: posts the ante 450
7a771626: posts the ante 450
c50c4803: posts the ante 450
67a6e167: posts the ante 450
Hero: posts the ante 450
5b10812e: posts the ante 450
f35a242e: posts small blind 1,500
5b10812e: posts big blind 3,000
*** HOLE CARDS ***
Dealt to 7a771626 
Dealt to e94cdfd9 
Dealt to 7966ecdb 
Dealt to Hero [7c Jc]
Dealt to 67a6e167 
Dealt to c50c4803 
Dealt to f35a242e 
Dealt to 5b10812e 
7a771626: folds
e94cdfd9: raises 3,200 to 6,200
7966ecdb: folds
Hero: folds
67a6e167: folds
c50c4803: calls 6,200
f35a242e: folds
5b10812e: calls 3,200
*** FLOP *** [6c 2h 6s]
5b10812e: checks
e94cdfd9: bets 7,821
c50c4803: calls 7,821
5b10812e: folds
*** TURN *** [6c 2h 6s] [Ts]
e94cdfd9: bets 12,983
c50c4803: raises 12,983 to 25,966
e94cdfd9: calls 12,983
*** RIVER *** [6c 2h 6s Ts] [2s]
e94cdfd9: checks
c50c4803: bets 48,000
e94cdfd9: calls 46,213 and is all-in
Uncalled bet (1,787) returned to c50c4803
c50c4803: shows [Ad Ac] (Pair of Aces and Pair of Sixes)
e94cdfd9: shows [3h 3s] (Pair of Sixes and Pair of Treys)
*** SHOWDOWN ***
c50c4803 collected 183,700 from pot
*** SUMMARY ***
Total pot 183,700 | Rake 0 | Jackpot 0 | Bingo 0 | Fortune 0 | Tax 0
Board [6c 2h 6s Ts 2s]
Seat 1: 7a771626 folded before Flop
Seat 2: e94cdfd9 showed [3h 3s] and lost with Pair of Sixes and Pair of Treys
Seat 3: 7966ecdb folded before Flop
Seat 4: Hero folded before Flop
Seat 5: 67a6e167 folded before Flop
Seat 6: c50c4803 (button) showed [Ad Ac] and won (183,700) with Pair of Aces and Pair of Sixes
Seat 7: f35a242e (small blind) folded before Flop
Seat 8: 5b10812e (big blind) folded on the Flop


Poker Hand #TM3552532084: Tournament #156543396, Bounty Hunters Special $1.08 Hold'em No Limit - Level18(1,500/3,000) - 2024/08/05 12:32:26
Table '72' 8-max Seat #5 is the button
Seat 1: 7a771626 (60,323 in chips)
Seat 2: e94cdfd9 (87,100 in chips)
Seat 3: 7966ecdb (49,326 in chips)
Seat 4: Hero (145,121 in chips)
Seat 5: 67a6e167 (207,518 in chips)
Seat 6: c50c4803 (262,346 in chips)
Seat 7: f35a242e (98,396 in chips)
Seat 8: 5b10812e (53,596 in chips)
7966ecdb: posts the ante 450
f35a242e: posts the ante 450
e94cdfd9: posts the ante 450
7a771626: posts the ante 450
c50c4803: posts the ante 450
67a6e167: posts the ante 450
Hero: posts the ante 450
5b10812e: posts the ante 450
c50c4803: posts small blind 1,500
f35a242e: posts big blind 3,000
*** HOLE CARDS ***
Dealt to 7a771626 
Dealt to e94cdfd9 
Dealt to 7966ecdb 
Dealt to Hero [Kc 2h]
Dealt to 67a6e167 
Dealt to c50c4803 
Dealt to f35a242e 
Dealt to 5b10812e 
5b10812e: folds
7a771626: folds
e94cdfd9: folds
7966ecdb: folds
Hero: folds
67a6e167: calls 3,000
c50c4803: calls 1,500
f35a242e: checks
*** FLOP *** [Jh 8d 7c]
c50c4803: checks
f35a242e: checks
67a6e167: checks
*** TURN *** [Jh 8d 7c] [Qc]
c50c4803: bets 7,500
f35a242e: folds
67a6e167: calls 7,500
*** RIVER *** [Jh 8d 7c Qc] [5c]
c50c4803: bets 10,500
67a6e167: folds
Uncalled bet (10,500) returned to c50c4803
*** SHOWDOWN ***
c50c4803 collected 27,600 from pot
*** SUMMARY ***
Total pot 27,600 | Rake 0 | Jackpot 0 | Bingo 0 | Fortune 0 | Tax 0
Board [Jh 8d 7c Qc 5c]
Seat 1: 7a771626 folded before Flop
Seat 2: e94cdfd9 folded before Flop
Seat 3: 7966ecdb folded before Flop
Seat 4: Hero folded before Flop
Seat 5: 67a6e167 (button) folded on the River
Seat 6: c50c4803 (small blind) won (27,600)
Seat 7: f35a242e (big blind) folded on the Turn
Seat 8: 5b10812e folded before Flop


Poker Hand #TM3552532079: Tournament #156543396, Bounty Hunters Special $1.08 Hold'em No Limit - Level18(1,500/3,000) - 2024/08/05 12:32:08
Table '72' 8-max Seat #4 is the button
Seat 1: 7a771626 (60,773 in chips)
Seat 2: e94cdfd9 (87,550 in chips)
Seat 3: 7966ecdb (49,776 in chips)
Seat 4: Hero (145,571 in chips)
Seat 5: 67a6e167 (209,468 in chips)
Seat 6: c50c4803 (257,696 in chips)
Seat 7: f35a242e (98,846 in chips)
Seat 8: 5b10812e (54,046 in chips)
7966ecdb: posts the ante 450
f35a242e: posts the ante 450
e94cdfd9: posts the ante 450
7a771626: posts the ante 450
c50c4803: posts the ante 450
Hero: posts the ante 450
67a6e167: posts the ante 450
5b10812e: posts the ante 450
67a6e167: posts small blind 1,500
c50c4803: posts big blind 3,000
*** HOLE CARDS ***
Dealt to 7a771626 
Dealt to e94cdfd9 
Dealt to 7966ecdb 
Dealt to Hero [Qs 7c]
Dealt to 67a6e167 
Dealt to c50c4803 
Dealt to f35a242e 
Dealt to 5b10812e 
f35a242e: folds
5b10812e: folds
7a771626: folds
e94cdfd9: folds
7966ecdb: folds
Hero: folds
67a6e167: folds
Uncalled bet (1,500) returned to c50c4803
*** SHOWDOWN ***
c50c4803 collected 6,600 from pot
*** SUMMARY ***
Total pot 6,600 | Rake 0 | Jackpot 0 | Bingo 0 | Fortune 0 | Tax 0
Seat 1: 7a771626 folded before Flop
Seat 2: e94cdfd9 folded before Flop
Seat 3: 7966ecdb folded before Flop
Seat 4: Hero (button) folded before Flop
Seat 5: 67a6e167 (small blind) folded before Flop
Seat 6: c50c4803 (big blind) collected (6,600)
Seat 7: f35a242e folded before Flop
Seat 8: 5b10812e folded before Flop


Poker Hand #TM3552532066: Tournament #156543396, Bounty Hunters Special $1.08 Hold'em No Limit - Level18(1,500/3,000) - 2024/08/05 12:31:18
Table '72' 8-max Seat #3 is the button
Seat 1: 7a771626 (61,223 in chips)
Seat 2: e94cdfd9 (94,000 in chips)
Seat 3: 7966ecdb (50,226 in chips)
Seat 4: Hero (147,521 in chips)
Seat 5: 67a6e167 (186,818 in chips)
Seat 6: c50c4803 (258,146 in chips)
Seat 7: f35a242e (105,296 in chips)
Seat 8: 5b10812e (60,496 in chips)
7966ecdb: posts the ante 450
f35a242e: posts the ante 450
e94cdfd9: posts the ante 450
7a771626: posts the ante 450
c50c4803: posts the ante 450
67a6e167: posts the ante 450
Hero: posts the ante 450
5b10812e: posts the ante 450
Hero: posts small blind 1,500
67a6e167: posts big blind 3,000
*** HOLE CARDS ***
Dealt to 7a771626 
Dealt to e94cdfd9 
Dealt to 7966ecdb 
Dealt to Hero [6h 3d]
Dealt to 67a6e167 
Dealt to c50c4803 
Dealt to f35a242e 
Dealt to 5b10812e 
c50c4803: folds
f35a242e: raises 3,000 to 6,000
5b10812e: calls 6,000
7a771626: folds
e94cdfd9: calls 6,000
7966ecdb: folds
Hero: folds
67a6e167: calls 3,000
*** FLOP *** [4d 9s 5s]
67a6e167: bets 7,275
f35a242e: folds
5b10812e: folds
e94cdfd9: folds
Uncalled bet (7,275) returned to 67a6e167
*** SHOWDOWN ***
67a6e167 collected 29,100 from pot
*** SUMMARY ***
Total pot 29,100 | Rake 0 | Jackpot 0 | Bingo 0 | Fortune 0 | Tax 0
Board [4d 9s 5s]
Seat 1: 7a771626 folded before Flop
Seat 2: e94cdfd9 folded on the Flop
Seat 3: 7966ecdb (button) folded before Flop
Seat 4: Hero (small blind) folded before Flop
Seat 5: 67a6e167 (big blind) won (29,100)
Seat 6: c50c4803 folded before Flop
Seat 7: f35a242e folded on the Flop
Seat 8: 5b10812e folded on the Flop


Poker Hand #TM3552532045: Tournament #156543396, Bounty Hunters Special $1.08 Hold'em No Limit - Level17(1,250/2,500) - 2024/08/05 12:30:21
Table '72' 8-max Seat #2 is the button
Seat 1: 7a771626 (61,573 in chips)
Seat 2: e94cdfd9 (94,350 in chips)
Seat 3: 7966ecdb (55,650 in chips)
Seat 4: Hero (139,997 in chips)
Seat 5: 67a6e167 (187,168 in chips)
Seat 6: c50c4803 (258,496 in chips)
Seat 7: f35a242e (105,646 in chips)
Seat 8: 5b10812e (60,846 in chips)
7966ecdb: posts the ante 350
f35a242e: posts the ante 350
e94cdfd9: posts the ante 350
7a771626: posts the ante 350
c50c4803: posts the ante 350
67a6e167: posts the ante 350
Hero: posts the ante 350
5b10812e: posts the ante 350
7966ecdb: posts small blind 1,250
Hero: posts big blind 2,500
*** HOLE CARDS ***
Dealt to 7a771626 
Dealt to e94cdfd9 
Dealt to 7966ecdb 
Dealt to Hero [5s 7h]
Dealt to 67a6e167 
Dealt to c50c4803 
Dealt to f35a242e 
Dealt to 5b10812e 
67a6e167: folds
c50c4803: folds
f35a242e: folds
5b10812e: folds
7a771626: folds
e94cdfd9: folds
7966ecdb: calls 1,250
Hero: checks
*** FLOP *** [5d Qs 4h]
7966ecdb: bets 2,574
Hero: raises 6,474 to 9,048
7966ecdb: folds
Uncalled bet (6,474) returned to Hero
*** SHOWDOWN ***
Hero collected 12,948 from pot
*** SUMMARY ***
Total pot 12,948 | Rake 0 | Jackpot 0 | Bingo 0 | Fortune 0 | Tax 0
Board [5d Qs 4h]
Seat 1: 7a771626 folded before Flop
Seat 2: e94cdfd9 (button) folded before Flop
Seat 3: 7966ecdb (small blind) folded on the Flop
Seat 4: Hero (big blind) won (12,948)
Seat 5: 67a6e167 folded before Flop
Seat 6: c50c4803 folded before Flop
Seat 7: f35a242e folded before Flop
Seat 8: 5b10812e folded before Flop


Poker Hand #TM3552532035: Tournament #156543396, Bounty Hunters Special $1.08 Hold'em No Limit - Level17(1,250/2,500) - 2024/08/05 12:29:51
Table '72' 8-max Seat #1 is the button
Seat 1: 7a771626 (61,923 in chips)
Seat 2: e94cdfd9 (95,950 in chips)
Seat 3: 7966ecdb (52,300 in chips)
Seat 4: Hero (140,347 in chips)
Seat 5: 67a6e167 (187,518 in chips)
Seat 7: f35a242e (105,996 in chips)
Seat 8: 5b10812e (61,196 in chips)
7966ecdb: posts the ante 350
f35a242e: posts the ante 350
e94cdfd9: posts the ante 350
7a771626: posts the ante 350
67a6e167: posts the ante 350
Hero: posts the ante 350
5b10812e: posts the ante 350
e94cdfd9: posts small blind 1,250
7966ecdb: posts big blind 2,500
*** HOLE CARDS ***
Dealt to 7a771626 
Dealt to e94cdfd9 
Dealt to 7966ecdb 
Dealt to Hero [3c Qh]
Dealt to 67a6e167 
Dealt to f35a242e 
Dealt to 5b10812e 
Hero: folds
67a6e167: folds
f35a242e: folds
5b10812e: folds
7a771626: folds
e94cdfd9: folds
Uncalled bet (1,250) returned to 7966ecdb
*** SHOWDOWN ***
7966ecdb collected 4,950 from pot
*** SUMMARY ***
Total pot 4,950 | Rake 0 | Jackpot 0 | Bingo 0 | Fortune 0 | Tax 0
Seat 1: 7a771626 (button) folded before Flop
Seat 2: e94cdfd9 (small blind) folded before Flop
Seat 3: 7966ecdb (big blind) collected (4,950)
Seat 4: Hero folded before Flop
Seat 5: 67a6e167 folded before Flop
Seat 7: f35a242e folded before Flop
Seat 8: 5b10812e folded before Flop


Poker Hand #TM3552532024: Tournament #156543396, Bounty Hunters Special $1.08 Hold'em No Limit - Level17(1,250/2,500) - 2024/08/05 12:29:04
Table '72' 8-max Seat #8 is the button
Seat 1: 7a771626 (63,523 in chips)
Seat 2: e94cdfd9 (98,800 in chips)
Seat 3: 7966ecdb (23,400 in chips)
Seat 4: Hero (140,697 in chips)
Seat 5: 67a6e167 (187,868 in chips)
Seat 7: f35a242e (129,396 in chips)
Seat 8: 5b10812e (61,546 in chips)
7966ecdb: posts the ante 350
f35a242e: posts the ante 350
e94cdfd9: posts the ante 350
7a771626: posts the ante 350
67a6e167: posts the ante 350
Hero: posts the ante 350
5b10812e: posts the ante 350
7a771626: posts small blind 1,250
e94cdfd9: posts big blind 2,500
*** HOLE CARDS ***
Dealt to 7a771626 
Dealt to e94cdfd9 
Dealt to 7966ecdb 
Dealt to Hero [Jh 2h]
Dealt to 67a6e167 
Dealt to f35a242e 
Dealt to 5b10812e 
7966ecdb: raises 2,500 to 5,000
Hero: folds
67a6e167: folds
f35a242e: calls 5,000
5b10812e: folds
7a771626: folds
e94cdfd9: folds
*** FLOP *** [Qc 7s 8c]
7966ecdb: bets 18,050 and is all-in
f35a242e: calls 18,050
7966ecdb: shows [7c As] (Pair of Sevens)
f35a242e: shows [Ad 5d] (Ace-High)
*** TURN *** [Qc 7s 8c] [3c]
*** RIVER *** [Qc 7s 8c 3c] [3h]
*** SHOWDOWN ***
7966ecdb collected 52,300 from pot
*** SUMMARY ***
Total pot 52,300 | Rake 0 | Jackpot 0 | Bingo 0 | Fortune 0 | Tax 0
Board [Qc 7s 8c 3c 3h]
Seat 1: 7a771626 (small blind) folded before Flop
Seat 2: e94cdfd9 (big blind) folded before Flop
Seat 3: 7966ecdb showed [7c As] and won (52,300) with Pair of Sevens and Pair of Treys
Seat 4: Hero folded before Flop
Seat 5: 67a6e167 folded before Flop
Seat 7: f35a242e showed [Ad 5d] and lost with Pair of Treys
Seat 8: 5b10812e (button) folded before Flop


Poker Hand #TM3552532012: Tournament #156543396, Bounty Hunters Special $1.08 Hold'em No Limit - Level17(1,250/2,500) - 2024/08/05 12:28:24
Table '72' 8-max Seat #7 is the button
Seat 1: 7a771626 (66,373 in chips)
Seat 2: e94cdfd9 (92,950 in chips)
Seat 3: 7966ecdb (23,750 in chips)
Seat 4: Hero (141,047 in chips)
Seat 5: 67a6e167 (188,218 in chips)
Seat 7: f35a242e (129,746 in chips)
Seat 8: 5b10812e (63,146 in chips)
7966ecdb: posts the ante 350
f35a242e: posts the ante 350
e94cdfd9: posts the ante 350
7a771626: posts the ante 350
67a6e167: posts the ante 350
Hero: posts the ante 350
5b10812e: posts the ante 350
5b10812e: posts small blind 1,250
7a771626: posts big blind 2,500
*** HOLE CARDS ***
Dealt to 7a771626 
Dealt to e94cdfd9 
Dealt to 7966ecdb 
Dealt to Hero [Qd 5c]
Dealt to 67a6e167 
Dealt to f35a242e 
Dealt to 5b10812e 
e94cdfd9: raises 4,100 to 6,600
7966ecdb: folds
Hero: folds
67a6e167: folds
f35a242e: folds
5b10812e: folds
7a771626: folds
Uncalled bet (4,100) returned to e94cdfd9
*** SHOWDOWN ***
e94cdfd9 collected 8,700 from pot
*** SUMMARY ***
Total pot 8,700 | Rake 0 | Jackpot 0 | Bingo 0 | Fortune 0 | Tax 0
Seat 1: 7a771626 (big blind) folded before Flop
Seat 2: e94cdfd9 collected (8,700)
Seat 3: 7966ecdb folded before Flop
Seat 4: Hero folded before Flop
Seat 5: 67a6e167 folded before Flop
Seat 7: f35a242e (button) folded before Flop
Seat 8: 5b10812e (small blind) folded before Flop


Poker Hand #TM3552532002: Tournament #156543396, Bounty Hunters Special $1.08 Hold'em No Limit - Level17(1,250/2,500) - 2024/08/05 12:27:31
Table '72' 8-max Seat #5 is the button
Seat 1: 7a771626 (66,723 in chips)
Seat 2: e94cdfd9 (93,300 in chips)
Seat 3: 7966ecdb (24,100 in chips)
Seat 4: Hero (141,397 in chips)
Seat 5: 67a6e167 (188,568 in chips)
Seat 6: d8ba7db5 (37,140 in chips)
Seat 7: f35a242e (90,506 in chips)
Seat 8: 5b10812e (63,496 in chips)
7966ecdb: posts the ante 350
d8ba7db5: posts the ante 350
f35a242e: posts the ante 350
e94cdfd9: posts the ante 350
7a771626: posts the ante 350
67a6e167: posts the ante 350
Hero: posts the ante 350
5b10812e: posts the ante 350
d8ba7db5: posts small blind 1,250
f35a242e: posts big blind 2,500
*** HOLE CARDS ***
Dealt to 7a771626 
Dealt to e94cdfd9 
Dealt to 7966ecdb 
Dealt to Hero [6c As]
Dealt to 67a6e167 
Dealt to d8ba7db5 
Dealt to f35a242e 
Dealt to 5b10812e 
5b10812e: folds
7a771626: folds
e94cdfd9: folds
7966ecdb: folds
Hero: folds
67a6e167: folds
d8ba7db5: calls 1,250
f35a242e: raises 7,500 to 10,000
d8ba7db5: calls 7,500
*** FLOP *** [4s Ts Ks]
d8ba7db5: bets 26,790 and is all-in
f35a242e: calls 26,790
d8ba7db5: shows [Td 8d] (Pair of Tens)
f35a242e: shows [Kc Ac] (Pair of Kings)
*** TURN *** [4s Ts Ks] [Jd]
*** RIVER *** [4s Ts Ks Jd] [9d]
*** SHOWDOWN ***
f35a242e collected 76,380 from pot
*** SUMMARY ***
Total pot 76,380 | Rake 0 | Jackpot 0 | Bingo 0 | Fortune 0 | Tax 0
Board [4s Ts Ks Jd 9d]
Seat 1: 7a771626 folded before Flop
Seat 2: e94cdfd9 folded before Flop
Seat 3: 7966ecdb folded before Flop
Seat 4: Hero folded before Flop
Seat 5: 67a6e167 (button) folded before Flop
Seat 6: d8ba7db5 (small blind) showed [Td 8d] and lost with Pair of Tens
Seat 7: f35a242e (big blind) showed [Kc Ac] and won (76,380) with Pair of Kings
Seat 8: 5b10812e folded before Flop


Poker Hand #TM3552531980: Tournament #156543396, Bounty Hunters Special $1.08 Hold'em No Limit - Level17(1,250/2,500) - 2024/08/05 12:26:22
Table '72' 8-max Seat #4 is the button
Seat 1: 7a771626 (67,073 in chips)
Seat 2: e94cdfd9 (93,650 in chips)
Seat 3: 7966ecdb (24,450 in chips)
Seat 4: Hero (184,525 in chips)
Seat 5: 67a6e167 (190,168 in chips)
Seat 6: d8ba7db5 (11,380 in chips)
Seat 7: f35a242e (90,856 in chips)
Seat 8: 5b10812e (43,128 in chips)
7966ecdb: posts the ante 350
d8ba7db5: posts the ante 350
f35a242e: posts the ante 350
e94cdfd9: posts the ante 350
7a771626: posts the ante 350
Hero: posts the ante 350
67a6e167: posts the ante 350
5b10812e: posts the ante 350
67a6e167: posts small blind 1,250
d8ba7db5: posts big blind 2,500
*** HOLE CARDS ***
Dealt to 7a771626 
Dealt to e94cdfd9 
Dealt to 7966ecdb 
Dealt to Hero [8s Kd]
Dealt to 67a6e167 
Dealt to d8ba7db5 
Dealt to f35a242e 
Dealt to 5b10812e 
f35a242e: folds
5b10812e: raises 2,500 to 5,000
7a771626: folds
e94cdfd9: folds
7966ecdb: folds
Hero: raises 2,500 to 7,500
67a6e167: folds
d8ba7db5: raises 3,530 to 11,030 and is all-in
5b10812e: calls 6,030
Hero: calls 3,530
*** FLOP *** [5s Ac 5c]
5b10812e: checks
Hero: checks
*** TURN *** [5s Ac 5c] [8d]
5b10812e: bets 31,748 and is all-in
Hero: calls 31,748
5b10812e: shows [Tc Ad] (Pair of Aces and Pair of Fives)
Hero: shows [8s Kd] (Pair of Eights and Pair of Fives)
d8ba7db5: shows [Kh 5h] (Three Fives)
*** RIVER *** [5s Ac 5c 8d] [6c]
*** SHOWDOWN ***
d8ba7db5 collected 37,140 from pot
5b10812e collected 63,496 from pot
*** SUMMARY ***
Total pot 100,636 | Rake 0 | Jackpot 0 | Bingo 0 | Fortune 0 | Tax 0
Board [5s Ac 5c 8d 6c]
Seat 1: 7a771626 folded before Flop
Seat 2: e94cdfd9 folded before Flop
Seat 3: 7966ecdb folded before Flop
Seat 4: Hero (button) showed [8s Kd] and lost with Pair of Eights and Pair of Fives
Seat 5: 67a6e167 (small blind) folded before Flop
Seat 6: d8ba7db5 (big blind) showed [Kh 5h] and won (37,140) with Three Fives
Seat 7: f35a242e folded before Flop
Seat 8: 5b10812e showed [Tc Ad] and won (63,496) with Pair of Aces and Pair of Fives


Poker Hand #TM3552531969: Tournament #156543396, Bounty Hunters Special $1.08 Hold'em No Limit - Level17(1,250/2,500) - 2024/08/05 12:25:37
Table '72' 8-max Seat #3 is the button
Seat 1: 7a771626 (67,423 in chips)
Seat 2: e94cdfd9 (94,000 in chips)
Seat 3: 7966ecdb (24,800 in chips)
Seat 4: Hero (151,325 in chips)
Seat 5: 67a6e167 (193,018 in chips)
Seat 6: d8ba7db5 (39,980 in chips)
Seat 7: f35a242e (91,206 in chips)
Seat 8: 5b10812e (43,478 in chips)
7966ecdb: posts the ante 350
d8ba7db5: posts the ante 350
f35a242e: posts the ante 350
e94cdfd9: posts the ante 350
7a771626: posts the ante 350
67a6e167: posts the ante 350
Hero: posts the ante 350
5b10812e: posts the ante 350
Hero: posts small blind 1,250
67a6e167: posts big blind 2,500
*** HOLE CARDS ***
Dealt to 7a771626 
Dealt to e94cdfd9 
Dealt to 7966ecdb 
Dealt to Hero [Qc 9h]
Dealt to 67a6e167 
Dealt to d8ba7db5 
Dealt to f35a242e 
Dealt to 5b10812e 
d8ba7db5: calls 2,500
f35a242e: folds
5b10812e: folds
7a771626: folds
e94cdfd9: folds
7966ecdb: folds
Hero: calls 1,250
67a6e167: checks
*** FLOP *** [5s 6s 9d]
Hero: bets 10,300
67a6e167: folds
d8ba7db5: calls 10,300
*** TURN *** [5s 6s 9d] [Jc]
Hero: bets 15,450
d8ba7db5: calls 15,450
*** RIVER *** [5s 6s 9d Jc] [8s]
Hero: checks
d8ba7db5: checks
Hero: shows [Qc 9h] (Pair of Nines)
d8ba7db5: shows [Kh 6h] (Pair of Sixes)
*** SHOWDOWN ***
Hero collected 61,800 from pot
*** SUMMARY ***
Total pot 61,800 | Rake 0 | Jackpot 0 | Bingo 0 | Fortune 0 | Tax 0
Board [5s 6s 9d Jc 8s]
Seat 1: 7a771626 folded before Flop
Seat 2: e94cdfd9 folded before Flop
Seat 3: 7966ecdb (button) folded before Flop
Seat 4: Hero (small blind) showed [Qc 9h] and won (61,800) with Pair of Nines
Seat 5: 67a6e167 (big blind) folded on the Flop
Seat 6: d8ba7db5 showed [Kh 6h] and lost with Pair of Sixes
Seat 7: f35a242e folded before Flop
Seat 8: 5b10812e folded before Flop


Poker Hand #TM3552531950: Tournament #156543396, Bounty Hunters Special $1.08 Hold'em No Limit - Level17(1,250/2,500) - 2024/08/05 12:24:33
Table '72' 8-max Seat #2 is the button
Seat 1: 7a771626 (67,773 in chips)
Seat 2: e94cdfd9 (100,168 in chips)
Seat 3: 7966ecdb (26,400 in chips)
Seat 4: Hero (141,807 in chips)
Seat 5: 67a6e167 (193,368 in chips)
Seat 6: d8ba7db5 (40,330 in chips)
Seat 7: f35a242e (91,556 in chips)
Seat 8: 5b10812e (43,828 in chips)
d8ba7db5: posts the ante 350
7966ecdb: posts the ante 350
f35a242e: posts the ante 350
e94cdfd9: posts the ante 350
7a771626: posts the ante 350
67a6e167: posts the ante 350
Hero: posts the ante 350
5b10812e: posts the ante 350
7966ecdb: posts small blind 1,250
Hero: posts big blind 2,500
*** HOLE CARDS ***
Dealt to 7a771626 
Dealt to e94cdfd9 
Dealt to 7966ecdb 
Dealt to Hero [Ah 2h]
Dealt to 67a6e167 
Dealt to d8ba7db5 
Dealt to f35a242e 
Dealt to 5b10812e 
67a6e167: folds
d8ba7db5: folds
f35a242e: folds
5b10812e: folds
7a771626: folds
e94cdfd9: raises 3,318 to 5,818
7966ecdb: folds
Hero: calls 3,318
*** FLOP *** [Qc 2s 9d]
Hero: checks
e94cdfd9: checks
*** TURN *** [Qc 2s 9d] [5c]
Hero: bets 7,843
e94cdfd9: folds
Uncalled bet (7,843) returned to Hero
*** SHOWDOWN ***
Hero collected 15,686 from pot
*** SUMMARY ***
Total pot 15,686 | Rake 0 | Jackpot 0 | Bingo 0 | Fortune 0 | Tax 0
Board [Qc 2s 9d 5c]
Seat 1: 7a771626 folded before Flop
Seat 2: e94cdfd9 (button) folded on the Turn
Seat 3: 7966ecdb (small blind) folded before Flop
Seat 4: Hero (big blind) won (15,686)
Seat 5: 67a6e167 folded before Flop
Seat 6: d8ba7db5 folded before Flop
Seat 7: f35a242e folded before Flop
Seat 8: 5b10812e folded before Flop


Poker Hand #TM3552531943: Tournament #156543396, Bounty Hunters Special $1.08 Hold'em No Limit - Level17(1,250/2,500) - 2024/08/05 12:24:01
Table '72' 8-max Seat #1 is the button
Seat 1: 7a771626 (68,123 in chips)
Seat 2: e94cdfd9 (101,768 in chips)
Seat 3: 7966ecdb (29,250 in chips)
Seat 4: Hero (142,157 in chips)
Seat 5: 67a6e167 (187,168 in chips)
Seat 6: d8ba7db5 (40,680 in chips)
Seat 7: f35a242e (91,906 in chips)
Seat 8: 5b10812e (44,178 in chips)
d8ba7db5: posts the ante 350
7966ecdb: posts the ante 350
f35a242e: posts the ante 350
e94cdfd9: posts the ante 350
7a771626: posts the ante 350
67a6e167: posts the ante 350
Hero: posts the ante 350
5b10812e: posts the ante 350
e94cdfd9: posts small blind 1,250
7966ecdb: posts big blind 2,500
*** HOLE CARDS ***
Dealt to 7a771626 
Dealt to e94cdfd9 
Dealt to 7966ecdb 
Dealt to Hero [4c 8h]
Dealt to 67a6e167 
Dealt to d8ba7db5 
Dealt to f35a242e 
Dealt to 5b10812e 
Hero: folds
67a6e167: raises 7,500 to 10,000
d8ba7db5: folds
f35a242e: folds
5b10812e: folds
7a771626: folds
e94cdfd9: folds
7966ecdb: folds
Uncalled bet (7,500) returned to 67a6e167
*** SHOWDOWN ***
67a6e167 collected 9,050 from pot
*** SUMMARY ***
Total pot 9,050 | Rake 0 | Jackpot 0 | Bingo 0 | Fortune 0 | Tax 0
Seat 1: 7a771626 (button) folded before Flop
Seat 2: e94cdfd9 (small blind) folded before Flop
Seat 3: 7966ecdb (big blind) folded before Flop
Seat 4: Hero folded before Flop
Seat 5: 67a6e167 collected (9,050)
Seat 6: d8ba7db5 folded before Flop
Seat 7: f35a242e folded before Flop
Seat 8: 5b10812e folded before Flop


Poker Hand #TM3552531936: Tournament #156543396, Bounty Hunters Special $1.08 Hold'em No Limit - Level17(1,250/2,500) - 2024/08/05 12:23:38
Table '72' 8-max Seat #8 is the button
Seat 1: 7a771626 (69,723 in chips)
Seat 2: e94cdfd9 (98,418 in chips)
Seat 3: 7966ecdb (29,600 in chips)
Seat 4: Hero (142,507 in chips)
Seat 5: 67a6e167 (187,518 in chips)
Seat 7: f35a242e (92,256 in chips)
Seat 8: 5b10812e (44,528 in chips)
7966ecdb: posts the ante 350
f35a242e: posts the ante 350
e94cdfd9: posts the ante 350
7a771626: posts the ante 350
67a6e167: posts the ante 350
Hero: posts the ante 350
5b10812e: posts the ante 350
7a771626: posts small blind 1,250
e94cdfd9: posts big blind 2,500
*** HOLE CARDS ***
Dealt to 7a771626 
Dealt to e94cdfd9 
Dealt to 7966ecdb 
Dealt to Hero [Ah 6d]
Dealt to 67a6e167 
Dealt to f35a242e 
Dealt to 5b10812e 
7966ecdb: folds
Hero: folds
67a6e167: folds
f35a242e: folds
5b10812e: folds
7a771626: folds
Uncalled bet (1,250) returned to e94cdfd9
*** SHOWDOWN ***
e94cdfd9 collected 4,950 from pot
*** SUMMARY ***
Total pot 4,950 | Rake 0 | Jackpot 0 | Bingo 0 | Fortune 0 | Tax 0
Seat 1: 7a771626 (small blind) folded before Flop
Seat 2: e94cdfd9 (big blind) collected (4,950)
Seat 3: 7966ecdb folded before Flop
Seat 4: Hero folded before Flop
Seat 5: 67a6e167 folded before Flop
Seat 7: f35a242e folded before Flop
Seat 8: 5b10812e (button) folded before Flop


Poker Hand #TM3552531911: Tournament #156543396, Bounty Hunters Special $1.08 Hold'em No Limit - Level16(1,000/2,000) - 2024/08/05 12:22:33
Table '72' 8-max Seat #7 is the button
Seat 1: 7a771626 (114,601 in chips)
Seat 2: e94cdfd9 (98,718 in chips)
Seat 3: 7966ecdb (29,900 in chips)
Seat 4: Hero (142,807 in chips)
Seat 5: 67a6e167 (187,818 in chips)
Seat 7: f35a242e (44,878 in chips)
Seat 8: 5b10812e (45,828 in chips)
7966ecdb: posts the ante 300
f35a242e: posts the ante 300
e94cdfd9: posts the ante 300
7a771626: posts the ante 300
67a6e167: posts the ante 300
Hero: posts the ante 300
5b10812e: posts the ante 300
5b10812e: posts small blind 1,000
7a771626: posts big blind 2,000
*** HOLE CARDS ***
Dealt to 7a771626 
Dealt to e94cdfd9 
Dealt to 7966ecdb 
Dealt to Hero [9h 8s]
Dealt to 67a6e167 
Dealt to f35a242e 
Dealt to 5b10812e 
e94cdfd9: folds
7966ecdb: folds
Hero: folds
67a6e167: folds
f35a242e: raises 2,000 to 4,000
5b10812e: folds
7a771626: raises 5,550 to 9,550
f35a242e: raises 35,028 to 44,578 and is all-in
7a771626: calls 35,028
f35a242e: shows [As Qc]
7a771626: shows [Kd Ad]
*** FLOP *** [3s 6h 2c]
*** TURN *** [3s 6h 2c] [Qh]
*** RIVER *** [3s 6h 2c Qh] [5h]
*** SHOWDOWN ***
f35a242e collected 92,256 from pot
*** SUMMARY ***
Total pot 92,256 | Rake 0 | Jackpot 0 | Bingo 0 | Fortune 0 | Tax 0
Board [3s 6h 2c Qh 5h]
Seat 1: 7a771626 (big blind) showed [Kd Ad] and lost with Ace-High
Seat 2: e94cdfd9 folded before Flop
Seat 3: 7966ecdb folded before Flop
Seat 4: Hero folded before Flop
Seat 5: 67a6e167 folded before Flop
Seat 7: f35a242e (button) showed [As Qc] and won (92,256) with Pair of Queens
Seat 8: 5b10812e (small blind) folded before Flop


Poker Hand #TM3552531895: Tournament #156543396, Bounty Hunters Special $1.08 Hold'em No Limit - Level16(1,000/2,000) - 2024/08/05 12:21:41
Table '72' 8-max Seat #6 is the button
Seat 1: 7a771626 (114,901 in chips)
Seat 2: e94cdfd9 (99,018 in chips)
Seat 3: 7966ecdb (30,200 in chips)
Seat 4: Hero (143,107 in chips)
Seat 5: 67a6e167 (165,998 in chips)
Seat 6: e6f0d967 (17,020 in chips)
Seat 7: f35a242e (46,178 in chips)
Seat 8: 5b10812e (48,128 in chips)
7966ecdb: posts the ante 300
f35a242e: posts the ante 300
e94cdfd9: posts the ante 300
7a771626: posts the ante 300
e6f0d967: posts the ante 300
67a6e167: posts the ante 300
Hero: posts the ante 300
5b10812e: posts the ante 300
f35a242e: posts small blind 1,000
5b10812e: posts big blind 2,000
*** HOLE CARDS ***
Dealt to 7a771626 
Dealt to e94cdfd9 
Dealt to 7966ecdb 
Dealt to Hero [Jh 3s]
Dealt to 67a6e167 
Dealt to e6f0d967 
Dealt to f35a242e 
Dealt to 5b10812e 
7a771626: folds
e94cdfd9: folds
7966ecdb: folds
Hero: folds
67a6e167: raises 6,000 to 8,000
e6f0d967: raises 8,720 to 16,720 and is all-in
f35a242e: folds
5b10812e: folds
67a6e167: calls 8,720
e6f0d967: shows [9c Jc]
67a6e167: shows [Ac As]
*** FLOP *** [2h 3h 8d]
*** TURN *** [2h 3h 8d] [Kc]
*** RIVER *** [2h 3h 8d Kc] [4s]
*** SHOWDOWN ***
67a6e167 collected 38,840 from pot
*** SUMMARY ***
Total pot 38,840 | Rake 0 | Jackpot 0 | Bingo 0 | Fortune 0 | Tax 0
Board [2h 3h 8d Kc 4s]
Seat 1: 7a771626 folded before Flop
Seat 2: e94cdfd9 folded before Flop
Seat 3: 7966ecdb folded before Flop
Seat 4: Hero folded before Flop
Seat 5: 67a6e167 showed [Ac As] and won (38,840) with Pair of Aces
Seat 6: e6f0d967 (button) showed [9c Jc] and lost with King-High
Seat 7: f35a242e (small blind) folded before Flop
Seat 8: 5b10812e (big blind) folded before Flop


Poker Hand #TM3552531876: Tournament #156543396, Bounty Hunters Special $1.08 Hold'em No Limit - Level16(1,000/2,000) - 2024/08/05 12:20:37
Table '72' 8-max Seat #5 is the button
Seat 1: 7a771626 (113,501 in chips)
Seat 2: e94cdfd9 (99,318 in chips)
Seat 3: 7966ecdb (30,500 in chips)
Seat 4: Hero (143,407 in chips)
Seat 5: 67a6e167 (166,298 in chips)
Seat 6: e6f0d967 (18,320 in chips)
Seat 7: f35a242e (44,778 in chips)
Seat 8: 5b10812e (48,428 in chips)
7966ecdb: posts the ante 300
f35a242e: posts the ante 300
e94cdfd9: posts the ante 300
7a771626: posts the ante 300
e6f0d967: posts the ante 300
67a6e167: posts the ante 300
Hero: posts the ante 300
5b10812e: posts the ante 300
e6f0d967: posts small blind 1,000
f35a242e: posts big blind 2,000
*** HOLE CARDS ***
Dealt to 7a771626 
Dealt to e94cdfd9 
Dealt to 7966ecdb 
Dealt to Hero [Kc 4h]
Dealt to 67a6e167 
Dealt to e6f0d967 
Dealt to f35a242e 
Dealt to 5b10812e 
5b10812e: folds
7a771626: raises 2,000 to 4,000
e94cdfd9: folds
7966ecdb: folds
Hero: folds
67a6e167: folds
e6f0d967: folds
f35a242e: raises 11,000 to 15,000
7a771626: calls 11,000
*** FLOP *** [Qd Th 2h]
f35a242e: bets 29,478 and is all-in
7a771626: calls 29,478
f35a242e: shows [Jc Jd] (Pair of Jacks)
7a771626: shows [Js Qs] (Pair of Queens)
*** TURN *** [Qd Th 2h] [8d]
*** RIVER *** [Qd Th 2h 8d] [9d]
*** SHOWDOWN ***
7a771626 collected 46,178 from pot
f35a242e collected 46,178 from pot
*** SUMMARY ***
Total pot 92,356 | Rake 0 | Jackpot 0 | Bingo 0 | Fortune 0 | Tax 0
Board [Qd Th 2h 8d 9d]
Seat 1: 7a771626 showed [Js Qs] and won (46,178) with Queens-High Straight
Seat 2: e94cdfd9 folded before Flop
Seat 3: 7966ecdb folded before Flop
Seat 4: Hero folded before Flop
Seat 5: 67a6e167 (button) folded before Flop
Seat 6: e6f0d967 (small blind) folded before Flop
Seat 7: f35a242e (big blind) showed [Jc Jd] and won (46,178) with Queens-High Straight
Seat 8: 5b10812e folded before Flop


Poker Hand #TM3552630195: Tournament #156543396, Bounty Hunters Special $1.08 Hold'em No Limit - Level16(1,000/2,000) - 2024/08/05 12:19:04
Table '138' 8-max Seat #6 is the button
Seat 1: b7ffda6e (40,080 in chips)
Seat 2: 919c9cd6 (10,052 in chips)
Seat 3: 319dcc00 (126,820 in chips)
Seat 4: 45a59c86 (56,660 in chips)
Seat 5: Hero (80,244 in chips)
Seat 6: 4265169a (54,363 in chips)
Seat 7: 61e408a2 (62,096 in chips)
Seat 8: 2924cd3 (47,298 in chips)
2924cd3: posts the ante 300
61e408a2: posts the ante 300
4265169a: posts the ante 300
319dcc00: posts the ante 300
b7ffda6e: posts the ante 300
45a59c86: posts the ante 300
Hero: posts the ante 300
919c9cd6: posts the ante 300
61e408a2: posts small blind 1,000
2924cd3: posts big blind 2,000
*** HOLE CARDS ***
Dealt to b7ffda6e 
Dealt to 919c9cd6 
Dealt to 319dcc00 
Dealt to 45a59c86 
Dealt to Hero [Qd Qh]
Dealt to 4265169a 
Dealt to 61e408a2 
Dealt to 2924cd3 
b7ffda6e: raises 2,000 to 4,000
919c9cd6: folds
319dcc00: folds
45a59c86: folds
Hero: raises 6,700 to 10,700
4265169a: raises 43,363 to 54,063 and is all-in
61e408a2: folds
2924cd3: folds
b7ffda6e: folds
Hero: calls 43,363
4265169a: shows [3s Ac]
Hero: shows [Qd Qh]
*** FLOP *** [6c 7d 4c]
*** TURN *** [6c 7d 4c] [8c]
*** RIVER *** [6c 7d 4c 8c] [Ks]
*** SHOWDOWN ***
Hero collected 117,526 from pot
*** SUMMARY ***
Total pot 117,526 | Rake 0 | Jackpot 0 | Bingo 0 | Fortune 0 | Tax 0
Board [6c 7d 4c 8c Ks]
Seat 1: b7ffda6e folded before Flop
Seat 2: 919c9cd6 folded before Flop
Seat 3: 319dcc00 folded before Flop
Seat 4: 45a59c86 folded before Flop
Seat 5: Hero showed [Qd Qh] and won (117,526) with Pair of Queens
Seat 6: 4265169a (button) showed [3s Ac] and lost with Ace-High
Seat 7: 61e408a2 (small blind) folded before Flop
Seat 8: 2924cd3 (big blind) folded before Flop


Poker Hand #TM3552630178: Tournament #156543396, Bounty Hunters Special $1.08 Hold'em No Limit - Level16(1,000/2,000) - 2024/08/05 12:18:06
Table '138' 8-max Seat #5 is the button
Seat 1: b7ffda6e (40,380 in chips)
Seat 2: 919c9cd6 (10,352 in chips)
Seat 3: 319dcc00 (73,740 in chips)
Seat 4: 45a59c86 (56,960 in chips)
Seat 5: Hero (84,544 in chips)
Seat 6: 4265169a (97,643 in chips)
Seat 7: 61e408a2 (66,396 in chips)
Seat 8: 2924cd3 (47,598 in chips)
2924cd3: posts the ante 300
61e408a2: posts the ante 300
319dcc00: posts the ante 300
4265169a: posts the ante 300
b7ffda6e: posts the ante 300
45a59c86: posts the ante 300
Hero: posts the ante 300
919c9cd6: posts the ante 300
4265169a: posts small blind 1,000
61e408a2: posts big blind 2,000
*** HOLE CARDS ***
Dealt to b7ffda6e 
Dealt to 919c9cd6 
Dealt to 319dcc00 
Dealt to 45a59c86 
Dealt to Hero [8s 8d]
Dealt to 4265169a 
Dealt to 61e408a2 
Dealt to 2924cd3 
2924cd3: folds
b7ffda6e: folds
919c9cd6: folds
319dcc00: raises 2,000 to 4,000
45a59c86: folds
Hero: calls 4,000
4265169a: calls 3,000
61e408a2: calls 2,000
*** FLOP *** [7h Qs 9d]
4265169a: checks
61e408a2: checks
319dcc00: bets 6,072
Hero: folds
4265169a: calls 6,072
61e408a2: folds
*** TURN *** [7h Qs 9d] [2h]
4265169a: checks
319dcc00: bets 4,000
4265169a: calls 4,000
*** RIVER *** [7h Qs 9d 2h] [2s]
4265169a: bets 28,908
319dcc00: calls 28,908
4265169a: shows [Ah Th] (Pair of Twos)
319dcc00: shows [Kd Qc] (Pair of Queens and Pair of Twos)
*** SHOWDOWN ***
319dcc00 collected 96,360 from pot
*** SUMMARY ***
Total pot 96,360 | Rake 0 | Jackpot 0 | Bingo 0 | Fortune 0 | Tax 0
Board [7h Qs 9d 2h 2s]
Seat 1: b7ffda6e folded before Flop
Seat 2: 919c9cd6 folded before Flop
Seat 3: 319dcc00 showed [Kd Qc] and won (96,360) with Pair of Queens and Pair of Twos
Seat 4: 45a59c86 folded before Flop
Seat 5: Hero (button) folded on the Flop
Seat 6: 4265169a (small blind) showed [Ah Th] and lost with Pair of Twos
Seat 7: 61e408a2 (big blind) folded on the Flop
Seat 8: 2924cd3 folded before Flop


Poker Hand #TM3552630155: Tournament #156543396, Bounty Hunters Special $1.08 Hold'em No Limit - Level16(1,000/2,000) - 2024/08/05 12:17:16
Table '138' 8-max Seat #4 is the button
Seat 1: b7ffda6e (40,680 in chips)
Seat 2: 919c9cd6 (10,652 in chips)
Seat 3: 319dcc00 (79,040 in chips)
Seat 4: 45a59c86 (57,260 in chips)
Seat 5: Hero (85,844 in chips)
Seat 6: 4265169a (99,943 in chips)
Seat 7: 61e408a2 (71,696 in chips)
Seat 8: 2924cd3 (32,498 in chips)
2924cd3: posts the ante 300
61e408a2: posts the ante 300
319dcc00: posts the ante 300
4265169a: posts the ante 300
b7ffda6e: posts the ante 300
45a59c86: posts the ante 300
Hero: posts the ante 300
919c9cd6: posts the ante 300
Hero: posts small blind 1,000
4265169a: posts big blind 2,000
*** HOLE CARDS ***
Dealt to b7ffda6e 
Dealt to 919c9cd6 
Dealt to 319dcc00 
Dealt to 45a59c86 
Dealt to Hero [5c Ad]
Dealt to 4265169a 
Dealt to 61e408a2 
Dealt to 2924cd3 
61e408a2: calls 2,000
2924cd3: raises 3,000 to 5,000
b7ffda6e: folds
919c9cd6: folds
319dcc00: calls 5,000
45a59c86: folds
Hero: folds
4265169a: folds
61e408a2: calls 3,000
*** FLOP *** [6h 9c 9d]
61e408a2: checks
2924cd3: bets 6,732
319dcc00: folds
61e408a2: folds
Uncalled bet (6,732) returned to 2924cd3
*** SHOWDOWN ***
2924cd3 collected 20,400 from pot
*** SUMMARY ***
Total pot 20,400 | Rake 0 | Jackpot 0 | Bingo 0 | Fortune 0 | Tax 0
Board [6h 9c 9d]
Seat 1: b7ffda6e folded before Flop
Seat 2: 919c9cd6 folded before Flop
Seat 3: 319dcc00 folded on the Flop
Seat 4: 45a59c86 (button) folded before Flop
Seat 5: Hero (small blind) folded before Flop
Seat 6: 4265169a (big blind) folded before Flop
Seat 7: 61e408a2 folded on the Flop
Seat 8: 2924cd3 won (20,400)


Poker Hand #TM3552630150: Tournament #156543396, Bounty Hunters Special $1.08 Hold'em No Limit - Level16(1,000/2,000) - 2024/08/05 12:16:53
Table '138' 8-max Seat #3 is the button
Seat 1: b7ffda6e (40,980 in chips)
Seat 2: 919c9cd6 (10,952 in chips)
Seat 3: 319dcc00 (79,340 in chips)
Seat 4: 45a59c86 (58,560 in chips)
Seat 5: Hero (88,144 in chips)
Seat 6: 4265169a (94,843 in chips)
Seat 7: 61e408a2 (71,996 in chips)
Seat 8: 2924cd3 (32,798 in chips)
2924cd3: posts the ante 300
61e408a2: posts the ante 300
319dcc00: posts the ante 300
4265169a: posts the ante 300
b7ffda6e: posts the ante 300
45a59c86: posts the ante 300
Hero: posts the ante 300
919c9cd6: posts the ante 300
45a59c86: posts small blind 1,000
Hero: posts big blind 2,000
*** HOLE CARDS ***
Dealt to b7ffda6e 
Dealt to 919c9cd6 
Dealt to 319dcc00 
Dealt to 45a59c86 
Dealt to Hero [5d 9c]
Dealt to 4265169a 
Dealt to 61e408a2 
Dealt to 2924cd3 
4265169a: raises 4,000 to 6,000
61e408a2: folds
2924cd3: folds
b7ffda6e: folds
919c9cd6: folds
319dcc00: folds
45a59c86: folds
Hero: folds
Uncalled bet (4,000) returned to 4265169a
*** SHOWDOWN ***
4265169a collected 7,400 from pot
*** SUMMARY ***
Total pot 7,400 | Rake 0 | Jackpot 0 | Bingo 0 | Fortune 0 | Tax 0
Seat 1: b7ffda6e folded before Flop
Seat 2: 919c9cd6 folded before Flop
Seat 3: 319dcc00 (button) folded before Flop
Seat 4: 45a59c86 (small blind) folded before Flop
Seat 5: Hero (big blind) folded before Flop
Seat 6: 4265169a collected (7,400)
Seat 7: 61e408a2 folded before Flop
Seat 8: 2924cd3 folded before Flop


Poker Hand #TM3552630144: Tournament #156543396, Bounty Hunters Special $1.08 Hold'em No Limit - Level16(1,000/2,000) - 2024/08/05 12:16:33
Table '138' 8-max Seat #1 is the button
Seat 1: b7ffda6e (41,280 in chips)
Seat 3: 319dcc00 (80,640 in chips)
Seat 4: 45a59c86 (60,860 in chips)
Seat 5: Hero (88,444 in chips)
Seat 6: 4265169a (90,043 in chips)
Seat 7: 61e408a2 (72,296 in chips)
Seat 8: 2924cd3 (33,098 in chips)
2924cd3: posts the ante 300
61e408a2: posts the ante 300
4265169a: posts the ante 300
319dcc00: posts the ante 300
b7ffda6e: posts the ante 300
45a59c86: posts the ante 300
Hero: posts the ante 300
319dcc00: posts small blind 1,000
45a59c86: posts big blind 2,000
*** HOLE CARDS ***
Dealt to b7ffda6e 
Dealt to 319dcc00 
Dealt to 45a59c86 
Dealt to Hero [7c As]
Dealt to 4265169a 
Dealt to 61e408a2 
Dealt to 2924cd3 
Hero: folds
4265169a: raises 4,000 to 6,000
61e408a2: folds
2924cd3: folds
b7ffda6e: folds
319dcc00: folds
45a59c86: folds
Uncalled bet (4,000) returned to 4265169a
*** SHOWDOWN ***
4265169a collected 7,100 from pot
*** SUMMARY ***
Total pot 7,100 | Rake 0 | Jackpot 0 | Bingo 0 | Fortune 0 | Tax 0
Seat 1: b7ffda6e (button) folded before Flop
Seat 3: 319dcc00 (small blind) folded before Flop
Seat 4: 45a59c86 (big blind) folded before Flop
Seat 5: Hero folded before Flop
Seat 6: 4265169a collected (7,100)
Seat 7: 61e408a2 folded before Flop
Seat 8: 2924cd3 folded before Flop


Poker Hand #TM3552630130: Tournament #156543396, Bounty Hunters Special $1.08 Hold'em No Limit - Level16(1,000/2,000) - 2024/08/05 12:15:55
Table '138' 8-max Seat #8 is the button
Seat 1: b7ffda6e (42,580 in chips)
Seat 3: 319dcc00 (82,940 in chips)
Seat 4: 45a59c86 (61,160 in chips)
Seat 5: Hero (88,744 in chips)
Seat 6: 4265169a (123,941 in chips)
Seat 7: 61e408a2 (33,898 in chips)
Seat 8: 2924cd3 (33,398 in chips)
2924cd3: posts the ante 300
61e408a2: posts the ante 300
4265169a: posts the ante 300
319dcc00: posts the ante 300
b7ffda6e: posts the ante 300
45a59c86: posts the ante 300
Hero: posts the ante 300
b7ffda6e: posts small blind 1,000
319dcc00: posts big blind 2,000
*** HOLE CARDS ***
Dealt to b7ffda6e 
Dealt to 319dcc00 
Dealt to 45a59c86 
Dealt to Hero [8h Ad]
Dealt to 4265169a 
Dealt to 61e408a2 
Dealt to 2924cd3 
45a59c86: folds
Hero: folds
4265169a: raises 2,000 to 4,000
61e408a2: raises 29,598 to 33,598 and is all-in
2924cd3: folds
b7ffda6e: folds
319dcc00: folds
4265169a: calls 29,598
61e408a2: shows [Kc Kh]
4265169a: shows [Jc Th]
*** FLOP *** [3h 3s 3c]
*** TURN *** [3h 3s 3c] [4c]
*** RIVER *** [3h 3s 3c 4c] [5c]
*** SHOWDOWN ***
61e408a2 collected 72,296 from pot
*** SUMMARY ***
Total pot 72,296 | Rake 0 | Jackpot 0 | Bingo 0 | Fortune 0 | Tax 0
Board [3h 3s 3c 4c 5c]
Seat 1: b7ffda6e (small blind) folded before Flop
Seat 3: 319dcc00 (big blind) folded before Flop
Seat 4: 45a59c86 folded before Flop
Seat 5: Hero folded before Flop
Seat 6: 4265169a showed [Jc Th] and lost with Three Treys
Seat 7: 61e408a2 showed [Kc Kh] and won (72,296) with Treys Full over Kings
Seat 8: 2924cd3 (button) folded before Flop


Poker Hand #TM3552630123: Tournament #156543396, Bounty Hunters Special $1.08 Hold'em No Limit - Level16(1,000/2,000) - 2024/08/05 12:15:29
Table '138' 8-max Seat #7 is the button
Seat 1: b7ffda6e (39,480 in chips)
Seat 2: 353c4ad1 (21,494 in chips)
Seat 3: 319dcc00 (83,240 in chips)
Seat 4: 45a59c86 (61,460 in chips)
Seat 5: Hero (89,044 in chips)
Seat 6: 4265169a (124,241 in chips)
Seat 7: 61e408a2 (34,198 in chips)
Seat 8: 2924cd3 (34,698 in chips)
61e408a2: posts the ante 300
2924cd3: posts the ante 300
4265169a: posts the ante 300
319dcc00: posts the ante 300
353c4ad1: posts the ante 300
b7ffda6e: posts the ante 300
45a59c86: posts the ante 300
Hero: posts the ante 300
2924cd3: posts small blind 1,000
b7ffda6e: posts big blind 2,000
*** HOLE CARDS ***
Dealt to b7ffda6e 
Dealt to 353c4ad1 
Dealt to 319dcc00 
Dealt to 45a59c86 
Dealt to Hero [3d 6h]
Dealt to 4265169a 
Dealt to 61e408a2 
Dealt to 2924cd3 
353c4ad1: folds
319dcc00: folds
45a59c86: folds
Hero: folds
4265169a: folds
61e408a2: folds
2924cd3: folds
Uncalled bet (1,000) returned to b7ffda6e
*** SHOWDOWN ***
b7ffda6e collected 4,400 from pot
*** SUMMARY ***
Total pot 4,400 | Rake 0 | Jackpot 0 | Bingo 0 | Fortune 0 | Tax 0
Seat 1: b7ffda6e (big blind) collected (4,400)
Seat 2: 353c4ad1 folded before Flop
Seat 3: 319dcc00 folded before Flop
Seat 4: 45a59c86 folded before Flop
Seat 5: Hero folded before Flop
Seat 6: 4265169a folded before Flop
Seat 7: 61e408a2 (button) folded before Flop
Seat 8: 2924cd3 (small blind) folded before Flop


Poker Hand #TM3552630107: Tournament #156543396, Bounty Hunters Special $1.08 Hold'em No Limit - Level15(800/1,600) - 2024/08/05 12:14:46
Table '138' 8-max Seat #6 is the button
Seat 1: b7ffda6e (39,730 in chips)
Seat 2: 353c4ad1 (8,797 in chips)
Seat 3: 319dcc00 (92,037 in chips)
Seat 4: 45a59c86 (61,710 in chips)
Seat 5: Hero (89,294 in chips)
Seat 6: 4265169a (124,491 in chips)
Seat 7: 61e408a2 (35,248 in chips)
Seat 8: 2924cd3 (36,548 in chips)
2924cd3: posts the ante 250
61e408a2: posts the ante 250
4265169a: posts the ante 250
319dcc00: posts the ante 250
353c4ad1: posts the ante 250
b7ffda6e: posts the ante 250
45a59c86: posts the ante 250
Hero: posts the ante 250
61e408a2: posts small blind 800
2924cd3: posts big blind 1,600
*** HOLE CARDS ***
Dealt to b7ffda6e 
Dealt to 353c4ad1 
Dealt to 319dcc00 
Dealt to 45a59c86 
Dealt to Hero [Kd As]
Dealt to 4265169a 
Dealt to 61e408a2 
Dealt to 2924cd3 
b7ffda6e: folds
353c4ad1: raises 6,947 to 8,547 and is all-in
319dcc00: calls 8,547
45a59c86: folds
Hero: folds
4265169a: folds
61e408a2: folds
2924cd3: folds
353c4ad1: shows [8d Td]
319dcc00: shows [Tc Ac]
*** FLOP *** [Ah Jd 2d]
*** TURN *** [Ah Jd 2d] [3d]
*** RIVER *** [Ah Jd 2d 3d] [Qs]
4265169a: shows [7s 2c] (Pair of Twos)
*** SHOWDOWN ***
353c4ad1 collected 21,494 from pot
*** SUMMARY ***
Total pot 21,494 | Rake 0 | Jackpot 0 | Bingo 0 | Fortune 0 | Tax 0
Board [Ah Jd 2d 3d Qs]
Seat 1: b7ffda6e folded before Flop
Seat 2: 353c4ad1 showed [8d Td] and won (21,494) with Jack High Flush
Seat 3: 319dcc00 showed [Tc Ac] and lost with Pair of Aces
Seat 4: 45a59c86 folded before Flop
Seat 5: Hero folded before Flop
Seat 6: 4265169a (button) folded before Flop
Seat 7: 61e408a2 (small blind) folded before Flop
Seat 8: 2924cd3 (big blind) folded before Flop


Poker Hand #TM3552630078: Tournament #156543396, Bounty Hunters Special $1.08 Hold'em No Limit - Level15(800/1,600) - 2024/08/05 12:13:05
Table '138' 8-max Seat #5 is the button
Seat 1: b7ffda6e (39,980 in chips)
Seat 2: 353c4ad1 (9,047 in chips)
Seat 3: 319dcc00 (95,867 in chips)
Seat 4: 45a59c86 (61,960 in chips)
Seat 5: Hero (89,544 in chips)
Seat 6: 4265169a (125,541 in chips)
Seat 7: 61e408a2 (29,118 in chips)
Seat 8: 2924cd3 (36,798 in chips)
2924cd3: posts the ante 250
61e408a2: posts the ante 250
319dcc00: posts the ante 250
353c4ad1: posts the ante 250
4265169a: posts the ante 250
b7ffda6e: posts the ante 250
45a59c86: posts the ante 250
Hero: posts the ante 250
4265169a: posts small blind 800
61e408a2: posts big blind 1,600
*** HOLE CARDS ***
Dealt to b7ffda6e 
Dealt to 353c4ad1 
Dealt to 319dcc00 
Dealt to 45a59c86 
Dealt to Hero [7c Jh]
Dealt to 4265169a 
Dealt to 61e408a2 
Dealt to 2924cd3 
2924cd3: folds
b7ffda6e: folds
353c4ad1: folds
319dcc00: calls 1,600
45a59c86: folds
Hero: folds
4265169a: folds
61e408a2: checks
*** FLOP *** [4d 7d 8c]
61e408a2: bets 1,980
319dcc00: calls 1,980
*** TURN *** [4d 7d 8c] [Ad]
61e408a2: checks
319dcc00: checks
*** RIVER *** [4d 7d 8c Ad] [4c]
61e408a2: bets 3,287
319dcc00: folds
Uncalled bet (3,287) returned to 61e408a2
319dcc00: shows [Tc Jc] (Pair of Fours)
*** SHOWDOWN ***
61e408a2 collected 9,960 from pot
*** SUMMARY ***
Total pot 9,960 | Rake 0 | Jackpot 0 | Bingo 0 | Fortune 0 | Tax 0
Board [4d 7d 8c Ad 4c]
Seat 1: b7ffda6e folded before Flop
Seat 2: 353c4ad1 folded before Flop
Seat 3: 319dcc00 folded on the River
Seat 4: 45a59c86 folded before Flop
Seat 5: Hero (button) folded before Flop
Seat 6: 4265169a (small blind) folded before Flop
Seat 7: 61e408a2 (big blind) won (9,960)
Seat 8: 2924cd3 folded before Flop


Poker Hand #TM3552630069: Tournament #156543396, Bounty Hunters Special $1.08 Hold'em No Limit - Level15(800/1,600) - 2024/08/05 12:12:33
Table '138' 8-max Seat #4 is the button
Seat 1: b7ffda6e (40,230 in chips)
Seat 2: 353c4ad1 (9,297 in chips)
Seat 3: 319dcc00 (96,117 in chips)
Seat 4: 45a59c86 (62,210 in chips)
Seat 5: Hero (91,394 in chips)
Seat 6: 4265169a (122,191 in chips)
Seat 7: 61e408a2 (29,368 in chips)
Seat 8: 2924cd3 (37,048 in chips)
2924cd3: posts the ante 250
61e408a2: posts the ante 250
319dcc00: posts the ante 250
353c4ad1: posts the ante 250
4265169a: posts the ante 250
b7ffda6e: posts the ante 250
45a59c86: posts the ante 250
Hero: posts the ante 250
Hero: posts small blind 800
4265169a: posts big blind 1,600
*** HOLE CARDS ***
Dealt to b7ffda6e 
Dealt to 353c4ad1 
Dealt to 319dcc00 
Dealt to 45a59c86 
Dealt to Hero [Kh 7d]
Dealt to 4265169a 
Dealt to 61e408a2 
Dealt to 2924cd3 
61e408a2: folds
2924cd3: folds
b7ffda6e: folds
353c4ad1: folds
319dcc00: folds
45a59c86: folds
Hero: calls 800
4265169a: raises 120,341 to 121,941 and is all-in
Hero: folds
Uncalled bet (120,341) returned to 4265169a
Hero: shows [Kh]
*** SHOWDOWN ***
4265169a collected 5,200 from pot
*** SUMMARY ***
Total pot 5,200 | Rake 0 | Jackpot 0 | Bingo 0 | Fortune 0 | Tax 0
Seat 1: b7ffda6e folded before Flop
Seat 2: 353c4ad1 folded before Flop
Seat 3: 319dcc00 folded before Flop
Seat 4: 45a59c86 (button) folded before Flop
Seat 5: Hero (small blind) folded before Flop
Seat 6: 4265169a (big blind) collected (5,200)
Seat 7: 61e408a2 folded before Flop
Seat 8: 2924cd3 folded before Flop


Poker Hand #TM3552630056: Tournament #156543396, Bounty Hunters Special $1.08 Hold'em No Limit - Level15(800/1,600) - 2024/08/05 12:11:54
Table '138' 8-max Seat #3 is the button
Seat 1: b7ffda6e (40,480 in chips)
Seat 2: 353c4ad1 (8,147 in chips)
Seat 3: 319dcc00 (96,367 in chips)
Seat 4: 45a59c86 (63,260 in chips)
Seat 5: Hero (90,244 in chips)
Seat 6: 4265169a (122,441 in chips)
Seat 7: 61e408a2 (29,618 in chips)
Seat 8: 2924cd3 (37,298 in chips)
2924cd3: posts the ante 250
61e408a2: posts the ante 250
319dcc00: posts the ante 250
353c4ad1: posts the ante 250
4265169a: posts the ante 250
b7ffda6e: posts the ante 250
45a59c86: posts the ante 250
Hero: posts the ante 250
45a59c86: posts small blind 800
Hero: posts big blind 1,600
*** HOLE CARDS ***
Dealt to b7ffda6e 
Dealt to 353c4ad1 
Dealt to 319dcc00 
Dealt to 45a59c86 
Dealt to Hero [Qc 4c]
Dealt to 4265169a 
Dealt to 61e408a2 
Dealt to 2924cd3 
4265169a: folds
61e408a2: folds
2924cd3: folds
b7ffda6e: folds
353c4ad1: raises 6,297 to 7,897 and is all-in
319dcc00: folds
45a59c86: folds
Hero: calls 6,297
353c4ad1: shows [9c Tc]
Hero: shows [Qc 4c]
*** FLOP *** [Jd 8c Ah]
*** TURN *** [Jd 8c Ah] [Js]
*** RIVER *** [Jd 8c Ah Js] [8d]
*** SHOWDOWN ***
Hero collected 9,297 from pot
353c4ad1 collected 9,297 from pot
*** SUMMARY ***
Total pot 18,594 | Rake 0 | Jackpot 0 | Bingo 0 | Fortune 0 | Tax 0
Board [Jd 8c Ah Js 8d]
Seat 1: b7ffda6e folded before Flop
Seat 2: 353c4ad1 showed [9c Tc] and won (9,297) with Pair of Jacks and Pair of Eights
Seat 3: 319dcc00 (button) folded before Flop
Seat 4: 45a59c86 (small blind) folded before Flop
Seat 5: Hero (big blind) showed [Qc 4c] and won (9,297) with Pair of Jacks and Pair of Eights
Seat 6: 4265169a folded before Flop
Seat 7: 61e408a2 folded before Flop
Seat 8: 2924cd3 folded before Flop


Poker Hand #TM3552630037: Tournament #156543396, Bounty Hunters Special $1.08 Hold'em No Limit - Level15(800/1,600) - 2024/08/05 12:10:56
Table '138' 8-max Seat #2 is the button
Seat 1: b7ffda6e (40,730 in chips)
Seat 2: 353c4ad1 (8,397 in chips)
Seat 3: 319dcc00 (97,417 in chips)
Seat 4: 45a59c86 (65,110 in chips)
Seat 5: Hero (99,914 in chips)
Seat 6: 4265169a (108,871 in chips)
Seat 7: 61e408a2 (29,868 in chips)
Seat 8: 2924cd3 (37,548 in chips)
2924cd3: posts the ante 250
61e408a2: posts the ante 250
353c4ad1: posts the ante 250
4265169a: posts the ante 250
319dcc00: posts the ante 250
b7ffda6e: posts the ante 250
45a59c86: posts the ante 250
Hero: posts the ante 250
319dcc00: posts small blind 800
45a59c86: posts big blind 1,600
*** HOLE CARDS ***
Dealt to b7ffda6e 
Dealt to 353c4ad1 
Dealt to 319dcc00 
Dealt to 45a59c86 
Dealt to Hero [7h 7c]
Dealt to 4265169a 
Dealt to 61e408a2 
Dealt to 2924cd3 
Hero: calls 1,600
4265169a: raises 3,200 to 4,800
61e408a2: folds
2924cd3: folds
b7ffda6e: folds
353c4ad1: folds
319dcc00: folds
45a59c86: folds
Hero: calls 3,200
*** FLOP *** [6c Ad 2d]
Hero: bets 4,620
4265169a: calls 4,620
*** TURN *** [6c Ad 2d] [5h]
Hero: checks
4265169a: checks
*** RIVER *** [6c Ad 2d 5h] [Tc]
Hero: checks
4265169a: checks
Hero: shows [7h 7c] (Pair of Sevens)
4265169a: shows [8h 8c] (Pair of Eights)
*** SHOWDOWN ***
4265169a collected 23,240 from pot
*** SUMMARY ***
Total pot 23,240 | Rake 0 | Jackpot 0 | Bingo 0 | Fortune 0 | Tax 0
Board [6c Ad 2d 5h Tc]
Seat 1: b7ffda6e folded before Flop
Seat 2: 353c4ad1 (button) folded before Flop
Seat 3: 319dcc00 (small blind) folded before Flop
Seat 4: 45a59c86 (big blind) folded before Flop
Seat 5: Hero showed [7h 7c] and lost with Pair of Sevens
Seat 6: 4265169a showed [8h 8c] and won (23,240) with Pair of Eights
Seat 7: 61e408a2 folded before Flop
Seat 8: 2924cd3 folded before Flop


Poker Hand #TM3552630020: Tournament #156543396, Bounty Hunters Special $1.08 Hold'em No Limit - Level15(800/1,600) - 2024/08/05 12:10:17
Table '138' 8-max Seat #1 is the button
Seat 1: b7ffda6e (40,980 in chips)
Seat 2: 353c4ad1 (9,447 in chips)
Seat 3: 319dcc00 (101,027 in chips)
Seat 4: 45a59c86 (65,360 in chips)
Seat 5: Hero (100,164 in chips)
Seat 6: 4265169a (109,121 in chips)
Seat 8: 2924cd3 (31,888 in chips)
2924cd3: posts the ante 250
4265169a: posts the ante 250
319dcc00: posts the ante 250
353c4ad1: posts the ante 250
b7ffda6e: posts the ante 250
45a59c86: posts the ante 250
Hero: posts the ante 250
353c4ad1: posts small blind 800
319dcc00: posts big blind 1,600
*** HOLE CARDS ***
Dealt to b7ffda6e 
Dealt to 353c4ad1 
Dealt to 319dcc00 
Dealt to 45a59c86 
Dealt to Hero [6c 8d]
Dealt to 4265169a 
Dealt to 2924cd3 
45a59c86: folds
Hero: folds
4265169a: folds
2924cd3: raises 1,760 to 3,360
b7ffda6e: folds
353c4ad1: folds
319dcc00: calls 1,760
*** FLOP *** [Ad 2d 5h]
319dcc00: checks
2924cd3: bets 3,060
319dcc00: folds
Uncalled bet (3,060) returned to 2924cd3
*** SHOWDOWN ***
2924cd3 collected 9,270 from pot
*** SUMMARY ***
Total pot 9,270 | Rake 0 | Jackpot 0 | Bingo 0 | Fortune 0 | Tax 0
Board [Ad 2d 5h]
Seat 1: b7ffda6e (button) folded before Flop
Seat 2: 353c4ad1 (small blind) folded before Flop
Seat 3: 319dcc00 (big blind) folded on the Flop
Seat 4: 45a59c86 folded before Flop
Seat 5: Hero folded before Flop
Seat 6: 4265169a folded before Flop
Seat 8: 2924cd3 won (9,270)


Poker Hand #TM3552630012: Tournament #156543396, Bounty Hunters Special $1.08 Hold'em No Limit - Level15(800/1,600) - 2024/08/05 12:09:53
Table '138' 8-max Seat #8 is the button
Seat 1: b7ffda6e (42,030 in chips)
Seat 2: 353c4ad1 (11,297 in chips)
Seat 3: 319dcc00 (101,277 in chips)
Seat 4: 45a59c86 (65,610 in chips)
Seat 5: Hero (100,414 in chips)
Seat 6: 4265169a (109,371 in chips)
Seat 8: 2924cd3 (27,988 in chips)
2924cd3: posts the ante 250
4265169a: posts the ante 250
319dcc00: posts the ante 250
353c4ad1: posts the ante 250
b7ffda6e: posts the ante 250
45a59c86: posts the ante 250
Hero: posts the ante 250
b7ffda6e: posts small blind 800
353c4ad1: posts big blind 1,600
*** HOLE CARDS ***
Dealt to b7ffda6e 
Dealt to 353c4ad1 
Dealt to 319dcc00 
Dealt to 45a59c86 
Dealt to Hero [5s Qc]
Dealt to 4265169a 
Dealt to 2924cd3 
319dcc00: folds
45a59c86: folds
Hero: folds
4265169a: folds
2924cd3: raises 26,138 to 27,738 and is all-in
b7ffda6e: folds
353c4ad1: folds
Uncalled bet (26,138) returned to 2924cd3
*** SHOWDOWN ***
2924cd3 collected 5,750 from pot
*** SUMMARY ***
Total pot 5,750 | Rake 0 | Jackpot 0 | Bingo 0 | Fortune 0 | Tax 0
Seat 1: b7ffda6e (small blind) folded before Flop
Seat 2: 353c4ad1 (big blind) folded before Flop
Seat 3: 319dcc00 folded before Flop
Seat 4: 45a59c86 folded before Flop
Seat 5: Hero folded before Flop
Seat 6: 4265169a folded before Flop
Seat 8: 2924cd3 (button) collected (5,750)


Poker Hand #TM3552630002: Tournament #156543396, Bounty Hunters Special $1.08 Hold'em No Limit - Level15(800/1,600) - 2024/08/05 12:09:13
Table '138' 8-max Seat #7 is the button
Seat 1: b7ffda6e (43,880 in chips)
Seat 2: 353c4ad1 (11,547 in chips)
Seat 3: 319dcc00 (85,381 in chips)
Seat 4: 45a59c86 (65,860 in chips)
Seat 5: Hero (100,664 in chips)
Seat 6: 4265169a (109,621 in chips)
Seat 7: 1a038103 (11,996 in chips)
Seat 8: 2924cd3 (29,038 in chips)
2924cd3: posts the ante 250
4265169a: posts the ante 250
319dcc00: posts the ante 250
353c4ad1: posts the ante 250
b7ffda6e: posts the ante 250
1a038103: posts the ante 250
45a59c86: posts the ante 250
Hero: posts the ante 250
2924cd3: posts small blind 800
b7ffda6e: posts big blind 1,600
*** HOLE CARDS ***
Dealt to b7ffda6e 
Dealt to 353c4ad1 
Dealt to 319dcc00 
Dealt to 45a59c86 
Dealt to Hero [4d Th]
Dealt to 4265169a 
Dealt to 1a038103 
Dealt to 2924cd3 
353c4ad1: folds
319dcc00: raises 1,600 to 3,200
45a59c86: folds
Hero: folds
4265169a: folds
1a038103: raises 8,546 to 11,746 and is all-in
2924cd3: folds
b7ffda6e: folds
319dcc00: calls 8,546
1a038103: shows [Qd Kh]
319dcc00: shows [As Jd]
*** FLOP *** [2d Ah 7s]
*** TURN *** [2d Ah 7s] [Ks]
*** RIVER *** [2d Ah 7s Ks] [Td]
*** SHOWDOWN ***
319dcc00 collected 27,892 from pot
*** SUMMARY ***
Total pot 27,892 | Rake 0 | Jackpot 0 | Bingo 0 | Fortune 0 | Tax 0
Board [2d Ah 7s Ks Td]
Seat 1: b7ffda6e (big blind) folded before Flop
Seat 2: 353c4ad1 folded before Flop
Seat 3: 319dcc00 showed [As Jd] and won (27,892) with Pair of Aces
Seat 4: 45a59c86 folded before Flop
Seat 5: Hero folded before Flop
Seat 6: 4265169a folded before Flop
Seat 7: 1a038103 (button) showed [Qd Kh] and lost with Pair of Kings
Seat 8: 2924cd3 (small blind) folded before Flop


Poker Hand #TM3552629984: Tournament #156543396, Bounty Hunters Special $1.08 Hold'em No Limit - Level15(800/1,600) - 2024/08/05 12:08:18
Table '138' 8-max Seat #6 is the button
Seat 1: b7ffda6e (44,130 in chips)
Seat 2: 353c4ad1 (11,797 in chips)
Seat 3: 319dcc00 (85,631 in chips)
Seat 4: 45a59c86 (30,980 in chips)
Seat 5: Hero (131,644 in chips)
Seat 6: 4265169a (109,871 in chips)
Seat 7: 1a038103 (13,046 in chips)
Seat 8: 2924cd3 (30,888 in chips)
2924cd3: posts the ante 250
4265169a: posts the ante 250
319dcc00: posts the ante 250
353c4ad1: posts the ante 250
b7ffda6e: posts the ante 250
1a038103: posts the ante 250
45a59c86: posts the ante 250
Hero: posts the ante 250
1a038103: posts small blind 800
2924cd3: posts big blind 1,600
*** HOLE CARDS ***
Dealt to b7ffda6e 
Dealt to 353c4ad1 
Dealt to 319dcc00 
Dealt to 45a59c86 
Dealt to Hero [Jh Ah]
Dealt to 4265169a 
Dealt to 1a038103 
Dealt to 2924cd3 
b7ffda6e: folds
353c4ad1: folds
319dcc00: folds
45a59c86: raises 1,600 to 3,200
Hero: raises 3,564 to 6,764
4265169a: folds
1a038103: folds
2924cd3: folds
45a59c86: raises 23,966 to 30,730 and is all-in
Hero: calls 23,966
45a59c86: shows [Ad As]
Hero: shows [Jh Ah]
*** FLOP *** [4d Js Qd]
*** TURN *** [4d Js Qd] [Kc]
*** RIVER *** [4d Js Qd Kc] [3h]
2924cd3: shows [Jc 4h] (Pair of Jacks and Pair of Fours)
*** SHOWDOWN ***
45a59c86 collected 65,860 from pot
*** SUMMARY ***
Total pot 65,860 | Rake 0 | Jackpot 0 | Bingo 0 | Fortune 0 | Tax 0
Board [4d Js Qd Kc 3h]
Seat 1: b7ffda6e folded before Flop
Seat 2: 353c4ad1 folded before Flop
Seat 3: 319dcc00 folded before Flop
Seat 4: 45a59c86 showed [Ad As] and won (65,860) with Pair of Aces
Seat 5: Hero showed [Jh Ah] and lost with Pair of Jacks
Seat 6: 4265169a (button) folded before Flop
Seat 7: 1a038103 (small blind) folded before Flop
Seat 8: 2924cd3 (big blind) folded before Flop


Poker Hand #TM3552629959: Tournament #156543396, Bounty Hunters Special $1.08 Hold'em No Limit - Level15(800/1,600) - 2024/08/05 12:06:52
Table '138' 8-max Seat #5 is the button
Seat 1: b7ffda6e (44,380 in chips)
Seat 2: 353c4ad1 (12,047 in chips)
Seat 3: 319dcc00 (89,081 in chips)
Seat 4: 45a59c86 (31,230 in chips)
Seat 5: Hero (90,394 in chips)
Seat 6: 4265169a (110,921 in chips)
Seat 7: 1a038103 (48,796 in chips)
Seat 8: 2924cd3 (31,138 in chips)
2924cd3: posts the ante 250
319dcc00: posts the ante 250
353c4ad1: posts the ante 250
4265169a: posts the ante 250
b7ffda6e: posts the ante 250
1a038103: posts the ante 250
45a59c86: posts the ante 250
Hero: posts the ante 250
4265169a: posts small blind 800
1a038103: posts big blind 1,600
*** HOLE CARDS ***
Dealt to b7ffda6e 
Dealt to 353c4ad1 
Dealt to 319dcc00 
Dealt to 45a59c86 
Dealt to Hero [9c Ac]
Dealt to 4265169a 
Dealt to 1a038103 
Dealt to 2924cd3 
2924cd3: folds
b7ffda6e: folds
353c4ad1: folds
319dcc00: calls 1,600
45a59c86: folds
Hero: calls 1,600
4265169a: folds
1a038103: checks
*** FLOP *** [Kh 2c Tc]
1a038103: checks
319dcc00: bets 1,600
Hero: calls 1,600
1a038103: calls 1,600
*** TURN *** [Kh 2c Tc] [8c]
1a038103: checks
319dcc00: checks
Hero: checks
*** RIVER *** [Kh 2c Tc 8c] [2d]
1a038103: bets 4,800
319dcc00: folds
Hero: raises 27,500 to 32,300
1a038103: calls 27,500
Hero: shows [9c Ac] (Ace High Flush)
1a038103: shows [Jc 7c] (Jack High Flush)
*** SHOWDOWN ***
Hero collected 77,000 from pot
*** SUMMARY ***
Total pot 77,000 | Rake 0 | Jackpot 0 | Bingo 0 | Fortune 0 | Tax 0
Board [Kh 2c Tc 8c 2d]
Seat 1: b7ffda6e folded before Flop
Seat 2: 353c4ad1 folded before Flop
Seat 3: 319dcc00 folded on the River
Seat 4: 45a59c86 folded before Flop
Seat 5: Hero (button) showed [9c Ac] and won (77,000) with Ace High Flush
Seat 6: 4265169a (small blind) folded before Flop
Seat 7: 1a038103 (big blind) showed [Jc 7c] and lost with Jack High Flush
Seat 8: 2924cd3 folded before Flop


Poker Hand #TM3552629943: Tournament #156543396, Bounty Hunters Special $1.08 Hold'em No Limit - Level14(600/1,200) - 2024/08/05 12:06:13
Table '138' 8-max Seat #4 is the button
Seat 1: b7ffda6e (44,560 in chips)
Seat 2: 353c4ad1 (19,274 in chips)
Seat 3: 319dcc00 (89,261 in chips)
Seat 4: 45a59c86 (31,410 in chips)
Seat 5: Hero (91,774 in chips)
Seat 6: 4265169a (101,414 in chips)
Seat 7: 1a038103 (48,976 in chips)
Seat 8: 2924cd3 (31,318 in chips)
2924cd3: posts the ante 180
319dcc00: posts the ante 180
353c4ad1: posts the ante 180
4265169a: posts the ante 180
b7ffda6e: posts the ante 180
1a038103: posts the ante 180
45a59c86: posts the ante 180
Hero: posts the ante 180
Hero: posts small blind 600
4265169a: posts big blind 1,200
*** HOLE CARDS ***
Dealt to b7ffda6e 
Dealt to 353c4ad1 
Dealt to 319dcc00 
Dealt to 45a59c86 
Dealt to Hero [Qc 9s]
Dealt to 4265169a 
Dealt to 1a038103 
Dealt to 2924cd3 
1a038103: folds
2924cd3: folds
b7ffda6e: folds
353c4ad1: calls 1,200
319dcc00: folds
45a59c86: folds
Hero: calls 600
4265169a: checks
*** FLOP *** [4d 2h Js]
Hero: checks
4265169a: checks
353c4ad1: checks
*** TURN *** [4d 2h Js] [Jc]
Hero: checks
4265169a: bets 2,520
353c4ad1: calls 2,520
Hero: folds
*** RIVER *** [4d 2h Js Jc] [6h]
4265169a: bets 3,327
353c4ad1: calls 3,327
4265169a: shows [5d 6d] (Pair of Jacks and Pair of Sixes)
353c4ad1: shows [3s 3c] (Pair of Jacks and Pair of Treys)
*** SHOWDOWN ***
4265169a collected 16,734 from pot
*** SUMMARY ***
Total pot 16,734 | Rake 0 | Jackpot 0 | Bingo 0 | Fortune 0 | Tax 0
Board [4d 2h Js Jc 6h]
Seat 1: b7ffda6e folded before Flop
Seat 2: 353c4ad1 showed [3s 3c] and lost with Pair of Jacks and Pair of Treys
Seat 3: 319dcc00 folded before Flop
Seat 4: 45a59c86 (button) folded before Flop
Seat 5: Hero (small blind) folded on the Turn
Seat 6: 4265169a (big blind) showed [5d 6d] and won (16,734) with Pair of Jacks and Pair of Sixes
Seat 7: 1a038103 folded before Flop
Seat 8: 2924cd3 folded before Flop


Poker Hand #TM3552629924: Tournament #156543396, Bounty Hunters Special $1.08 Hold'em No Limit - Level14(600/1,200) - 2024/08/05 12:05:11
Table '138' 8-max Seat #3 is the button
Seat 1: b7ffda6e (44,740 in chips)
Seat 2: 353c4ad1 (19,454 in chips)
Seat 3: 319dcc00 (89,441 in chips)
Seat 4: 45a59c86 (32,190 in chips)
Seat 5: Hero (93,154 in chips)
Seat 6: 4265169a (101,594 in chips)
Seat 7: 1a038103 (40,862 in chips)
Seat 8: 2924cd3 (36,552 in chips)
2924cd3: posts the ante 180
319dcc00: posts the ante 180
353c4ad1: posts the ante 180
4265169a: posts the ante 180
b7ffda6e: posts the ante 180
1a038103: posts the ante 180
45a59c86: posts the ante 180
Hero: posts the ante 180
45a59c86: posts small blind 600
Hero: posts big blind 1,200
*** HOLE CARDS ***
Dealt to b7ffda6e 
Dealt to 353c4ad1 
Dealt to 319dcc00 
Dealt to 45a59c86 
Dealt to Hero [Td 5s]
Dealt to 4265169a 
Dealt to 1a038103 
Dealt to 2924cd3 
4265169a: folds
1a038103: raises 1,200 to 2,400
2924cd3: calls 2,400
b7ffda6e: folds
353c4ad1: folds
319dcc00: folds
45a59c86: folds
Hero: folds
*** FLOP *** [3d Ks 2c]
1a038103: checks
2924cd3: bets 2,654
1a038103: calls 2,654
*** TURN *** [3d Ks 2c] [Tc]
1a038103: checks
2924cd3: checks
*** RIVER *** [3d Ks 2c Tc] [3h]
1a038103: checks
2924cd3: checks
1a038103: shows [Kh Kd] (Kings Full over Treys)
2924cd3: shows [6d 6c] (Pair of Sixes and Pair of Treys)
*** SHOWDOWN ***
1a038103 collected 13,348 from pot
*** SUMMARY ***
Total pot 13,348 | Rake 0 | Jackpot 0 | Bingo 0 | Fortune 0 | Tax 0
Board [3d Ks 2c Tc 3h]
Seat 1: b7ffda6e folded before Flop
Seat 2: 353c4ad1 folded before Flop
Seat 3: 319dcc00 (button) folded before Flop
Seat 4: 45a59c86 (small blind) folded before Flop
Seat 5: Hero (big blind) folded before Flop
Seat 6: 4265169a folded before Flop
Seat 7: 1a038103 showed [Kh Kd] and won (13,348) with Kings Full over Treys
Seat 8: 2924cd3 showed [6d 6c] and lost with Pair of Sixes and Pair of Treys


Poker Hand #TM3552629902: Tournament #156543396, Bounty Hunters Special $1.08 Hold'em No Limit - Level14(600/1,200) - 2024/08/05 12:04:08
Table '138' 8-max Seat #2 is the button
Seat 1: b7ffda6e (44,920 in chips)
Seat 2: 353c4ad1 (19,634 in chips)
Seat 3: 319dcc00 (90,821 in chips)
Seat 4: 45a59c86 (33,570 in chips)
Seat 5: Hero (93,334 in chips)
Seat 6: 4265169a (97,934 in chips)
Seat 7: 1a038103 (41,042 in chips)
Seat 8: 2924cd3 (36,732 in chips)
2924cd3: posts the ante 180
353c4ad1: posts the ante 180
4265169a: posts the ante 180
319dcc00: posts the ante 180
b7ffda6e: posts the ante 180
1a038103: posts the ante 180
45a59c86: posts the ante 180
Hero: posts the ante 180
319dcc00: posts small blind 600
45a59c86: posts big blind 1,200
*** HOLE CARDS ***
Dealt to b7ffda6e 
Dealt to 353c4ad1 
Dealt to 319dcc00 
Dealt to 45a59c86 
Dealt to Hero [Qh 5s]
Dealt to 4265169a 
Dealt to 1a038103 
Dealt to 2924cd3 
Hero: folds
4265169a: calls 1,200
1a038103: folds
2924cd3: folds
b7ffda6e: folds
353c4ad1: folds
319dcc00: calls 600
45a59c86: checks
*** FLOP *** [3h Js Qc]
319dcc00: checks
45a59c86: checks
4265169a: bets 2,520
319dcc00: folds
45a59c86: folds
Uncalled bet (2,520) returned to 4265169a
*** SHOWDOWN ***
4265169a collected 5,040 from pot
*** SUMMARY ***
Total pot 5,040 | Rake 0 | Jackpot 0 | Bingo 0 | Fortune 0 | Tax 0
Board [3h Js Qc]
Seat 1: b7ffda6e folded before Flop
Seat 2: 353c4ad1 (button) folded before Flop
Seat 3: 319dcc00 (small blind) folded on the Flop
Seat 4: 45a59c86 (big blind) folded on the Flop
Seat 5: Hero folded before Flop
Seat 6: 4265169a won (5,040)
Seat 7: 1a038103 folded before Flop
Seat 8: 2924cd3 folded before Flop


Poker Hand #TM3552629883: Tournament #156543396, Bounty Hunters Special $1.08 Hold'em No Limit - Level14(600/1,200) - 2024/08/05 12:03:08
Table '138' 8-max Seat #1 is the button
Seat 1: b7ffda6e (45,100 in chips)
Seat 2: 353c4ad1 (20,414 in chips)
Seat 3: 319dcc00 (121,331 in chips)
Seat 4: 45a59c86 (33,750 in chips)
Seat 5: Hero (55,324 in chips)
Seat 6: 4265169a (104,114 in chips)
Seat 8: 2924cd3 (36,912 in chips)
2924cd3: posts the ante 180
4265169a: posts the ante 180
319dcc00: posts the ante 180
353c4ad1: posts the ante 180
b7ffda6e: posts the ante 180
45a59c86: posts the ante 180
Hero: posts the ante 180
353c4ad1: posts small blind 600
319dcc00: posts big blind 1,200
*** HOLE CARDS ***
Dealt to b7ffda6e 
Dealt to 353c4ad1 
Dealt to 319dcc00 
Dealt to 45a59c86 
Dealt to Hero [5s 5d]
Dealt to 4265169a 
Dealt to 2924cd3 
45a59c86: folds
Hero: calls 1,200
4265169a: raises 2,400 to 3,600
2924cd3: folds
b7ffda6e: folds
353c4ad1: folds
319dcc00: calls 2,400
Hero: calls 2,400
*** FLOP *** [Ks 5h Jd]
319dcc00: bets 2,400
Hero: calls 2,400
4265169a: calls 2,400
*** TURN *** [Ks 5h Jd] [2s]
319dcc00: bets 2,400
Hero: raises 4,800 to 7,200
4265169a: folds
319dcc00: calls 4,800
*** RIVER *** [Ks 5h Jd 2s] [6c]
319dcc00: checks
Hero: bets 17,130
319dcc00: calls 17,130
Hero: shows [5s 5d] (Three Fives)
319dcc00: shows [Kh Qh] (Pair of Kings)
*** SHOWDOWN ***
Hero collected 68,520 from pot
*** SUMMARY ***
Total pot 68,520 | Rake 0 | Jackpot 0 | Bingo 0 | Fortune 0 | Tax 0
Board [Ks 5h Jd 2s 6c]
Seat 1: b7ffda6e (button) folded before Flop
Seat 2: 353c4ad1 (small blind) folded before Flop
Seat 3: 319dcc00 (big blind) showed [Kh Qh] and lost with Pair of Kings
Seat 4: 45a59c86 folded before Flop
Seat 5: Hero showed [5s 5d] and won (68,520) with Three Fives
Seat 6: 4265169a folded on the Turn
Seat 8: 2924cd3 folded before Flop


Poker Hand #TM3552629873: Tournament #156543396, Bounty Hunters Special $1.08 Hold'em No Limit - Level14(600/1,200) - 2024/08/05 12:02:17
Table '138' 8-max Seat #8 is the button
Seat 1: b7ffda6e (45,880 in chips)
Seat 2: 353c4ad1 (21,794 in chips)
Seat 3: 319dcc00 (122,711 in chips)
Seat 4: 45a59c86 (33,930 in chips)
Seat 5: Hero (55,504 in chips)
Seat 6: 4265169a (63,221 in chips)
Seat 7: ec8ad784 (36,813 in chips)
Seat 8: 2924cd3 (37,092 in chips)
2924cd3: posts the ante 180
ec8ad784: posts the ante 180
4265169a: posts the ante 180
319dcc00: posts the ante 180
353c4ad1: posts the ante 180
b7ffda6e: posts the ante 180
45a59c86: posts the ante 180
Hero: posts the ante 180
b7ffda6e: posts small blind 600
353c4ad1: posts big blind 1,200
*** HOLE CARDS ***
Dealt to b7ffda6e 
Dealt to 353c4ad1 
Dealt to 319dcc00 
Dealt to 45a59c86 
Dealt to Hero [Jd 9d]
Dealt to 4265169a 
Dealt to ec8ad784 
Dealt to 2924cd3 
319dcc00: calls 1,200
45a59c86: folds
Hero: folds
4265169a: raises 3,600 to 4,800
ec8ad784: raises 7,020 to 11,820
2924cd3: folds
b7ffda6e: folds
353c4ad1: folds
319dcc00: folds
4265169a: raises 51,221 to 63,041 and is all-in
ec8ad784: calls 24,813 and is all-in
Uncalled bet (26,408) returned to 4265169a
4265169a: shows [Kc Ah]
ec8ad784: shows [Ac Qh]
*** FLOP *** [8d 7h 4h]
*** TURN *** [8d 7h 4h] [Js]
*** RIVER *** [8d 7h 4h Js] [5s]
*** SHOWDOWN ***
4265169a collected 77,706 from pot
*** SUMMARY ***
Total pot 77,706 | Rake 0 | Jackpot 0 | Bingo 0 | Fortune 0 | Tax 0
Board [8d 7h 4h Js 5s]
Seat 1: b7ffda6e (small blind) folded before Flop
Seat 2: 353c4ad1 (big blind) folded before Flop
Seat 3: 319dcc00 folded before Flop
Seat 4: 45a59c86 folded before Flop
Seat 5: Hero folded before Flop
Seat 6: 4265169a showed [Kc Ah] and won (77,706) with Ace-High
Seat 7: ec8ad784 showed [Ac Qh] and lost with Ace-High
Seat 8: 2924cd3 (button) folded before Flop


Poker Hand #TM3552629848: Tournament #156543396, Bounty Hunters Special $1.08 Hold'em No Limit - Level14(600/1,200) - 2024/08/05 11:54:32
Table '138' 8-max Seat #7 is the button
Seat 1: b7ffda6e (32,620 in chips)
Seat 2: 353c4ad1 (21,974 in chips)
Seat 3: 319dcc00 (122,891 in chips)
Seat 4: 45a59c86 (34,110 in chips)
Seat 5: Hero (58,684 in chips)
Seat 6: 4265169a (66,401 in chips)
Seat 7: ec8ad784 (39,993 in chips)
Seat 8: 2924cd3 (40,272 in chips)
2924cd3: posts the ante 180
ec8ad784: posts the ante 180
4265169a: posts the ante 180
319dcc00: posts the ante 180
353c4ad1: posts the ante 180
b7ffda6e: posts the ante 180
45a59c86: posts the ante 180
Hero: posts the ante 180
2924cd3: posts small blind 600
b7ffda6e: posts big blind 1,200
*** HOLE CARDS ***
Dealt to b7ffda6e 
Dealt to 353c4ad1 
Dealt to 319dcc00 
Dealt to 45a59c86 
Dealt to Hero [9s As]
Dealt to 4265169a 
Dealt to ec8ad784 
Dealt to 2924cd3 
353c4ad1: folds
319dcc00: folds
45a59c86: folds
Hero: raises 1,800 to 3,000
4265169a: calls 3,000
ec8ad784: calls 3,000
2924cd3: calls 2,400
b7ffda6e: raises 29,400 to 32,400
Hero: folds
4265169a: folds
ec8ad784: folds
2924cd3: folds
Uncalled bet (29,400) returned to b7ffda6e
*** SHOWDOWN ***
b7ffda6e collected 16,440 from pot
*** SUMMARY ***
Total pot 16,440 | Rake 0 | Jackpot 0 | Bingo 0 | Fortune 0 | Tax 0
Seat 1: b7ffda6e (big blind) collected (16,440)
Seat 2: 353c4ad1 folded before Flop
Seat 3: 319dcc00 folded before Flop
Seat 4: 45a59c86 folded before Flop
Seat 5: Hero folded before Flop
Seat 6: 4265169a folded before Flop
Seat 7: ec8ad784 (button) folded before Flop
Seat 8: 2924cd3 (small blind) folded before Flop


Poker Hand #TM3552629820: Tournament #156543396, Bounty Hunters Special $1.08 Hold'em No Limit - Level14(600/1,200) - 2024/08/05 11:53:20
Table '138' 8-max Seat #6 is the button
Seat 1: b7ffda6e (32,800 in chips)
Seat 2: 353c4ad1 (22,154 in chips)
Seat 3: 319dcc00 (123,071 in chips)
Seat 4: 45a59c86 (29,850 in chips)
Seat 5: Hero (58,864 in chips)
Seat 6: 4265169a (67,781 in chips)
Seat 7: ec8ad784 (40,773 in chips)
Seat 8: 2924cd3 (41,652 in chips)
2924cd3: posts the ante 180
ec8ad784: posts the ante 180
4265169a: posts the ante 180
319dcc00: posts the ante 180
353c4ad1: posts the ante 180
b7ffda6e: posts the ante 180
45a59c86: posts the ante 180
Hero: posts the ante 180
ec8ad784: posts small blind 600
2924cd3: posts big blind 1,200
*** HOLE CARDS ***
Dealt to b7ffda6e 
Dealt to 353c4ad1 
Dealt to 319dcc00 
Dealt to 45a59c86 
Dealt to Hero [4s 5h]
Dealt to 4265169a 
Dealt to ec8ad784 
Dealt to 2924cd3 
b7ffda6e: folds
353c4ad1: folds
319dcc00: folds
45a59c86: calls 1,200
Hero: folds
4265169a: calls 1,200
ec8ad784: folds
2924cd3: checks
*** FLOP *** [Qd Ac 3c]
2924cd3: checks
45a59c86: checks
4265169a: checks
*** TURN *** [Qd Ac 3c] [Tc]
2924cd3: checks
45a59c86: checks
4265169a: checks
*** RIVER *** [Qd Ac 3c Tc] [3d]
2924cd3: checks
45a59c86: checks
4265169a: checks
2924cd3: shows [9s 7h] (Pair of Treys)
45a59c86: shows [Ah 6h] (Pair of Aces and Pair of Treys)
4265169a: shows [4d Kd] (Pair of Treys)
ec8ad784: shows [Kh 3s] (Three Treys)
*** SHOWDOWN ***
45a59c86 collected 5,640 from pot
*** SUMMARY ***
Total pot 5,640 | Rake 0 | Jackpot 0 | Bingo 0 | Fortune 0 | Tax 0
Board [Qd Ac 3c Tc 3d]
Seat 1: b7ffda6e folded before Flop
Seat 2: 353c4ad1 folded before Flop
Seat 3: 319dcc00 folded before Flop
Seat 4: 45a59c86 showed [Ah 6h] and won (5,640) with Pair of Aces and Pair of Treys
Seat 5: Hero folded before Flop
Seat 6: 4265169a (button) showed [4d Kd] and lost with Pair of Treys
Seat 7: ec8ad784 (small blind) folded before Flop
Seat 8: 2924cd3 (big blind) showed [9s 7h] and lost with Pair of Treys


Poker Hand #TM3552629811: Tournament #156543396, Bounty Hunters Special $1.08 Hold'em No Limit - Level14(600/1,200) - 2024/08/05 11:52:45
Table '138' 8-max Seat #5 is the button
Seat 1: b7ffda6e (32,980 in chips)
Seat 2: 353c4ad1 (22,334 in chips)
Seat 3: 319dcc00 (123,251 in chips)
Seat 4: 45a59c86 (30,030 in chips)
Seat 5: Hero (59,044 in chips)
Seat 6: 4265169a (65,321 in chips)
Seat 7: ec8ad784 (42,153 in chips)
Seat 8: 2924cd3 (41,832 in chips)
2924cd3: posts the ante 180
ec8ad784: posts the ante 180
319dcc00: posts the ante 180
353c4ad1: posts the ante 180
4265169a: posts the ante 180
b7ffda6e: posts the ante 180
45a59c86: posts the ante 180
Hero: posts the ante 180
4265169a: posts small blind 600
ec8ad784: posts big blind 1,200
*** HOLE CARDS ***
Dealt to b7ffda6e 
Dealt to 353c4ad1 
Dealt to 319dcc00 
Dealt to 45a59c86 
Dealt to Hero [7h Qh]
Dealt to 4265169a 
Dealt to ec8ad784 
Dealt to 2924cd3 
2924cd3: folds
b7ffda6e: folds
353c4ad1: folds
319dcc00: folds
45a59c86: folds
Hero: folds
4265169a: raises 1,200 to 2,400
ec8ad784: folds
Uncalled bet (1,200) returned to 4265169a
*** SHOWDOWN ***
4265169a collected 3,840 from pot
*** SUMMARY ***
Total pot 3,840 | Rake 0 | Jackpot 0 | Bingo 0 | Fortune 0 | Tax 0
Seat 1: b7ffda6e folded before Flop
Seat 2: 353c4ad1 folded before Flop
Seat 3: 319dcc00 folded before Flop
Seat 4: 45a59c86 folded before Flop
Seat 5: Hero (button) folded before Flop
Seat 6: 4265169a (small blind) collected (3,840)
Seat 7: ec8ad784 (big blind) folded before Flop
Seat 8: 2924cd3 folded before Flop


Poker Hand #TM3552629804: Tournament #156543396, Bounty Hunters Special $1.08 Hold'em No Limit - Level14(600/1,200) - 2024/08/05 11:52:24
Table '138' 8-max Seat #4 is the button
Seat 1: b7ffda6e (33,160 in chips)
Seat 2: 353c4ad1 (19,274 in chips)
Seat 3: 319dcc00 (123,431 in chips)
Seat 4: 45a59c86 (30,210 in chips)
Seat 5: Hero (59,824 in chips)
Seat 6: 4265169a (66,701 in chips)
Seat 7: ec8ad784 (42,333 in chips)
Seat 8: 2924cd3 (42,012 in chips)
2924cd3: posts the ante 180
ec8ad784: posts the ante 180
319dcc00: posts the ante 180
353c4ad1: posts the ante 180
4265169a: posts the ante 180
b7ffda6e: posts the ante 180
45a59c86: posts the ante 180
Hero: posts the ante 180
Hero: posts small blind 600
4265169a: posts big blind 1,200
*** HOLE CARDS ***
Dealt to b7ffda6e 
Dealt to 353c4ad1 
Dealt to 319dcc00 
Dealt to 45a59c86 
Dealt to Hero [8c 2d]
Dealt to 4265169a 
Dealt to ec8ad784 
Dealt to 2924cd3 
ec8ad784: folds
2924cd3: folds
b7ffda6e: folds
353c4ad1: raises 17,894 to 19,094 and is all-in
319dcc00: folds
45a59c86: folds
Hero: folds
4265169a: folds
Uncalled bet (17,894) returned to 353c4ad1
*** SHOWDOWN ***
353c4ad1 collected 4,440 from pot
*** SUMMARY ***
Total pot 4,440 | Rake 0 | Jackpot 0 | Bingo 0 | Fortune 0 | Tax 0
Seat 1: b7ffda6e folded before Flop
Seat 2: 353c4ad1 collected (4,440)
Seat 3: 319dcc00 folded before Flop
Seat 4: 45a59c86 (button) folded before Flop
Seat 5: Hero (small blind) folded before Flop
Seat 6: 4265169a (big blind) folded before Flop
Seat 7: ec8ad784 folded before Flop
Seat 8: 2924cd3 folded before Flop


Poker Hand #TM3552629791: Tournament #156543396, Bounty Hunters Special $1.08 Hold'em No Limit - Level14(600/1,200) - 2024/08/05 11:51:56
Table '138' 8-max Seat #3 is the button
Seat 1: b7ffda6e (33,340 in chips)
Seat 2: 353c4ad1 (19,454 in chips)
Seat 3: 319dcc00 (123,611 in chips)
Seat 4: 45a59c86 (30,990 in chips)
Seat 5: Hero (61,204 in chips)
Seat 6: 4265169a (66,881 in chips)
Seat 7: ec8ad784 (42,513 in chips)
Seat 8: 2924cd3 (38,952 in chips)
2924cd3: posts the ante 180
ec8ad784: posts the ante 180
319dcc00: posts the ante 180
353c4ad1: posts the ante 180
4265169a: posts the ante 180
b7ffda6e: posts the ante 180
45a59c86: posts the ante 180
Hero: posts the ante 180
45a59c86: posts small blind 600
Hero: posts big blind 1,200
*** HOLE CARDS ***
Dealt to b7ffda6e 
Dealt to 353c4ad1 
Dealt to 319dcc00 
Dealt to 45a59c86 
Dealt to Hero [8c 4d]
Dealt to 4265169a 
Dealt to ec8ad784 
Dealt to 2924cd3 
4265169a: folds
ec8ad784: folds
2924cd3: raises 1,320 to 2,520
b7ffda6e: folds
353c4ad1: folds
319dcc00: folds
45a59c86: folds
Hero: folds
Uncalled bet (1,320) returned to 2924cd3
*** SHOWDOWN ***
2924cd3 collected 4,440 from pot
*** SUMMARY ***
Total pot 4,440 | Rake 0 | Jackpot 0 | Bingo 0 | Fortune 0 | Tax 0
Seat 1: b7ffda6e folded before Flop
Seat 2: 353c4ad1 folded before Flop
Seat 3: 319dcc00 (button) folded before Flop
Seat 4: 45a59c86 (small blind) folded before Flop
Seat 5: Hero (big blind) folded before Flop
Seat 6: 4265169a folded before Flop
Seat 7: ec8ad784 folded before Flop
Seat 8: 2924cd3 collected (4,440)


Poker Hand #TM3552629772: Tournament #156543396, Bounty Hunters Special $1.08 Hold'em No Limit - Level13(500/1,000) - 2024/08/05 11:50:57
Table '138' 8-max Seat #2 is the button
Seat 1: b7ffda6e (39,990 in chips)
Seat 2: 353c4ad1 (19,604 in chips)
Seat 3: 319dcc00 (124,261 in chips)
Seat 4: 45a59c86 (18,740 in chips)
Seat 5: Hero (61,354 in chips)
Seat 6: 4265169a (67,031 in chips)
Seat 7: ec8ad784 (44,763 in chips)
Seat 8: 2924cd3 (41,202 in chips)
2924cd3: posts the ante 150
ec8ad784: posts the ante 150
353c4ad1: posts the ante 150
4265169a: posts the ante 150
319dcc00: posts the ante 150
b7ffda6e: posts the ante 150
45a59c86: posts the ante 150
Hero: posts the ante 150
319dcc00: posts small blind 500
45a59c86: posts big blind 1,000
*** HOLE CARDS ***
Dealt to b7ffda6e 
Dealt to 353c4ad1 
Dealt to 319dcc00 
Dealt to 45a59c86 
Dealt to Hero [3c 4s]
Dealt to 4265169a 
Dealt to ec8ad784 
Dealt to 2924cd3 
Hero: folds
4265169a: folds
ec8ad784: raises 1,100 to 2,100
2924cd3: calls 2,100
b7ffda6e: raises 4,400 to 6,500
353c4ad1: folds
319dcc00: folds
45a59c86: raises 12,090 to 18,590 and is all-in
ec8ad784: folds
2924cd3: folds
b7ffda6e: folds
Uncalled bet (12,090) returned to 45a59c86
*** SHOWDOWN ***
45a59c86 collected 18,900 from pot
*** SUMMARY ***
Total pot 18,900 | Rake 0 | Jackpot 0 | Bingo 0 | Fortune 0 | Tax 0
Seat 1: b7ffda6e folded before Flop
Seat 2: 353c4ad1 (button) folded before Flop
Seat 3: 319dcc00 (small blind) folded before Flop
Seat 4: 45a59c86 (big blind) collected (18,900)
Seat 5: Hero folded before Flop
Seat 6: 4265169a folded before Flop
Seat 7: ec8ad784 folded before Flop
Seat 8: 2924cd3 folded before Flop


Poker Hand #TM3552629763: Tournament #156543396, Bounty Hunters Special $1.08 Hold'em No Limit - Level13(500/1,000) - 2024/08/05 11:50:33
Table '138' 8-max Seat #1 is the button
Seat 1: b7ffda6e (40,140 in chips)
Seat 2: 353c4ad1 (17,554 in chips)
Seat 3: 319dcc00 (125,411 in chips)
Seat 4: 45a59c86 (18,890 in chips)
Seat 5: Hero (61,504 in chips)
Seat 6: 4265169a (67,181 in chips)
Seat 7: ec8ad784 (44,913 in chips)
Seat 8: 2924cd3 (41,352 in chips)
2924cd3: posts the ante 150
ec8ad784: posts the ante 150
4265169a: posts the ante 150
319dcc00: posts the ante 150
353c4ad1: posts the ante 150
b7ffda6e: posts the ante 150
45a59c86: posts the ante 150
Hero: posts the ante 150
353c4ad1: posts small blind 500
319dcc00: posts big blind 1,000
*** HOLE CARDS ***
Dealt to b7ffda6e 
Dealt to 353c4ad1 
Dealt to 319dcc00 
Dealt to 45a59c86 
Dealt to Hero [Qd 8c]
Dealt to 4265169a 
Dealt to ec8ad784 
Dealt to 2924cd3 
45a59c86: folds
Hero: folds
4265169a: folds
ec8ad784: folds
2924cd3: folds
b7ffda6e: folds
353c4ad1: raises 16,404 to 17,404 and is all-in
319dcc00: folds
Uncalled bet (16,404) returned to 353c4ad1
*** SHOWDOWN ***
353c4ad1 collected 3,200 from pot
*** SUMMARY ***
Total pot 3,200 | Rake 0 | Jackpot 0 | Bingo 0 | Fortune 0 | Tax 0
Seat 1: b7ffda6e (button) folded before Flop
Seat 2: 353c4ad1 (small blind) collected (3,200)
Seat 3: 319dcc00 (big blind) folded before Flop
Seat 4: 45a59c86 folded before Flop
Seat 5: Hero folded before Flop
Seat 6: 4265169a folded before Flop
Seat 7: ec8ad784 folded before Flop
Seat 8: 2924cd3 folded before Flop


Poker Hand #TM3552629744: Tournament #156543396, Bounty Hunters Special $1.08 Hold'em No Limit - Level13(500/1,000) - 2024/08/05 11:49:49
Table '138' 8-max Seat #8 is the button
Seat 1: b7ffda6e (40,790 in chips)
Seat 2: 353c4ad1 (12,453 in chips)
Seat 3: 319dcc00 (125,561 in chips)
Seat 4: 45a59c86 (19,040 in chips)
Seat 5: Hero (61,654 in chips)
Seat 6: 4265169a (68,331 in chips)
Seat 7: ec8ad784 (45,063 in chips)
Seat 8: 2924cd3 (44,053 in chips)
2924cd3: posts the ante 150
ec8ad784: posts the ante 150
4265169a: posts the ante 150
319dcc00: posts the ante 150
353c4ad1: posts the ante 150
b7ffda6e: posts the ante 150
45a59c86: posts the ante 150
Hero: posts the ante 150
b7ffda6e: posts small blind 500
353c4ad1: posts big blind 1,000
*** HOLE CARDS ***
Dealt to b7ffda6e 
Dealt to 353c4ad1 
Dealt to 319dcc00 
Dealt to 45a59c86 
Dealt to Hero [7c 3h]
Dealt to 4265169a 
Dealt to ec8ad784 
Dealt to 2924cd3 
319dcc00: folds
45a59c86: folds
Hero: folds
4265169a: calls 1,000
ec8ad784: folds
2924cd3: raises 1,551 to 2,551
b7ffda6e: folds
353c4ad1: raises 9,752 to 12,303 and is all-in
4265169a: folds
2924cd3: folds
Uncalled bet (9,752) returned to 353c4ad1
*** SHOWDOWN ***
353c4ad1 collected 7,802 from pot
*** SUMMARY ***
Total pot 7,802 | Rake 0 | Jackpot 0 | Bingo 0 | Fortune 0 | Tax 0
Seat 1: b7ffda6e (small blind) folded before Flop
Seat 2: 353c4ad1 (big blind) collected (7,802)
Seat 3: 319dcc00 folded before Flop
Seat 4: 45a59c86 folded before Flop
Seat 5: Hero folded before Flop
Seat 6: 4265169a folded before Flop
Seat 7: ec8ad784 folded before Flop
Seat 8: 2924cd3 (button) folded before Flop


Poker Hand #TM3552629723: Tournament #156543396, Bounty Hunters Special $1.08 Hold'em No Limit - Level13(500/1,000) - 2024/08/05 11:48:46
Table '138' 8-max Seat #6 is the button
Seat 1: b7ffda6e (41,940 in chips)
Seat 2: 353c4ad1 (12,603 in chips)
Seat 3: 319dcc00 (126,711 in chips)
Seat 4: 45a59c86 (14,640 in chips)
Seat 5: Hero (62,804 in chips)
Seat 6: 4265169a (68,481 in chips)
Seat 8: 2924cd3 (44,703 in chips)
2924cd3: posts the ante 150
4265169a: posts the ante 150
319dcc00: posts the ante 150
353c4ad1: posts the ante 150
b7ffda6e: posts the ante 150
45a59c86: posts the ante 150
Hero: posts the ante 150
2924cd3: posts small blind 500
b7ffda6e: posts big blind 1,000
*** HOLE CARDS ***
Dealt to b7ffda6e 
Dealt to 353c4ad1 
Dealt to 319dcc00 
Dealt to 45a59c86 
Dealt to Hero [Ah Jd]
Dealt to 4265169a 
Dealt to 2924cd3 
353c4ad1: folds
319dcc00: calls 1,000
45a59c86: calls 1,000
Hero: calls 1,000
4265169a: folds
2924cd3: folds
b7ffda6e: checks
*** FLOP *** [2h 8s 9d]
b7ffda6e: checks
319dcc00: checks
45a59c86: checks
Hero: checks
*** TURN *** [2h 8s 9d] [4s]
b7ffda6e: checks
319dcc00: checks
45a59c86: checks
Hero: checks
*** RIVER *** [2h 8s 9d 4s] [Qc]
b7ffda6e: checks
319dcc00: checks
45a59c86: bets 4,000
Hero: folds
b7ffda6e: folds
319dcc00: folds
Uncalled bet (4,000) returned to 45a59c86
*** SHOWDOWN ***
45a59c86 collected 5,550 from pot
*** SUMMARY ***
Total pot 5,550 | Rake 0 | Jackpot 0 | Bingo 0 | Fortune 0 | Tax 0
Board [2h 8s 9d 4s Qc]
Seat 1: b7ffda6e (big blind) folded on the River
Seat 2: 353c4ad1 folded before Flop
Seat 3: 319dcc00 folded on the River
Seat 4: 45a59c86 won (5,550)
Seat 5: Hero folded on the River
Seat 6: 4265169a (button) folded before Flop
Seat 8: 2924cd3 (small blind) folded before Flop


Poker Hand #TM3552502007: Tournament #156543396, Bounty Hunters Special $1.08 Hold'em No Limit - Level13(500/1,000) - 2024/08/05 11:45:56
Table '140' 8-max Seat #7 is the button
Seat 1: be03606d (52,579 in chips)
Seat 2: 4ed4da92 (29,103 in chips)
Seat 3: 7887656d (49,069 in chips)
Seat 4: 8b7ef6a5 (7,220 in chips)
Seat 5: 22817cfe (54,369 in chips)
Seat 7: Hero (70,024 in chips)
Seat 8: 8afec004 (9,100 in chips)
22817cfe: posts the ante 150
8afec004: posts the ante 150
8b7ef6a5: posts the ante 150
be03606d: posts the ante 150
7887656d: posts the ante 150
Hero: posts the ante 150
4ed4da92: posts the ante 150
8afec004: posts small blind 500
be03606d: posts big blind 1,000
*** HOLE CARDS ***
Dealt to be03606d 
Dealt to 4ed4da92 
Dealt to 7887656d 
Dealt to 8b7ef6a5 
Dealt to 22817cfe 
Dealt to Hero [8h 9h]
Dealt to 8afec004 
4ed4da92: raises 1,000 to 2,000
7887656d: folds
8b7ef6a5: raises 5,070 to 7,070 and is all-in
22817cfe: folds
Hero: calls 7,070
8afec004: raises 1,880 to 8,950 and is all-in
be03606d: raises 43,479 to 52,429 and is all-in
4ed4da92: folds
Hero: folds
Uncalled bet (43,479) returned to be03606d
be03606d: shows [Qc Qs]
8b7ef6a5: shows [8s 7d]
8afec004: shows [9c 9s]
*** FLOP *** [9d Qd 3d]
*** TURN *** [9d Qd 3d] [6s]
*** RIVER *** [9d Qd 3d 6s] [7s]
Hero: shows [8h 9h] (Pair of Nines)
*** SHOWDOWN ***
be03606d collected 31,330 from pot
be03606d collected 3,760 from pot
*** SUMMARY ***
Total pot 35,090 | Rake 0 | Jackpot 0 | Bingo 0 | Fortune 0 | Tax 0
Board [9d Qd 3d 6s 7s]
Seat 1: be03606d (big blind) showed [Qc Qs] and won (35,090) with Three Queens
Seat 2: 4ed4da92 folded before Flop
Seat 3: 7887656d folded before Flop
Seat 4: 8b7ef6a5 showed [8s 7d] and lost with Pair of Sevens
Seat 5: 22817cfe folded before Flop
Seat 7: Hero (button) folded before Flop
Seat 8: 8afec004 (small blind) showed [9c 9s] and lost with Three Nines


Poker Hand #TM3552501973: Tournament #156543396, Bounty Hunters Special $1.08 Hold'em No Limit - Level13(500/1,000) - 2024/08/05 11:44:49
Table '140' 8-max Seat #6 is the button
Seat 1: be03606d (52,729 in chips)
Seat 2: 4ed4da92 (29,253 in chips)
Seat 3: 7887656d (56,858 in chips)
Seat 4: 8b7ef6a5 (7,370 in chips)
Seat 5: 22817cfe (34,184 in chips)
Seat 6: faec6805 (3,007 in chips)
Seat 7: Hero (77,813 in chips)
Seat 8: 8afec004 (10,250 in chips)
faec6805: posts the ante 150
22817cfe: posts the ante 150
8afec004: posts the ante 150
8b7ef6a5: posts the ante 150
be03606d: posts the ante 150
7887656d: posts the ante 150
4ed4da92: posts the ante 150
Hero: posts the ante 150
Hero: posts small blind 500
8afec004: posts big blind 1,000
*** HOLE CARDS ***
Dealt to be03606d 
Dealt to 4ed4da92 
Dealt to 7887656d 
Dealt to 8b7ef6a5 
Dealt to 22817cfe 
Dealt to faec6805 
Dealt to Hero [8d Tc]
Dealt to 8afec004 
be03606d: folds
4ed4da92: folds
7887656d: calls 1,000
8b7ef6a5: folds
22817cfe: raises 2,000 to 3,000
faec6805: calls 2,857 and is all-in
Hero: calls 2,500
8afec004: folds
7887656d: calls 2,000
*** FLOP *** [Qd 5h Td]
Hero: bets 4,639
7887656d: calls 4,639
22817cfe: raises 26,395 to 31,034 and is all-in
Hero: folds
7887656d: folds
Uncalled bet (26,395) returned to 22817cfe
22817cfe: shows [Jd Kd] (King-High)
faec6805: shows [9s Jh] (Queen-High)
*** TURN *** [Qd 5h Td] [6c]
*** RIVER *** [Qd 5h Td 6c] [9c]
Hero: shows [Tc] (Pair of Tens)
*** SHOWDOWN ***
22817cfe collected 13,628 from pot
22817cfe collected 14,346 from pot
*** SUMMARY ***
Total pot 27,974 | Rake 0 | Jackpot 0 | Bingo 0 | Fortune 0 | Tax 0
Board [Qd 5h Td 6c 9c]
Seat 1: be03606d folded before Flop
Seat 2: 4ed4da92 folded before Flop
Seat 3: 7887656d folded on the Flop
Seat 4: 8b7ef6a5 folded before Flop
Seat 5: 22817cfe showed [Jd Kd] and won (27,974) with Kings-High Straight
Seat 6: faec6805 (button) showed [9s Jh] and lost with Pair of Nines
Seat 7: Hero (small blind) folded on the Flop
Seat 8: 8afec004 (big blind) folded before Flop


Poker Hand #TM3552501949: Tournament #156543396, Bounty Hunters Special $1.08 Hold'em No Limit - Level13(500/1,000) - 2024/08/05 11:44:00
Table '140' 8-max Seat #5 is the button
Seat 1: be03606d (52,879 in chips)
Seat 2: 4ed4da92 (29,403 in chips)
Seat 3: 7887656d (57,008 in chips)
Seat 4: 8b7ef6a5 (7,520 in chips)
Seat 5: 22817cfe (34,334 in chips)
Seat 6: faec6805 (2,757 in chips)
Seat 7: Hero (77,563 in chips)
Seat 8: 8afec004 (10,000 in chips)
faec6805: posts the ante 150
22817cfe: posts the ante 150
8afec004: posts the ante 150
8b7ef6a5: posts the ante 150
be03606d: posts the ante 150
7887656d: posts the ante 150
4ed4da92: posts the ante 150
Hero: posts the ante 150
faec6805: posts small blind 500
Hero: posts big blind 1,000
*** HOLE CARDS ***
Dealt to be03606d 
Dealt to 4ed4da92 
Dealt to 7887656d 
Dealt to 8b7ef6a5 
Dealt to 22817cfe 
Dealt to faec6805 
Dealt to Hero [6s Qd]
Dealt to 8afec004 
8afec004: raises 8,850 to 9,850 and is all-in
be03606d: folds
4ed4da92: folds
7887656d: folds
8b7ef6a5: folds
22817cfe: folds
faec6805: calls 2,107 and is all-in
Hero: calls 8,850
8afec004: shows [Qc 6c]
faec6805: shows [Ks Jc]
Hero: shows [6s Qd]
*** FLOP *** [Ts 5c Tc]
*** TURN *** [Ts 5c Tc] [5d]
*** RIVER *** [Ts 5c Tc 5d] [As]
*** SHOWDOWN ***
Hero collected 3,007 from pot
8afec004 collected 3,007 from pot
faec6805 collected 3,007 from pot
Hero collected 7,243 from pot
8afec004 collected 7,243 from pot
*** SUMMARY ***
Total pot 23,507 | Rake 0 | Jackpot 0 | Bingo 0 | Fortune 0 | Tax 0
Board [Ts 5c Tc 5d As]
Seat 1: be03606d folded before Flop
Seat 2: 4ed4da92 folded before Flop
Seat 3: 7887656d folded before Flop
Seat 4: 8b7ef6a5 folded before Flop
Seat 5: 22817cfe (button) folded before Flop
Seat 6: faec6805 (small blind) showed [Ks Jc] and won (3,007) with Pair of Tens and Pair of Fives
Seat 7: Hero (big blind) showed [6s Qd] and won (10,250) with Pair of Tens and Pair of Fives
Seat 8: 8afec004 showed [Qc 6c] and won (10,250) with Pair of Tens and Pair of Fives


Poker Hand #TM3552501934: Tournament #156543396, Bounty Hunters Special $1.08 Hold'em No Limit - Level12(400/800) - 2024/08/05 11:43:27
Table '140' 8-max Seat #4 is the button
Seat 1: be03606d (52,999 in chips)
Seat 2: 4ed4da92 (29,523 in chips)
Seat 3: 7887656d (57,128 in chips)
Seat 4: 8b7ef6a5 (7,640 in chips)
Seat 5: 22817cfe (34,854 in chips)
Seat 6: faec6805 (1,637 in chips)
Seat 7: Hero (77,683 in chips)
faec6805: posts the ante 120
22817cfe: posts the ante 120
8b7ef6a5: posts the ante 120
be03606d: posts the ante 120
7887656d: posts the ante 120
4ed4da92: posts the ante 120
Hero: posts the ante 120
22817cfe: posts small blind 400
faec6805: posts big blind 800
*** HOLE CARDS ***
Dealt to be03606d 
Dealt to 4ed4da92 
Dealt to 7887656d 
Dealt to 8b7ef6a5 
Dealt to 22817cfe 
Dealt to faec6805 
Dealt to Hero [2s 7h]
Hero: folds
be03606d: folds
4ed4da92: folds
7887656d: folds
8b7ef6a5: folds
22817cfe: folds
Uncalled bet (400) returned to faec6805
*** SHOWDOWN ***
faec6805 collected 1,640 from pot
*** SUMMARY ***
Total pot 1,640 | Rake 0 | Jackpot 0 | Bingo 0 | Fortune 0 | Tax 0
Seat 1: be03606d folded before Flop
Seat 2: 4ed4da92 folded before Flop
Seat 3: 7887656d folded before Flop
Seat 4: 8b7ef6a5 (button) folded before Flop
Seat 5: 22817cfe (small blind) folded before Flop
Seat 6: faec6805 (big blind) collected (1,640)
Seat 7: Hero folded before Flop


Poker Hand #TM3552501905: Tournament #156543396, Bounty Hunters Special $1.08 Hold'em No Limit - Level12(400/800) - 2024/08/05 11:42:27
Table '140' 8-max Seat #3 is the button
Seat 1: be03606d (53,119 in chips)
Seat 2: 4ed4da92 (29,643 in chips)
Seat 3: 7887656d (57,248 in chips)
Seat 4: 8b7ef6a5 (8,160 in chips)
Seat 5: 22817cfe (35,774 in chips)
Seat 6: faec6805 (1,757 in chips)
Seat 7: Hero (67,847 in chips)
Seat 8: 7cdddcd (7,916 in chips)
faec6805: posts the ante 120
22817cfe: posts the ante 120
be03606d: posts the ante 120
8b7ef6a5: posts the ante 120
7887656d: posts the ante 120
7cdddcd: posts the ante 120
4ed4da92: posts the ante 120
Hero: posts the ante 120
8b7ef6a5: posts small blind 400
22817cfe: posts big blind 800
*** HOLE CARDS ***
Dealt to be03606d 
Dealt to 4ed4da92 
Dealt to 7887656d 
Dealt to 8b7ef6a5 
Dealt to 22817cfe 
Dealt to faec6805 
Dealt to Hero [Qc Ah]
Dealt to 7cdddcd 
faec6805: folds
Hero: calls 800
7cdddcd: raises 6,996 to 7,796 and is all-in
be03606d: folds
4ed4da92: folds
7887656d: folds
8b7ef6a5: folds
22817cfe: folds
Hero: calls 6,996
7cdddcd: shows [Js As]
Hero: shows [Qc Ah]
*** FLOP *** [6c 2h 8d]
*** TURN *** [6c 2h 8d] [Ts]
*** RIVER *** [6c 2h 8d Ts] [5s]
8b7ef6a5: shows [8h Ac] (Pair of Eights)
be03606d: shows [8c] (Pair of Eights)
*** SHOWDOWN ***
Hero collected 17,752 from pot
*** SUMMARY ***
Total pot 17,752 | Rake 0 | Jackpot 0 | Bingo 0 | Fortune 0 | Tax 0
Board [6c 2h 8d Ts 5s]
Seat 1: be03606d folded before Flop
Seat 2: 4ed4da92 folded before Flop
Seat 3: 7887656d (button) folded before Flop
Seat 4: 8b7ef6a5 (small blind) folded before Flop
Seat 5: 22817cfe (big blind) folded before Flop
Seat 6: faec6805 folded before Flop
Seat 7: Hero showed [Qc Ah] and won (17,752) with Ace-High
Seat 8: 7cdddcd showed [Js As] and lost with Ace-High


Poker Hand #TM3552501884: Tournament #156543396, Bounty Hunters Special $1.08 Hold'em No Limit - Level12(400/800) - 2024/08/05 11:41:54
Table '140' 8-max Seat #2 is the button
Seat 1: be03606d (54,839 in chips)
Seat 2: 4ed4da92 (29,763 in chips)
Seat 3: 7887656d (57,768 in chips)
Seat 4: 8b7ef6a5 (9,880 in chips)
Seat 5: 22817cfe (31,334 in chips)
Seat 6: faec6805 (1,877 in chips)
Seat 7: Hero (67,967 in chips)
Seat 8: 7cdddcd (8,036 in chips)
faec6805: posts the ante 120
22817cfe: posts the ante 120
be03606d: posts the ante 120
8b7ef6a5: posts the ante 120
7887656d: posts the ante 120
7cdddcd: posts the ante 120
4ed4da92: posts the ante 120
Hero: posts the ante 120
7887656d: posts small blind 400
8b7ef6a5: posts big blind 800
*** HOLE CARDS ***
Dealt to be03606d 
Dealt to 4ed4da92 
Dealt to 7887656d 
Dealt to 8b7ef6a5 
Dealt to 22817cfe 
Dealt to faec6805 
Dealt to Hero [3s 5c]
Dealt to 7cdddcd 
22817cfe: raises 800 to 1,600
faec6805: folds
Hero: folds
7cdddcd: folds
be03606d: calls 1,600
4ed4da92: folds
7887656d: folds
8b7ef6a5: calls 800
*** FLOP *** [4s Qc Ad]
8b7ef6a5: checks
22817cfe: bets 2,033
be03606d: folds
8b7ef6a5: folds
Uncalled bet (2,033) returned to 22817cfe
*** SHOWDOWN ***
22817cfe collected 6,160 from pot
*** SUMMARY ***
Total pot 6,160 | Rake 0 | Jackpot 0 | Bingo 0 | Fortune 0 | Tax 0
Board [4s Qc Ad]
Seat 1: be03606d folded on the Flop
Seat 2: 4ed4da92 (button) folded before Flop
Seat 3: 7887656d (small blind) folded before Flop
Seat 4: 8b7ef6a5 (big blind) folded on the Flop
Seat 5: 22817cfe won (6,160)
Seat 6: faec6805 folded before Flop
Seat 7: Hero folded before Flop
Seat 8: 7cdddcd folded before Flop


Poker Hand #TM3552501844: Tournament #156543396, Bounty Hunters Special $1.08 Hold'em No Limit - Level12(400/800) - 2024/08/05 11:40:46
Table '140' 8-max Seat #1 is the button
Seat 1: be03606d (54,959 in chips)
Seat 2: 4ed4da92 (30,283 in chips)
Seat 3: 7887656d (59,488 in chips)
Seat 4: 8b7ef6a5 (10,000 in chips)
Seat 5: 22817cfe (28,494 in chips)
Seat 6: faec6805 (1,997 in chips)
Seat 7: Hero (68,087 in chips)
Seat 8: 7cdddcd (8,156 in chips)
faec6805: posts the ante 120
22817cfe: posts the ante 120
be03606d: posts the ante 120
8b7ef6a5: posts the ante 120
7887656d: posts the ante 120
7cdddcd: posts the ante 120
Hero: posts the ante 120
4ed4da92: posts the ante 120
4ed4da92: posts small blind 400
7887656d: posts big blind 800
*** HOLE CARDS ***
Dealt to be03606d 
Dealt to 4ed4da92 
Dealt to 7887656d 
Dealt to 8b7ef6a5 
Dealt to 22817cfe 
Dealt to faec6805 
Dealt to Hero [6s 7d]
Dealt to 7cdddcd 
8b7ef6a5: folds
22817cfe: raises 800 to 1,600
faec6805: folds
Hero: folds
7cdddcd: folds
be03606d: folds
4ed4da92: folds
7887656d: calls 800
*** FLOP *** [5s Qd Qs]
7887656d: checks
22817cfe: bets 1,505
7887656d: folds
Uncalled bet (1,505) returned to 22817cfe
*** SHOWDOWN ***
22817cfe collected 4,560 from pot
*** SUMMARY ***
Total pot 4,560 | Rake 0 | Jackpot 0 | Bingo 0 | Fortune 0 | Tax 0
Board [5s Qd Qs]
Seat 1: be03606d (button) folded before Flop
Seat 2: 4ed4da92 (small blind) folded before Flop
Seat 3: 7887656d (big blind) folded on the Flop
Seat 4: 8b7ef6a5 folded before Flop
Seat 5: 22817cfe won (4,560)
Seat 6: faec6805 folded before Flop
Seat 7: Hero folded before Flop
Seat 8: 7cdddcd folded before Flop


Poker Hand #TM3552501800: Tournament #156543396, Bounty Hunters Special $1.08 Hold'em No Limit - Level12(400/800) - 2024/08/05 11:39:27
Table '140' 8-max Seat #8 is the button
Seat 1: be03606d (62,319 in chips)
Seat 2: 4ed4da92 (20,723 in chips)
Seat 3: 7887656d (59,608 in chips)
Seat 5: 22817cfe (28,614 in chips)
Seat 6: faec6805 (2,117 in chips)
Seat 7: Hero (69,807 in chips)
Seat 8: 7cdddcd (8,276 in chips)
faec6805: posts the ante 120
22817cfe: posts the ante 120
be03606d: posts the ante 120
7887656d: posts the ante 120
7cdddcd: posts the ante 120
Hero: posts the ante 120
4ed4da92: posts the ante 120
be03606d: posts small blind 400
4ed4da92: posts big blind 800
*** HOLE CARDS ***
Dealt to be03606d 
Dealt to 4ed4da92 
Dealt to 7887656d 
Dealt to 22817cfe 
Dealt to faec6805 
Dealt to Hero [8s 6s]
Dealt to 7cdddcd 
7887656d: folds
22817cfe: folds
faec6805: folds
Hero: raises 800 to 1,600
7cdddcd: folds
be03606d: calls 1,200
4ed4da92: raises 5,640 to 7,240
Hero: folds
be03606d: calls 5,640
*** FLOP *** [Td Tc Th]
be03606d: checks
4ed4da92: bets 13,363 and is all-in
be03606d: folds
Uncalled bet (13,363) returned to 4ed4da92
*** SHOWDOWN ***
4ed4da92 collected 16,920 from pot
*** SUMMARY ***
Total pot 16,920 | Rake 0 | Jackpot 0 | Bingo 0 | Fortune 0 | Tax 0
Board [Td Tc Th]
Seat 1: be03606d (small blind) folded on the Flop
Seat 2: 4ed4da92 (big blind) won (16,920)
Seat 3: 7887656d folded before Flop
Seat 5: 22817cfe folded before Flop
Seat 6: faec6805 folded before Flop
Seat 7: Hero folded before Flop
Seat 8: 7cdddcd (button) folded before Flop


Poker Hand #TM3552363236: Tournament #156543396, Bounty Hunters Special $1.08 Hold'em No Limit - Level12(400/800) - 2024/08/05 11:38:21
Table '119' 8-max Seat #1 is the button
Seat 1: efff41bc (25,209 in chips)
Seat 2: 516045fd (35,923 in chips)
Seat 3: f97c269e (27,086 in chips)
Seat 4: 10438ff8 (42,232 in chips)
Seat 5: 8e2803b9 (61,050 in chips)
Seat 6: 992f7aa2 (27,866 in chips)
Seat 7: Hero (69,927 in chips)
f97c269e: posts the ante 120
8e2803b9: posts the ante 120
10438ff8: posts the ante 120
efff41bc: posts the ante 120
516045fd: posts the ante 120
992f7aa2: posts the ante 120
Hero: posts the ante 120
516045fd: posts small blind 400
f97c269e: posts big blind 800
*** HOLE CARDS ***
Dealt to efff41bc 
Dealt to 516045fd 
Dealt to f97c269e 
Dealt to 10438ff8 
Dealt to 8e2803b9 
Dealt to 992f7aa2 
Dealt to Hero [2d 8s]
10438ff8: folds
8e2803b9: raises 800 to 1,600
992f7aa2: raises 1,730 to 3,330
Hero: folds
efff41bc: calls 3,330
516045fd: folds
f97c269e: folds
8e2803b9: calls 1,730
*** FLOP *** [7c 2s Kd]
8e2803b9: checks
992f7aa2: checks
efff41bc: bets 3,970
8e2803b9: raises 8,388 to 12,358
992f7aa2: folds
efff41bc: folds
Uncalled bet (8,388) returned to 8e2803b9
*** SHOWDOWN ***
8e2803b9 collected 19,970 from pot
*** SUMMARY ***
Total pot 19,970 | Rake 0 | Jackpot 0 | Bingo 0 | Fortune 0 | Tax 0
Board [7c 2s Kd]
Seat 1: efff41bc (button) folded on the Flop
Seat 2: 516045fd (small blind) folded before Flop
Seat 3: f97c269e (big blind) folded before Flop
Seat 4: 10438ff8 folded before Flop
Seat 5: 8e2803b9 won (19,970)
Seat 6: 992f7aa2 folded on the Flop
Seat 7: Hero folded before Flop


Poker Hand #TM3552363215: Tournament #156543396, Bounty Hunters Special $1.08 Hold'em No Limit - Level12(400/800) - 2024/08/05 11:37:25
Table '119' 8-max Seat #7 is the button
Seat 1: efff41bc (26,129 in chips)
Seat 2: 516045fd (36,043 in chips)
Seat 3: f97c269e (27,206 in chips)
Seat 4: 10438ff8 (42,352 in chips)
Seat 5: 8e2803b9 (61,170 in chips)
Seat 6: 992f7aa2 (27,986 in chips)
Seat 7: Hero (53,749 in chips)
Seat 8: 49163000 (14,658 in chips)
f97c269e: posts the ante 120
8e2803b9: posts the ante 120
49163000: posts the ante 120
10438ff8: posts the ante 120
516045fd: posts the ante 120
efff41bc: posts the ante 120
992f7aa2: posts the ante 120
Hero: posts the ante 120
49163000: posts small blind 400
efff41bc: posts big blind 800
*** HOLE CARDS ***
Dealt to efff41bc 
Dealt to 516045fd 
Dealt to f97c269e 
Dealt to 10438ff8 
Dealt to 8e2803b9 
Dealt to 992f7aa2 
Dealt to Hero [6s As]
Dealt to 49163000 
516045fd: folds
f97c269e: folds
10438ff8: folds
8e2803b9: folds
992f7aa2: folds
Hero: raises 800 to 1,600
49163000: raises 12,938 to 14,538 and is all-in
efff41bc: folds
Hero: calls 12,938
49163000: shows [Ts Kc]
Hero: shows [6s As]
*** FLOP *** [7d Ac 7h]
*** TURN *** [7d Ac 7h] [7s]
*** RIVER *** [7d Ac 7h 7s] [6c]
*** SHOWDOWN ***
Hero collected 30,836 from pot
*** SUMMARY ***
Total pot 30,836 | Rake 0 | Jackpot 0 | Bingo 0 | Fortune 0 | Tax 0
Board [7d Ac 7h 7s 6c]
Seat 1: efff41bc (big blind) folded before Flop
Seat 2: 516045fd folded before Flop
Seat 3: f97c269e folded before Flop
Seat 4: 10438ff8 folded before Flop
Seat 5: 8e2803b9 folded before Flop
Seat 6: 992f7aa2 folded before Flop
Seat 7: Hero (button) showed [6s As] and won (30,836) with Sevens Full over Aces
Seat 8: 49163000 (small blind) showed [Ts Kc] and lost with Three Sevens


Poker Hand #TM3552363193: Tournament #156543396, Bounty Hunters Special $1.08 Hold'em No Limit - Level12(400/800) - 2024/08/05 11:36:19
Table '119' 8-max Seat #6 is the button
Seat 1: efff41bc (26,249 in chips)
Seat 2: 516045fd (36,163 in chips)
Seat 3: f97c269e (29,235 in chips)
Seat 4: 10438ff8 (42,472 in chips)
Seat 5: 8e2803b9 (61,290 in chips)
Seat 6: 992f7aa2 (28,106 in chips)
Seat 7: Hero (55,778 in chips)
Seat 8: 49163000 (10,000 in chips)
f97c269e: posts the ante 120
8e2803b9: posts the ante 120
49163000: posts the ante 120
10438ff8: posts the ante 120
516045fd: posts the ante 120
efff41bc: posts the ante 120
992f7aa2: posts the ante 120
Hero: posts the ante 120
Hero: posts small blind 400
49163000: posts big blind 800
*** HOLE CARDS ***
Dealt to efff41bc 
Dealt to 516045fd 
Dealt to f97c269e 
Dealt to 10438ff8 
Dealt to 8e2803b9 
Dealt to 992f7aa2 
Dealt to Hero [Qh Th]
Dealt to 49163000 
efff41bc: folds
516045fd: folds
f97c269e: calls 800
10438ff8: folds
8e2803b9: folds
992f7aa2: folds
Hero: calls 400
49163000: checks
*** FLOP *** [4c 4h 7c]
Hero: checks
49163000: checks
f97c269e: checks
*** TURN *** [4c 4h 7c] [3h]
Hero: checks
49163000: bets 1,109
f97c269e: calls 1,109
Hero: calls 1,109
*** RIVER *** [4c 4h 7c 3h] [7s]
Hero: checks
49163000: bets 7,971 and is all-in
f97c269e: folds
Hero: folds
Uncalled bet (7,971) returned to 49163000
*** SHOWDOWN ***
49163000 collected 6,687 from pot
*** SUMMARY ***
Total pot 6,687 | Rake 0 | Jackpot 0 | Bingo 0 | Fortune 0 | Tax 0
Board [4c 4h 7c 3h 7s]
Seat 1: efff41bc folded before Flop
Seat 2: 516045fd folded before Flop
Seat 3: f97c269e folded on the River
Seat 4: 10438ff8 folded before Flop
Seat 5: 8e2803b9 folded before Flop
Seat 6: 992f7aa2 (button) folded before Flop
Seat 7: Hero (small blind) folded on the River
Seat 8: 49163000 (big blind) won (6,687)


Poker Hand #TM3552363165: Tournament #156543396, Bounty Hunters Special $1.08 Hold'em No Limit - Level12(400/800) - 2024/08/05 11:35:15
Table '119' 8-max Seat #5 is the button
Seat 1: efff41bc (27,969 in chips)
Seat 2: 516045fd (36,283 in chips)
Seat 3: f97c269e (30,955 in chips)
Seat 4: 10438ff8 (42,592 in chips)
Seat 5: 8e2803b9 (63,010 in chips)
Seat 6: 992f7aa2 (28,626 in chips)
Seat 7: Hero (49,858 in chips)
f97c269e: posts the ante 120
8e2803b9: posts the ante 120
10438ff8: posts the ante 120
516045fd: posts the ante 120
efff41bc: posts the ante 120
992f7aa2: posts the ante 120
Hero: posts the ante 120
992f7aa2: posts small blind 400
Hero: posts big blind 800
*** HOLE CARDS ***
Dealt to efff41bc 
Dealt to 516045fd 
Dealt to f97c269e 
Dealt to 10438ff8 
Dealt to 8e2803b9 
Dealt to 992f7aa2 
Dealt to Hero [3h 4d]
efff41bc: calls 800
516045fd: folds
f97c269e: raises 800 to 1,600
10438ff8: folds
8e2803b9: calls 1,600
992f7aa2: folds
Hero: calls 800
efff41bc: calls 800
*** FLOP *** [Kd 5h 2c]
Hero: checks
efff41bc: checks
f97c269e: checks
8e2803b9: checks
*** TURN *** [Kd 5h 2c] [5d]
Hero: bets 2,522
efff41bc: folds
f97c269e: folds
8e2803b9: folds
Uncalled bet (2,522) returned to Hero
*** SHOWDOWN ***
Hero collected 7,640 from pot
*** SUMMARY ***
Total pot 7,640 | Rake 0 | Jackpot 0 | Bingo 0 | Fortune 0 | Tax 0
Board [Kd 5h 2c 5d]
Seat 1: efff41bc folded on the Turn
Seat 2: 516045fd folded before Flop
Seat 3: f97c269e folded on the Turn
Seat 4: 10438ff8 folded before Flop
Seat 5: 8e2803b9 (button) folded on the Turn
Seat 6: 992f7aa2 (small blind) folded before Flop
Seat 7: Hero (big blind) won (7,640)


Poker Hand #TM3552363137: Tournament #156543396, Bounty Hunters Special $1.08 Hold'em No Limit - Level12(400/800) - 2024/08/05 11:34:16
Table '119' 8-max Seat #4 is the button
Seat 1: efff41bc (28,089 in chips)
Seat 2: 516045fd (36,403 in chips)
Seat 3: f97c269e (31,075 in chips)
Seat 4: 10438ff8 (42,712 in chips)
Seat 5: 8e2803b9 (51,490 in chips)
Seat 6: 992f7aa2 (29,546 in chips)
Seat 7: Hero (49,978 in chips)
Seat 8: e859c7eb (10,000 in chips)
f97c269e: posts the ante 120
8e2803b9: posts the ante 120
e859c7eb: posts the ante 120
10438ff8: posts the ante 120
516045fd: posts the ante 120
efff41bc: posts the ante 120
992f7aa2: posts the ante 120
Hero: posts the ante 120
8e2803b9: posts small blind 400
992f7aa2: posts big blind 800
*** HOLE CARDS ***
Dealt to efff41bc 
Dealt to 516045fd 
Dealt to f97c269e 
Dealt to 10438ff8 
Dealt to 8e2803b9 
Dealt to 992f7aa2 
Dealt to Hero [4s 8h]
Dealt to e859c7eb 
Hero: folds
e859c7eb: raises 2,400 to 3,200
efff41bc: folds
516045fd: folds
f97c269e: folds
10438ff8: folds
8e2803b9: raises 48,170 to 51,370 and is all-in
992f7aa2: folds
e859c7eb: calls 6,680 and is all-in
Uncalled bet (41,490) returned to 8e2803b9
8e2803b9: shows [9c As]
e859c7eb: shows [Ah Kh]
*** FLOP *** [Th 3d 9s]
*** TURN *** [Th 3d 9s] [9h]
*** RIVER *** [Th 3d 9s 9h] [6c]
*** SHOWDOWN ***
8e2803b9 collected 21,520 from pot
*** SUMMARY ***
Total pot 21,520 | Rake 0 | Jackpot 0 | Bingo 0 | Fortune 0 | Tax 0
Board [Th 3d 9s 9h 6c]
Seat 1: efff41bc folded before Flop
Seat 2: 516045fd folded before Flop
Seat 3: f97c269e folded before Flop
Seat 4: 10438ff8 (button) folded before Flop
Seat 5: 8e2803b9 (small blind) showed [9c As] and won (21,520) with Three Nines
Seat 6: 992f7aa2 (big blind) folded before Flop
Seat 7: Hero folded before Flop
Seat 8: e859c7eb showed [Ah Kh] and lost with Pair of Nines


Poker Hand #TM3552363127: Tournament #156543396, Bounty Hunters Special $1.08 Hold'em No Limit - Level12(400/800) - 2024/08/05 11:33:42
Table '119' 8-max Seat #3 is the button
Seat 1: efff41bc (28,209 in chips)
Seat 2: 516045fd (36,523 in chips)
Seat 3: f97c269e (31,195 in chips)
Seat 4: 10438ff8 (43,232 in chips)
Seat 5: 8e2803b9 (52,410 in chips)
Seat 6: 992f7aa2 (29,666 in chips)
Seat 7: Hero (48,058 in chips)
f97c269e: posts the ante 120
8e2803b9: posts the ante 120
10438ff8: posts the ante 120
516045fd: posts the ante 120
efff41bc: posts the ante 120
992f7aa2: posts the ante 120
Hero: posts the ante 120
10438ff8: posts small blind 400
8e2803b9: posts big blind 800
*** HOLE CARDS ***
Dealt to efff41bc 
Dealt to 516045fd 
Dealt to f97c269e 
Dealt to 10438ff8 
Dealt to 8e2803b9 
Dealt to 992f7aa2 
Dealt to Hero [Ac 8c]
992f7aa2: folds
Hero: raises 800 to 1,600
efff41bc: folds
516045fd: folds
f97c269e: folds
10438ff8: folds
8e2803b9: folds
Uncalled bet (800) returned to Hero
*** SHOWDOWN ***
Hero collected 2,840 from pot
*** SUMMARY ***
Total pot 2,840 | Rake 0 | Jackpot 0 | Bingo 0 | Fortune 0 | Tax 0
Seat 1: efff41bc folded before Flop
Seat 2: 516045fd folded before Flop
Seat 3: f97c269e (button) folded before Flop
Seat 4: 10438ff8 (small blind) folded before Flop
Seat 5: 8e2803b9 (big blind) folded before Flop
Seat 6: 992f7aa2 folded before Flop
Seat 7: Hero collected (2,840)


Poker Hand #TM3552363099: Tournament #156543396, Bounty Hunters Special $1.08 Hold'em No Limit - Level11(350/700) - 2024/08/05 11:32:42
Table '119' 8-max Seat #2 is the button
Seat 1: efff41bc (28,309 in chips)
Seat 2: 516045fd (36,623 in chips)
Seat 3: f97c269e (31,645 in chips)
Seat 4: 10438ff8 (44,032 in chips)
Seat 5: 8e2803b9 (40,860 in chips)
Seat 6: 992f7aa2 (29,766 in chips)
Seat 7: Hero (48,158 in chips)
Seat 8: 3088d432 (9,900 in chips)
f97c269e: posts the ante 100
8e2803b9: posts the ante 100
10438ff8: posts the ante 100
516045fd: posts the ante 100
efff41bc: posts the ante 100
992f7aa2: posts the ante 100
3088d432: posts the ante 100
Hero: posts the ante 100
f97c269e: posts small blind 350
10438ff8: posts big blind 700
*** HOLE CARDS ***
Dealt to efff41bc 
Dealt to 516045fd 
Dealt to f97c269e 
Dealt to 10438ff8 
Dealt to 8e2803b9 
Dealt to 992f7aa2 
Dealt to Hero [Qs 8h]
Dealt to 3088d432 
8e2803b9: raises 700 to 1,400
992f7aa2: folds
Hero: folds
3088d432: raises 8,400 to 9,800 and is all-in
efff41bc: folds
516045fd: folds
f97c269e: folds
10438ff8: folds
8e2803b9: calls 8,400
3088d432: shows [6d Ac]
8e2803b9: shows [Ad Qc]
*** FLOP *** [Ah 8d 3c]
*** TURN *** [Ah 8d 3c] [5c]
*** RIVER *** [Ah 8d 3c 5c] [Jd]
*** SHOWDOWN ***
8e2803b9 collected 21,450 from pot
*** SUMMARY ***
Total pot 21,450 | Rake 0 | Jackpot 0 | Bingo 0 | Fortune 0 | Tax 0
Board [Ah 8d 3c 5c Jd]
Seat 1: efff41bc folded before Flop
Seat 2: 516045fd (button) folded before Flop
Seat 3: f97c269e (small blind) folded before Flop
Seat 4: 10438ff8 (big blind) folded before Flop
Seat 5: 8e2803b9 showed [Ad Qc] and won (21,450) with Pair of Aces
Seat 6: 992f7aa2 folded before Flop
Seat 7: Hero folded before Flop
Seat 8: 3088d432 showed [6d Ac] and lost with Pair of Aces


Poker Hand #TM3552363054: Tournament #156543396, Bounty Hunters Special $1.08 Hold'em No Limit - Level11(350/700) - 2024/08/05 11:31:21
Table '119' 8-max Seat #1 is the button
Seat 1: efff41bc (28,409 in chips)
Seat 2: 516045fd (41,823 in chips)
Seat 3: f97c269e (25,845 in chips)
Seat 4: 10438ff8 (44,132 in chips)
Seat 5: 8e2803b9 (40,960 in chips)
Seat 6: 992f7aa2 (29,866 in chips)
Seat 7: Hero (48,258 in chips)
Seat 8: 3088d432 (10,000 in chips)
f97c269e: posts the ante 100
8e2803b9: posts the ante 100
10438ff8: posts the ante 100
efff41bc: posts the ante 100
516045fd: posts the ante 100
992f7aa2: posts the ante 100
3088d432: posts the ante 100
Hero: posts the ante 100
516045fd: posts small blind 350
f97c269e: posts big blind 700
*** HOLE CARDS ***
Dealt to efff41bc 
Dealt to 516045fd 
Dealt to f97c269e 
Dealt to 10438ff8 
Dealt to 8e2803b9 
Dealt to 992f7aa2 
Dealt to Hero [2c 4c]
Dealt to 3088d432 
10438ff8: folds
8e2803b9: folds
992f7aa2: folds
Hero: folds
3088d432: folds
efff41bc: folds
516045fd: calls 350
f97c269e: checks
*** FLOP *** [Tc Qd 3c]
516045fd: checks
f97c269e: bets 1,100
516045fd: calls 1,100
*** TURN *** [Tc Qd 3c] [Js]
516045fd: bets 3,300
f97c269e: raises 5,500 to 8,800
516045fd: folds
Uncalled bet (5,500) returned to f97c269e
*** SHOWDOWN ***
f97c269e collected 11,000 from pot
*** SUMMARY ***
Total pot 11,000 | Rake 0 | Jackpot 0 | Bingo 0 | Fortune 0 | Tax 0
Board [Tc Qd 3c Js]
Seat 1: efff41bc (button) folded before Flop
Seat 2: 516045fd (small blind) folded on the Turn
Seat 3: f97c269e (big blind) won (11,000)
Seat 4: 10438ff8 folded before Flop
Seat 5: 8e2803b9 folded before Flop
Seat 6: 992f7aa2 folded before Flop
Seat 7: Hero folded before Flop
Seat 8: 3088d432 folded before Flop


Poker Hand #TM3552363022: Tournament #156543396, Bounty Hunters Special $1.08 Hold'em No Limit - Level11(350/700) - 2024/08/05 11:30:17
Table '119' 8-max Seat #7 is the button
Seat 1: efff41bc (28,859 in chips)
Seat 2: 516045fd (42,623 in chips)
Seat 3: f97c269e (36,445 in chips)
Seat 4: 10438ff8 (44,232 in chips)
Seat 5: 8e2803b9 (28,810 in chips)
Seat 6: 992f7aa2 (29,966 in chips)
Seat 7: Hero (48,358 in chips)
f97c269e: posts the ante 100
8e2803b9: posts the ante 100
10438ff8: posts the ante 100
516045fd: posts the ante 100
efff41bc: posts the ante 100
992f7aa2: posts the ante 100
Hero: posts the ante 100
efff41bc: posts small blind 350
516045fd: posts big blind 700
*** HOLE CARDS ***
Dealt to efff41bc 
Dealt to 516045fd 
Dealt to f97c269e 
Dealt to 10438ff8 
Dealt to 8e2803b9 
Dealt to 992f7aa2 
Dealt to Hero [3s 4d]
f97c269e: raises 700 to 1,400
10438ff8: folds
8e2803b9: calls 1,400
992f7aa2: folds
Hero: folds
efff41bc: folds
516045fd: folds
*** FLOP *** [3c Jd 7c]
f97c269e: bets 2,275
8e2803b9: calls 2,275
*** TURN *** [3c Jd 7c] [9h]
f97c269e: bets 6,825
8e2803b9: calls 6,825
*** RIVER *** [3c Jd 7c 9h] [Ah]
f97c269e: checks
8e2803b9: bets 18,210 and is all-in
f97c269e: folds
Uncalled bet (18,210) returned to 8e2803b9
*** SHOWDOWN ***
8e2803b9 collected 22,750 from pot
*** SUMMARY ***
Total pot 22,750 | Rake 0 | Jackpot 0 | Bingo 0 | Fortune 0 | Tax 0
Board [3c Jd 7c 9h Ah]
Seat 1: efff41bc (small blind) folded before Flop
Seat 2: 516045fd (big blind) folded before Flop
Seat 3: f97c269e folded on the River
Seat 4: 10438ff8 folded before Flop
Seat 5: 8e2803b9 won (22,750)
Seat 6: 992f7aa2 folded before Flop
Seat 7: Hero (button) folded before Flop


Poker Hand #TM3552362967: Tournament #156543396, Bounty Hunters Special $1.08 Hold'em No Limit - Level11(350/700) - 2024/08/05 11:28:27
Table '119' 8-max Seat #6 is the button
Seat 1: efff41bc (28,959 in chips)
Seat 2: 516045fd (42,723 in chips)
Seat 3: f97c269e (36,545 in chips)
Seat 4: 10438ff8 (45,732 in chips)
Seat 5: 8e2803b9 (28,910 in chips)
Seat 6: 992f7aa2 (31,466 in chips)
Seat 7: Hero (35,158 in chips)
Seat 8: 509bb416 (9,800 in chips)
f97c269e: posts the ante 100
8e2803b9: posts the ante 100
10438ff8: posts the ante 100
516045fd: posts the ante 100
efff41bc: posts the ante 100
992f7aa2: posts the ante 100
509bb416: posts the ante 100
Hero: posts the ante 100
Hero: posts small blind 350
509bb416: posts big blind 700
*** HOLE CARDS ***
Dealt to efff41bc 
Dealt to 516045fd 
Dealt to f97c269e 
Dealt to 10438ff8 
Dealt to 8e2803b9 
Dealt to 992f7aa2 
Dealt to Hero [5d 8d]
Dealt to 509bb416 
efff41bc: folds
516045fd: folds
f97c269e: folds
10438ff8: raises 700 to 1,400
8e2803b9: folds
992f7aa2: calls 1,400
Hero: calls 1,050
509bb416: calls 700
*** FLOP *** [8h Ah Tc]
Hero: checks
509bb416: checks
10438ff8: checks
992f7aa2: checks
*** TURN *** [8h Ah Tc] [8c]
Hero: bets 2,112
509bb416: calls 2,112
10438ff8: folds
992f7aa2: folds
*** RIVER *** [8h Ah Tc 8c] [2s]
Hero: bets 6,300
509bb416: calls 6,188 and is all-in
Uncalled bet (112) returned to Hero
Hero: shows [5d 8d] (Three Eights)
509bb416: shows [Ac 6s] (Pair of Aces and Pair of Eights)
*** SHOWDOWN ***
Hero collected 23,000 from pot
*** SUMMARY ***
Total pot 23,000 | Rake 0 | Jackpot 0 | Bingo 0 | Fortune 0 | Tax 0
Board [8h Ah Tc 8c 2s]
Seat 1: efff41bc folded before Flop
Seat 2: 516045fd folded before Flop
Seat 3: f97c269e folded before Flop
Seat 4: 10438ff8 folded on the Turn
Seat 5: 8e2803b9 folded before Flop
Seat 6: 992f7aa2 (button) folded on the Turn
Seat 7: Hero (small blind) showed [5d 8d] and won (23,000) with Three Eights
Seat 8: 509bb416 (big blind) showed [Ac 6s] and lost with Pair of Aces and Pair of Eights


Poker Hand #TM3552362958: Tournament #156543396, Bounty Hunters Special $1.08 Hold'em No Limit - Level11(350/700) - 2024/08/05 11:28:03
Table '119' 8-max Seat #5 is the button
Seat 1: efff41bc (29,059 in chips)
Seat 2: 516045fd (42,823 in chips)
Seat 3: f97c269e (34,795 in chips)
Seat 4: 10438ff8 (45,832 in chips)
Seat 5: 8e2803b9 (29,010 in chips)
Seat 6: 992f7aa2 (31,916 in chips)
Seat 7: Hero (35,958 in chips)
Seat 8: 509bb416 (9,900 in chips)
f97c269e: posts the ante 100
8e2803b9: posts the ante 100
10438ff8: posts the ante 100
516045fd: posts the ante 100
efff41bc: posts the ante 100
992f7aa2: posts the ante 100
509bb416: posts the ante 100
Hero: posts the ante 100
992f7aa2: posts small blind 350
Hero: posts big blind 700
*** HOLE CARDS ***
Dealt to efff41bc 
Dealt to 516045fd 
Dealt to f97c269e 
Dealt to 10438ff8 
Dealt to 8e2803b9 
Dealt to 992f7aa2 
Dealt to Hero [3h 4c]
Dealt to 509bb416 
509bb416: folds
efff41bc: folds
516045fd: folds
f97c269e: raises 1,400 to 2,100
10438ff8: folds
8e2803b9: folds
992f7aa2: folds
Hero: folds
Uncalled bet (1,400) returned to f97c269e
*** SHOWDOWN ***
f97c269e collected 2,550 from pot
*** SUMMARY ***
Total pot 2,550 | Rake 0 | Jackpot 0 | Bingo 0 | Fortune 0 | Tax 0
Seat 1: efff41bc folded before Flop
Seat 2: 516045fd folded before Flop
Seat 3: f97c269e collected (2,550)
Seat 4: 10438ff8 folded before Flop
Seat 5: 8e2803b9 (button) folded before Flop
Seat 6: 992f7aa2 (small blind) folded before Flop
Seat 7: Hero (big blind) folded before Flop
Seat 8: 509bb416 folded before Flop


Poker Hand #TM3552362923: Tournament #156543396, Bounty Hunters Special $1.08 Hold'em No Limit - Level11(350/700) - 2024/08/05 11:26:54
Table '119' 8-max Seat #4 is the button
Seat 1: efff41bc (29,159 in chips)
Seat 2: 516045fd (42,923 in chips)
Seat 3: f97c269e (34,895 in chips)
Seat 4: 10438ff8 (45,932 in chips)
Seat 5: 8e2803b9 (21,785 in chips)
Seat 6: 992f7aa2 (36,791 in chips)
Seat 7: Hero (37,808 in chips)
Seat 8: 509bb416 (10,000 in chips)
f97c269e: posts the ante 100
8e2803b9: posts the ante 100
10438ff8: posts the ante 100
516045fd: posts the ante 100
efff41bc: posts the ante 100
992f7aa2: posts the ante 100
509bb416: posts the ante 100
Hero: posts the ante 100
8e2803b9: posts small blind 350
992f7aa2: posts big blind 700
*** HOLE CARDS ***
Dealt to efff41bc 
Dealt to 516045fd 
Dealt to f97c269e 
Dealt to 10438ff8 
Dealt to 8e2803b9 
Dealt to 992f7aa2 
Dealt to Hero [Kh Ad]
Dealt to 509bb416 
Hero: raises 1,050 to 1,750
509bb416: folds
efff41bc: folds
516045fd: folds
f97c269e: folds
10438ff8: folds
8e2803b9: calls 1,400
992f7aa2: calls 1,050
*** FLOP *** [Jd 5s 9c]
8e2803b9: checks
992f7aa2: bets 3,025
Hero: folds
8e2803b9: calls 3,025
*** TURN *** [Jd 5s 9c] [Ah]
8e2803b9: checks
992f7aa2: checks
*** RIVER *** [Jd 5s 9c Ah] [4d]
8e2803b9: bets 3,146
992f7aa2: folds
Uncalled bet (3,146) returned to 8e2803b9
*** SHOWDOWN ***
8e2803b9 collected 12,100 from pot
*** SUMMARY ***
Total pot 12,100 | Rake 0 | Jackpot 0 | Bingo 0 | Fortune 0 | Tax 0
Board [Jd 5s 9c Ah 4d]
Seat 1: efff41bc folded before Flop
Seat 2: 516045fd folded before Flop
Seat 3: f97c269e folded before Flop
Seat 4: 10438ff8 (button) folded before Flop
Seat 5: 8e2803b9 (small blind) won (12,100)
Seat 6: 992f7aa2 (big blind) folded on the River
Seat 7: Hero folded on the Flop
Seat 8: 509bb416 folded before Flop


Poker Hand #TM3552362877: Tournament #156543396, Bounty Hunters Special $1.08 Hold'em No Limit - Level11(350/700) - 2024/08/05 11:25:22
Table '119' 8-max Seat #3 is the button
Seat 1: efff41bc (20,859 in chips)
Seat 2: 516045fd (48,623 in chips)
Seat 3: f97c269e (34,995 in chips)
Seat 4: 10438ff8 (47,432 in chips)
Seat 5: 8e2803b9 (22,585 in chips)
Seat 6: 992f7aa2 (36,891 in chips)
Seat 7: Hero (37,908 in chips)
f97c269e: posts the ante 100
8e2803b9: posts the ante 100
10438ff8: posts the ante 100
516045fd: posts the ante 100
efff41bc: posts the ante 100
992f7aa2: posts the ante 100
Hero: posts the ante 100
10438ff8: posts small blind 350
8e2803b9: posts big blind 700
*** HOLE CARDS ***
Dealt to efff41bc 
Dealt to 516045fd 
Dealt to f97c269e 
Dealt to 10438ff8 
Dealt to 8e2803b9 
Dealt to 992f7aa2 
Dealt to Hero [7c 3h]
992f7aa2: folds
Hero: folds
efff41bc: calls 700
516045fd: raises 700 to 1,400
f97c269e: folds
10438ff8: calls 1,050
8e2803b9: folds
efff41bc: calls 700
*** FLOP *** [8c 5d Tc]
10438ff8: checks
efff41bc: checks
516045fd: checks
*** TURN *** [8c 5d Tc] [Js]
10438ff8: checks
efff41bc: checks
516045fd: bets 4,200
10438ff8: folds
efff41bc: calls 4,200
*** RIVER *** [8c 5d Tc Js] [7h]
efff41bc: checks
516045fd: checks
efff41bc: shows [Qc 9c] (Queens-High Straight)
516045fd: shows [Kh Qs] (King-High)
*** SHOWDOWN ***
efff41bc collected 14,000 from pot
*** SUMMARY ***
Total pot 14,000 | Rake 0 | Jackpot 0 | Bingo 0 | Fortune 0 | Tax 0
Board [8c 5d Tc Js 7h]
Seat 1: efff41bc showed [Qc 9c] and won (14,000) with Queens-High Straight
Seat 2: 516045fd showed [Kh Qs] and lost with King-High
Seat 3: f97c269e (button) folded before Flop
Seat 4: 10438ff8 (small blind) folded on the Turn
Seat 5: 8e2803b9 (big blind) folded before Flop
Seat 6: 992f7aa2 folded before Flop
Seat 7: Hero folded before Flop


Poker Hand #TM3552362844: Tournament #156543396, Bounty Hunters Special $1.08 Hold'em No Limit - Level11(350/700) - 2024/08/05 11:24:22
Table '119' 8-max Seat #2 is the button
Seat 1: efff41bc (20,959 in chips)
Seat 2: 516045fd (48,723 in chips)
Seat 3: f97c269e (35,445 in chips)
Seat 4: 10438ff8 (48,232 in chips)
Seat 5: 8e2803b9 (22,685 in chips)
Seat 7: Hero (19,968 in chips)
Seat 8: d56fa4f5 (16,390 in chips)
f97c269e: posts the ante 100
8e2803b9: posts the ante 100
10438ff8: posts the ante 100
516045fd: posts the ante 100
efff41bc: posts the ante 100
d56fa4f5: posts the ante 100
Hero: posts the ante 100
f97c269e: posts small blind 350
10438ff8: posts big blind 700
*** HOLE CARDS ***
Dealt to efff41bc 
Dealt to 516045fd 
Dealt to f97c269e 
Dealt to 10438ff8 
Dealt to 8e2803b9 
Dealt to Hero [Jd Js]
Dealt to d56fa4f5 
8e2803b9: folds
Hero: raises 2,100 to 2,800
d56fa4f5: raises 13,490 to 16,290 and is all-in
efff41bc: folds
516045fd: folds
f97c269e: folds
10438ff8: folds
Hero: calls 13,490
d56fa4f5: shows [7h 7s]
Hero: shows [Jd Js]
*** FLOP *** [5h 9h 3h]
*** TURN *** [5h 9h 3h] [Jc]
*** RIVER *** [5h 9h 3h Jc] [5d]
*** SHOWDOWN ***
Hero collected 34,330 from pot
*** SUMMARY ***
Total pot 34,330 | Rake 0 | Jackpot 0 | Bingo 0 | Fortune 0 | Tax 0
Board [5h 9h 3h Jc 5d]
Seat 1: efff41bc folded before Flop
Seat 2: 516045fd (button) folded before Flop
Seat 3: f97c269e (small blind) folded before Flop
Seat 4: 10438ff8 (big blind) folded before Flop
Seat 5: 8e2803b9 folded before Flop
Seat 7: Hero showed [Jd Js] and won (34,330) with Jacks Full over Fives
Seat 8: d56fa4f5 showed [7h 7s] and lost with Pair of Sevens and Pair of Fives


Poker Hand #TM3552362823: Tournament #156543396, Bounty Hunters Special $1.08 Hold'em No Limit - Level10(300/600) - 2024/08/05 11:23:28
Table '119' 8-max Seat #1 is the button
Seat 1: efff41bc (21,049 in chips)
Seat 2: 516045fd (49,113 in chips)
Seat 3: f97c269e (23,070 in chips)
Seat 4: 10438ff8 (48,322 in chips)
Seat 5: 8e2803b9 (22,775 in chips)
Seat 6: 5c76744d (11,535 in chips)
Seat 7: Hero (20,058 in chips)
Seat 8: d56fa4f5 (16,480 in chips)
f97c269e: posts the ante 90
5c76744d: posts the ante 90
8e2803b9: posts the ante 90
10438ff8: posts the ante 90
efff41bc: posts the ante 90
516045fd: posts the ante 90
d56fa4f5: posts the ante 90
Hero: posts the ante 90
516045fd: posts small blind 300
f97c269e: posts big blind 600
*** HOLE CARDS ***
Dealt to efff41bc 
Dealt to 516045fd 
Dealt to f97c269e 
Dealt to 10438ff8 
Dealt to 8e2803b9 
Dealt to 5c76744d 
Dealt to Hero [9h 3c]
Dealt to d56fa4f5 
10438ff8: folds
8e2803b9: folds
5c76744d: calls 600
Hero: folds
d56fa4f5: folds
efff41bc: folds
516045fd: folds
f97c269e: raises 22,380 to 22,980 and is all-in
5c76744d: calls 10,845 and is all-in
Uncalled bet (11,535) returned to f97c269e
f97c269e: shows [Qh As]
5c76744d: shows [Js 6s]
*** FLOP *** [Tc 5c 2s]
*** TURN *** [Tc 5c 2s] [Th]
*** RIVER *** [Tc 5c 2s Th] [Qc]
*** SHOWDOWN ***
f97c269e collected 23,910 from pot
*** SUMMARY ***
Total pot 23,910 | Rake 0 | Jackpot 0 | Bingo 0 | Fortune 0 | Tax 0
Board [Tc 5c 2s Th Qc]
Seat 1: efff41bc (button) folded before Flop
Seat 2: 516045fd (small blind) folded before Flop
Seat 3: f97c269e (big blind) showed [Qh As] and won (23,910) with Pair of Queens and Pair of Tens
Seat 4: 10438ff8 folded before Flop
Seat 5: 8e2803b9 folded before Flop
Seat 6: 5c76744d showed [Js 6s] and lost with Pair of Tens
Seat 7: Hero folded before Flop
Seat 8: d56fa4f5 folded before Flop


Poker Hand #TM3552362786: Tournament #156543396, Bounty Hunters Special $1.08 Hold'em No Limit - Level10(300/600) - 2024/08/05 11:22:12
Table '119' 8-max Seat #8 is the button
Seat 1: efff41bc (21,439 in chips)
Seat 2: 516045fd (54,213 in chips)
Seat 3: f97c269e (15,330 in chips)
Seat 4: 10438ff8 (48,412 in chips)
Seat 5: 8e2803b9 (22,865 in chips)
Seat 6: 5c76744d (13,425 in chips)
Seat 7: Hero (20,148 in chips)
Seat 8: d56fa4f5 (16,570 in chips)
f97c269e: posts the ante 90
5c76744d: posts the ante 90
8e2803b9: posts the ante 90
10438ff8: posts the ante 90
516045fd: posts the ante 90
efff41bc: posts the ante 90
d56fa4f5: posts the ante 90
Hero: posts the ante 90
efff41bc: posts small blind 300
516045fd: posts big blind 600
*** HOLE CARDS ***
Dealt to efff41bc 
Dealt to 516045fd 
Dealt to f97c269e 
Dealt to 10438ff8 
Dealt to 8e2803b9 
Dealt to 5c76744d 
Dealt to Hero [2s 4c]
Dealt to d56fa4f5 
f97c269e: raises 1,200 to 1,800
10438ff8: folds
8e2803b9: folds
5c76744d: calls 1,800
Hero: folds
d56fa4f5: folds
efff41bc: folds
516045fd: calls 1,200
*** FLOP *** [Ks Jd 5d]
516045fd: checks
f97c269e: bets 3,210
5c76744d: folds
516045fd: calls 3,210
*** TURN *** [Ks Jd 5d] [Qh]
516045fd: checks
f97c269e: bets 10,230 and is all-in
516045fd: folds
Uncalled bet (10,230) returned to f97c269e
*** SHOWDOWN ***
f97c269e collected 12,840 from pot
*** SUMMARY ***
Total pot 12,840 | Rake 0 | Jackpot 0 | Bingo 0 | Fortune 0 | Tax 0
Board [Ks Jd 5d Qh]
Seat 1: efff41bc (small blind) folded before Flop
Seat 2: 516045fd (big blind) folded on the Turn
Seat 3: f97c269e won (12,840)
Seat 4: 10438ff8 folded before Flop
Seat 5: 8e2803b9 folded before Flop
Seat 6: 5c76744d folded on the Flop
Seat 7: Hero folded before Flop
Seat 8: d56fa4f5 (button) folded before Flop


Poker Hand #TM3552362770: Tournament #156543396, Bounty Hunters Special $1.08 Hold'em No Limit - Level10(300/600) - 2024/08/05 11:21:38
Table '119' 8-max Seat #7 is the button
Seat 1: efff41bc (19,909 in chips)
Seat 2: 516045fd (54,303 in chips)
Seat 3: f97c269e (15,420 in chips)
Seat 4: 10438ff8 (48,502 in chips)
Seat 5: 8e2803b9 (22,955 in chips)
Seat 6: 5c76744d (14,115 in chips)
Seat 7: Hero (20,238 in chips)
Seat 8: d56fa4f5 (16,960 in chips)
f97c269e: posts the ante 90
5c76744d: posts the ante 90
8e2803b9: posts the ante 90
10438ff8: posts the ante 90
516045fd: posts the ante 90
efff41bc: posts the ante 90
d56fa4f5: posts the ante 90
Hero: posts the ante 90
d56fa4f5: posts small blind 300
efff41bc: posts big blind 600
*** HOLE CARDS ***
Dealt to efff41bc 
Dealt to 516045fd 
Dealt to f97c269e 
Dealt to 10438ff8 
Dealt to 8e2803b9 
Dealt to 5c76744d 
Dealt to Hero [4h 8h]
Dealt to d56fa4f5 
516045fd: folds
f97c269e: folds
10438ff8: folds
8e2803b9: folds
5c76744d: calls 600
Hero: folds
d56fa4f5: folds
efff41bc: checks
*** FLOP *** [Qd 9c 8d]
efff41bc: bets 900
5c76744d: folds
Uncalled bet (900) returned to efff41bc
*** SHOWDOWN ***
efff41bc collected 2,220 from pot
*** SUMMARY ***
Total pot 2,220 | Rake 0 | Jackpot 0 | Bingo 0 | Fortune 0 | Tax 0
Board [Qd 9c 8d]
Seat 1: efff41bc (big blind) won (2,220)
Seat 2: 516045fd folded before Flop
Seat 3: f97c269e folded before Flop
Seat 4: 10438ff8 folded before Flop
Seat 5: 8e2803b9 folded before Flop
Seat 6: 5c76744d folded on the Flop
Seat 7: Hero (button) folded before Flop
Seat 8: d56fa4f5 (small blind) folded before Flop


Poker Hand #TM3552362713: Tournament #156543396, Bounty Hunters Special $1.08 Hold'em No Limit - Level10(300/600) - 2024/08/05 11:19:43
Table '119' 8-max Seat #6 is the button
Seat 1: efff41bc (19,999 in chips)
Seat 2: 516045fd (32,453 in chips)
Seat 3: f97c269e (15,510 in chips)
Seat 4: 10438ff8 (48,592 in chips)
Seat 5: 8e2803b9 (24,245 in chips)
Seat 6: 5c76744d (15,405 in chips)
Seat 7: Hero (38,548 in chips)
Seat 8: d56fa4f5 (17,650 in chips)
f97c269e: posts the ante 90
5c76744d: posts the ante 90
8e2803b9: posts the ante 90
10438ff8: posts the ante 90
516045fd: posts the ante 90
efff41bc: posts the ante 90
d56fa4f5: posts the ante 90
Hero: posts the ante 90
Hero: posts small blind 300
d56fa4f5: posts big blind 600
*** HOLE CARDS ***
Dealt to efff41bc 
Dealt to 516045fd 
Dealt to f97c269e 
Dealt to 10438ff8 
Dealt to 8e2803b9 
Dealt to 5c76744d 
Dealt to Hero [Th Ah]
Dealt to d56fa4f5 
efff41bc: folds
516045fd: raises 600 to 1,200
f97c269e: folds
10438ff8: folds
8e2803b9: calls 1,200
5c76744d: calls 1,200
Hero: calls 900
d56fa4f5: folds
*** FLOP *** [As Tc Js]
Hero: bets 2,020
516045fd: calls 2,020
8e2803b9: folds
5c76744d: folds
*** TURN *** [As Tc Js] [8h]
Hero: bets 5,080
516045fd: raises 9,920 to 15,000
Hero: calls 9,920
*** RIVER *** [As Tc Js 8h] [9h]
Hero: checks
516045fd: bets 14,143 and is all-in
Hero: folds
Uncalled bet (14,143) returned to 516045fd
*** SHOWDOWN ***
516045fd collected 40,160 from pot
*** SUMMARY ***
Total pot 40,160 | Rake 0 | Jackpot 0 | Bingo 0 | Fortune 0 | Tax 0
Board [As Tc Js 8h 9h]
Seat 1: efff41bc folded before Flop
Seat 2: 516045fd won (40,160)
Seat 3: f97c269e folded before Flop
Seat 4: 10438ff8 folded before Flop
Seat 5: 8e2803b9 folded on the Flop
Seat 6: 5c76744d (button) folded on the Flop
Seat 7: Hero (small blind) folded on the River
Seat 8: d56fa4f5 (big blind) folded before Flop


Poker Hand #TM3552362692: Tournament #156543396, Bounty Hunters Special $1.08 Hold'em No Limit - Level10(300/600) - 2024/08/05 11:18:34
Table '119' 8-max Seat #5 is the button
Seat 1: efff41bc (20,089 in chips)
Seat 2: 516045fd (32,543 in chips)
Seat 3: f97c269e (15,600 in chips)
Seat 4: 10438ff8 (48,682 in chips)
Seat 5: 8e2803b9 (24,335 in chips)
Seat 6: 5c76744d (14,175 in chips)
Seat 7: Hero (39,238 in chips)
Seat 8: d56fa4f5 (17,740 in chips)
f97c269e: posts the ante 90
5c76744d: posts the ante 90
8e2803b9: posts the ante 90
10438ff8: posts the ante 90
516045fd: posts the ante 90
efff41bc: posts the ante 90
d56fa4f5: posts the ante 90
Hero: posts the ante 90
5c76744d: posts small blind 300
Hero: posts big blind 600
*** HOLE CARDS ***
Dealt to efff41bc 
Dealt to 516045fd 
Dealt to f97c269e 
Dealt to 10438ff8 
Dealt to 8e2803b9 
Dealt to 5c76744d 
Dealt to Hero [6h Kh]
Dealt to d56fa4f5 
d56fa4f5: folds
efff41bc: folds
516045fd: folds
f97c269e: folds
10438ff8: folds
8e2803b9: folds
5c76744d: calls 300
Hero: checks
*** FLOP *** [Jd 7s Qh]
5c76744d: checks
Hero: checks
*** TURN *** [Jd 7s Qh] [9d]
5c76744d: checks
Hero: checks
*** RIVER *** [Jd 7s Qh 9d] [8h]
5c76744d: checks
Hero: checks
5c76744d: shows [4c Th] (Queens-High Straight)
Hero: shows [6h Kh] (King-High)
*** SHOWDOWN ***
5c76744d collected 1,920 from pot
*** SUMMARY ***
Total pot 1,920 | Rake 0 | Jackpot 0 | Bingo 0 | Fortune 0 | Tax 0
Board [Jd 7s Qh 9d 8h]
Seat 1: efff41bc folded before Flop
Seat 2: 516045fd folded before Flop
Seat 3: f97c269e folded before Flop
Seat 4: 10438ff8 folded before Flop
Seat 5: 8e2803b9 (button) folded before Flop
Seat 6: 5c76744d (small blind) showed [4c Th] and won (1,920) with Queens-High Straight
Seat 7: Hero (big blind) showed [6h Kh] and lost with King-High
Seat 8: d56fa4f5 folded before Flop


Poker Hand #TM3552362647: Tournament #156543396, Bounty Hunters Special $1.08 Hold'em No Limit - Level10(300/600) - 2024/08/05 11:17:04
Table '119' 8-max Seat #4 is the button
Seat 1: efff41bc (20,179 in chips)
Seat 2: 516045fd (23,108 in chips)
Seat 3: f97c269e (15,690 in chips)
Seat 4: 10438ff8 (48,772 in chips)
Seat 5: 8e2803b9 (24,725 in chips)
Seat 6: 5c76744d (19,770 in chips)
Seat 7: Hero (39,328 in chips)
Seat 8: d56fa4f5 (20,830 in chips)
f97c269e: posts the ante 90
5c76744d: posts the ante 90
8e2803b9: posts the ante 90
10438ff8: posts the ante 90
516045fd: posts the ante 90
efff41bc: posts the ante 90
d56fa4f5: posts the ante 90
Hero: posts the ante 90
8e2803b9: posts small blind 300
5c76744d: posts big blind 600
*** HOLE CARDS ***
Dealt to efff41bc 
Dealt to 516045fd 
Dealt to f97c269e 
Dealt to 10438ff8 
Dealt to 8e2803b9 
Dealt to 5c76744d 
Dealt to Hero [4d Tc]
Dealt to d56fa4f5 
Hero: folds
d56fa4f5: raises 600 to 1,200
efff41bc: folds
516045fd: raises 1,800 to 3,000
f97c269e: folds
10438ff8: folds
8e2803b9: folds
5c76744d: calls 2,400
d56fa4f5: calls 1,800
*** FLOP *** [3d 2h Qd]
5c76744d: checks
d56fa4f5: checks
516045fd: bets 2,505
5c76744d: calls 2,505
d56fa4f5: folds
*** TURN *** [3d 2h Qd] [Td]
5c76744d: checks
516045fd: bets 17,513 and is all-in
5c76744d: folds
Uncalled bet (17,513) returned to 516045fd
*** SHOWDOWN ***
516045fd collected 15,030 from pot
*** SUMMARY ***
Total pot 15,030 | Rake 0 | Jackpot 0 | Bingo 0 | Fortune 0 | Tax 0
Board [3d 2h Qd Td]
Seat 1: efff41bc folded before Flop
Seat 2: 516045fd won (15,030)
Seat 3: f97c269e folded before Flop
Seat 4: 10438ff8 (button) folded before Flop
Seat 5: 8e2803b9 (small blind) folded before Flop
Seat 6: 5c76744d (big blind) folded on the Turn
Seat 7: Hero folded before Flop
Seat 8: d56fa4f5 folded on the Flop


Poker Hand #TM3552362629: Tournament #156543396, Bounty Hunters Special $1.08 Hold'em No Limit - Level10(300/600) - 2024/08/05 11:16:11
Table '119' 8-max Seat #3 is the button
Seat 1: efff41bc (20,269 in chips)
Seat 2: 516045fd (23,798 in chips)
Seat 3: f97c269e (12,960 in chips)
Seat 4: 10438ff8 (49,162 in chips)
Seat 5: 8e2803b9 (25,415 in chips)
Seat 6: 5c76744d (20,460 in chips)
Seat 7: Hero (39,418 in chips)
Seat 8: d56fa4f5 (20,920 in chips)
f97c269e: posts the ante 90
5c76744d: posts the ante 90
8e2803b9: posts the ante 90
10438ff8: posts the ante 90
516045fd: posts the ante 90
efff41bc: posts the ante 90
d56fa4f5: posts the ante 90
Hero: posts the ante 90
10438ff8: posts small blind 300
8e2803b9: posts big blind 600
*** HOLE CARDS ***
Dealt to efff41bc 
Dealt to 516045fd 
Dealt to f97c269e 
Dealt to 10438ff8 
Dealt to 8e2803b9 
Dealt to 5c76744d 
Dealt to Hero [Ad 8s]
Dealt to d56fa4f5 
5c76744d: calls 600
Hero: folds
d56fa4f5: folds
efff41bc: folds
516045fd: calls 600
f97c269e: raises 12,270 to 12,870 and is all-in
10438ff8: folds
8e2803b9: folds
5c76744d: folds
516045fd: folds
Uncalled bet (12,270) returned to f97c269e
*** SHOWDOWN ***
f97c269e collected 3,420 from pot
*** SUMMARY ***
Total pot 3,420 | Rake 0 | Jackpot 0 | Bingo 0 | Fortune 0 | Tax 0
Seat 1: efff41bc folded before Flop
Seat 2: 516045fd folded before Flop
Seat 3: f97c269e (button) collected (3,420)
Seat 4: 10438ff8 (small blind) folded before Flop
Seat 5: 8e2803b9 (big blind) folded before Flop
Seat 6: 5c76744d folded before Flop
Seat 7: Hero folded before Flop
Seat 8: d56fa4f5 folded before Flop


Poker Hand #TM3552362593: Tournament #156543396, Bounty Hunters Special $1.08 Hold'em No Limit - Level10(300/600) - 2024/08/05 11:14:40
Table '119' 8-max Seat #2 is the button
Seat 1: efff41bc (20,359 in chips)
Seat 2: 516045fd (23,888 in chips)
Seat 3: f97c269e (13,350 in chips)
Seat 4: 10438ff8 (49,852 in chips)
Seat 5: 66dad90a (8,150 in chips)
Seat 6: 5c76744d (20,550 in chips)
Seat 7: Hero (14,959 in chips)
Seat 8: d56fa4f5 (35,879 in chips)
f97c269e: posts the ante 90
66dad90a: posts the ante 90
5c76744d: posts the ante 90
10438ff8: posts the ante 90
516045fd: posts the ante 90
efff41bc: posts the ante 90
d56fa4f5: posts the ante 90
Hero: posts the ante 90
f97c269e: posts small blind 300
10438ff8: posts big blind 600
*** HOLE CARDS ***
Dealt to efff41bc 
Dealt to 516045fd 
Dealt to f97c269e 
Dealt to 10438ff8 
Dealt to 66dad90a 
Dealt to 5c76744d 
Dealt to Hero [7d 7s]
Dealt to d56fa4f5 
66dad90a: raises 600 to 1,200
5c76744d: folds
Hero: calls 1,200
d56fa4f5: raises 3,600 to 4,800
efff41bc: folds
516045fd: folds
f97c269e: folds
10438ff8: folds
66dad90a: calls 3,600
Hero: calls 3,600
*** FLOP *** [7c 6d 3s]
66dad90a: bets 3,260 and is all-in
Hero: calls 3,260
d56fa4f5: raises 19,350 to 22,610
Hero: calls 6,809 and is all-in
Uncalled bet (12,541) returned to d56fa4f5
d56fa4f5: shows [8s 8c] (Pair of Eights)
66dad90a: shows [Kd Js] (King-High)
Hero: shows [7d 7s] (Three Sevens)
*** TURN *** [7c 6d 3s] [Jh]
*** RIVER *** [7c 6d 3s Jh] [5s]
*** SHOWDOWN ***
Hero collected 25,800 from pot
Hero collected 13,618 from pot
*** SUMMARY ***
Total pot 39,418 | Rake 0 | Jackpot 0 | Bingo 0 | Fortune 0 | Tax 0
Board [7c 6d 3s Jh 5s]
Seat 1: efff41bc folded before Flop
Seat 2: 516045fd (button) folded before Flop
Seat 3: f97c269e (small blind) folded before Flop
Seat 4: 10438ff8 (big blind) folded before Flop
Seat 5: 66dad90a showed [Kd Js] and lost with Pair of Jacks
Seat 6: 5c76744d folded before Flop
Seat 7: Hero showed [7d 7s] and won (39,418) with Three Sevens
Seat 8: d56fa4f5 showed [8s 8c] and lost with Pair of Eights


Poker Hand #TM3552362565: Tournament #156543396, Bounty Hunters Special $1.08 Hold'em No Limit - Level9(250/500) - 2024/08/05 11:13:24
Table '119' 8-max Seat #1 is the button
Seat 1: efff41bc (20,434 in chips)
Seat 2: 516045fd (24,213 in chips)
Seat 3: f97c269e (23,275 in chips)
Seat 4: 10438ff8 (49,927 in chips)
Seat 5: 66dad90a (8,225 in chips)
Seat 6: 5c76744d (9,925 in chips)
Seat 7: Hero (15,034 in chips)
Seat 8: d56fa4f5 (35,954 in chips)
f97c269e: posts the ante 75
66dad90a: posts the ante 75
5c76744d: posts the ante 75
10438ff8: posts the ante 75
efff41bc: posts the ante 75
516045fd: posts the ante 75
d56fa4f5: posts the ante 75
Hero: posts the ante 75
516045fd: posts small blind 250
f97c269e: posts big blind 500
*** HOLE CARDS ***
Dealt to efff41bc 
Dealt to 516045fd 
Dealt to f97c269e 
Dealt to 10438ff8 
Dealt to 66dad90a 
Dealt to 5c76744d 
Dealt to Hero [7d 2c]
Dealt to d56fa4f5 
10438ff8: folds
66dad90a: folds
5c76744d: raises 500 to 1,000
Hero: folds
d56fa4f5: folds
efff41bc: folds
516045fd: folds
f97c269e: calls 500
*** FLOP *** [Qd 7h Jd]
f97c269e: bets 1,425
5c76744d: raises 1,881 to 3,306
f97c269e: raises 1,881 to 5,187
5c76744d: raises 3,663 to 8,850 and is all-in
f97c269e: calls 3,663
5c76744d: shows [Ad Ah] (Pair of Aces)
f97c269e: shows [2d 5d] (Queen-High)
*** TURN *** [Qd 7h Jd] [7s]
*** RIVER *** [Qd 7h Jd 7s] [Kh]
*** SHOWDOWN ***
5c76744d collected 20,550 from pot
*** SUMMARY ***
Total pot 20,550 | Rake 0 | Jackpot 0 | Bingo 0 | Fortune 0 | Tax 0
Board [Qd 7h Jd 7s Kh]
Seat 1: efff41bc (button) folded before Flop
Seat 2: 516045fd (small blind) folded before Flop
Seat 3: f97c269e (big blind) showed [2d 5d] and lost with Pair of Sevens
Seat 4: 10438ff8 folded before Flop
Seat 5: 66dad90a folded before Flop
Seat 6: 5c76744d showed [Ad Ah] and won (20,550) with Pair of Aces and Pair of Sevens
Seat 7: Hero folded before Flop
Seat 8: d56fa4f5 folded before Flop


Poker Hand #TM3552362526: Tournament #156543396, Bounty Hunters Special $1.08 Hold'em No Limit - Level9(250/500) - 2024/08/05 11:11:58
Table '119' 8-max Seat #8 is the button
Seat 1: efff41bc (20,759 in chips)
Seat 2: 516045fd (24,788 in chips)
Seat 3: f97c269e (20,900 in chips)
Seat 4: 10438ff8 (51,102 in chips)
Seat 5: 66dad90a (8,300 in chips)
Seat 6: 5c76744d (10,000 in chips)
Seat 7: Hero (15,109 in chips)
Seat 8: d56fa4f5 (36,029 in chips)
f97c269e: posts the ante 75
66dad90a: posts the ante 75
5c76744d: posts the ante 75
10438ff8: posts the ante 75
516045fd: posts the ante 75
efff41bc: posts the ante 75
d56fa4f5: posts the ante 75
Hero: posts the ante 75
efff41bc: posts small blind 250
516045fd: posts big blind 500
*** HOLE CARDS ***
Dealt to efff41bc 
Dealt to 516045fd 
Dealt to f97c269e 
Dealt to 10438ff8 
Dealt to 66dad90a 
Dealt to 5c76744d 
Dealt to Hero [5c Qh]
Dealt to d56fa4f5 
f97c269e: raises 600 to 1,100
10438ff8: calls 1,100
66dad90a: folds
5c76744d: folds
Hero: folds
d56fa4f5: folds
efff41bc: folds
516045fd: folds
*** FLOP *** [Js 6h 5d]
f97c269e: checks
10438ff8: checks
*** TURN *** [Js 6h 5d] [Ad]
f97c269e: checks
10438ff8: checks
*** RIVER *** [Js 6h 5d Ad] [4s]
f97c269e: bets 1,775
10438ff8: folds
Uncalled bet (1,775) returned to f97c269e
*** SHOWDOWN ***
f97c269e collected 3,550 from pot
*** SUMMARY ***
Total pot 3,550 | Rake 0 | Jackpot 0 | Bingo 0 | Fortune 0 | Tax 0
Board [Js 6h 5d Ad 4s]
Seat 1: efff41bc (small blind) folded before Flop
Seat 2: 516045fd (big blind) folded before Flop
Seat 3: f97c269e won (3,550)
Seat 4: 10438ff8 folded on the River
Seat 5: 66dad90a folded before Flop
Seat 6: 5c76744d folded before Flop
Seat 7: Hero folded before Flop
Seat 8: d56fa4f5 (button) folded before Flop


Poker Hand #TM3552362495: Tournament #156543396, Bounty Hunters Special $1.08 Hold'em No Limit - Level9(250/500) - 2024/08/05 11:10:54
Table '119' 8-max Seat #7 is the button
Seat 1: efff41bc (21,334 in chips)
Seat 2: 516045fd (24,863 in chips)
Seat 3: f97c269e (20,975 in chips)
Seat 4: 10438ff8 (51,177 in chips)
Seat 5: 66dad90a (8,875 in chips)
Seat 7: Hero (15,684 in chips)
Seat 8: d56fa4f5 (34,079 in chips)
f97c269e: posts the ante 75
66dad90a: posts the ante 75
10438ff8: posts the ante 75
516045fd: posts the ante 75
efff41bc: posts the ante 75
d56fa4f5: posts the ante 75
Hero: posts the ante 75
d56fa4f5: posts small blind 250
efff41bc: posts big blind 500
*** HOLE CARDS ***
Dealt to efff41bc 
Dealt to 516045fd 
Dealt to f97c269e 
Dealt to 10438ff8 
Dealt to 66dad90a 
Dealt to Hero [3s 3h]
Dealt to d56fa4f5 
516045fd: folds
f97c269e: folds
10438ff8: folds
66dad90a: calls 500
Hero: calls 500
d56fa4f5: raises 1,750 to 2,250
efff41bc: folds
66dad90a: folds
Hero: folds
Uncalled bet (1,750) returned to d56fa4f5
*** SHOWDOWN ***
d56fa4f5 collected 2,525 from pot
*** SUMMARY ***
Total pot 2,525 | Rake 0 | Jackpot 0 | Bingo 0 | Fortune 0 | Tax 0
Seat 1: efff41bc (big blind) folded before Flop
Seat 2: 516045fd folded before Flop
Seat 3: f97c269e folded before Flop
Seat 4: 10438ff8 folded before Flop
Seat 5: 66dad90a folded before Flop
Seat 7: Hero (button) folded before Flop
Seat 8: d56fa4f5 (small blind) collected (2,525)


Poker Hand #TM3552362450: Tournament #156543396, Bounty Hunters Special $1.08 Hold'em No Limit - Level9(250/500) - 2024/08/05 11:09:27
Table '119' 8-max Seat #6 is the button
Seat 1: efff41bc (21,409 in chips)
Seat 2: 516045fd (24,938 in chips)
Seat 3: f97c269e (21,050 in chips)
Seat 4: 10438ff8 (51,252 in chips)
Seat 5: 66dad90a (8,950 in chips)
Seat 6: f0bce165 (5,509 in chips)
Seat 7: Hero (16,009 in chips)
Seat 8: d56fa4f5 (27,870 in chips)
f97c269e: posts the ante 75
66dad90a: posts the ante 75
10438ff8: posts the ante 75
f0bce165: posts the ante 75
516045fd: posts the ante 75
efff41bc: posts the ante 75
d56fa4f5: posts the ante 75
Hero: posts the ante 75
Hero: posts small blind 250
d56fa4f5: posts big blind 500
*** HOLE CARDS ***
Dealt to efff41bc 
Dealt to 516045fd 
Dealt to f97c269e 
Dealt to 10438ff8 
Dealt to 66dad90a 
Dealt to f0bce165 
Dealt to Hero [4d 7h]
Dealt to d56fa4f5 
efff41bc: folds
516045fd: folds
f97c269e: folds
10438ff8: folds
66dad90a: folds
f0bce165: raises 1,000 to 1,500
Hero: folds
d56fa4f5: raises 3,250 to 4,750
f0bce165: raises 684 to 5,434 and is all-in
d56fa4f5: calls 684
f0bce165: shows [Qc Tc]
d56fa4f5: shows [Qd Ah]
*** FLOP *** [2s 5c Ks]
*** TURN *** [2s 5c Ks] [6s]
*** RIVER *** [2s 5c Ks 6s] [Js]
*** SHOWDOWN ***
d56fa4f5 collected 11,718 from pot
*** SUMMARY ***
Total pot 11,718 | Rake 0 | Jackpot 0 | Bingo 0 | Fortune 0 | Tax 0
Board [2s 5c Ks 6s Js]
Seat 1: efff41bc folded before Flop
Seat 2: 516045fd folded before Flop
Seat 3: f97c269e folded before Flop
Seat 4: 10438ff8 folded before Flop
Seat 5: 66dad90a folded before Flop
Seat 6: f0bce165 (button) showed [Qc Tc] and lost with King-High
Seat 7: Hero (small blind) folded before Flop
Seat 8: d56fa4f5 (big blind) showed [Qd Ah] and won (11,718) with Ace-High


Poker Hand #TM3552362416: Tournament #156543396, Bounty Hunters Special $1.08 Hold'em No Limit - Level9(250/500) - 2024/08/05 11:07:50
Table '119' 8-max Seat #5 is the button
Seat 1: efff41bc (21,484 in chips)
Seat 2: 516045fd (25,013 in chips)
Seat 3: f97c269e (9,925 in chips)
Seat 4: 10438ff8 (51,327 in chips)
Seat 5: 66dad90a (9,025 in chips)
Seat 6: f0bce165 (5,834 in chips)
Seat 7: Hero (16,584 in chips)
Seat 8: d56fa4f5 (37,795 in chips)
f97c269e: posts the ante 75
66dad90a: posts the ante 75
10438ff8: posts the ante 75
516045fd: posts the ante 75
efff41bc: posts the ante 75
f0bce165: posts the ante 75
d56fa4f5: posts the ante 75
Hero: posts the ante 75
f0bce165: posts small blind 250
Hero: posts big blind 500
*** HOLE CARDS ***
Dealt to efff41bc 
Dealt to 516045fd 
Dealt to f97c269e 
Dealt to 10438ff8 
Dealt to 66dad90a 
Dealt to f0bce165 
Dealt to Hero [Th 8h]
Dealt to d56fa4f5 
d56fa4f5: raises 500 to 1,000
efff41bc: folds
516045fd: folds
f97c269e: raises 8,850 to 9,850 and is all-in
10438ff8: folds
66dad90a: folds
f0bce165: folds
Hero: folds
d56fa4f5: calls 8,850
f97c269e: shows [As Kc]
d56fa4f5: shows [5d Ac]
*** FLOP *** [Td Jh Qd]
*** TURN *** [Td Jh Qd] [Js]
*** RIVER *** [Td Jh Qd Js] [6d]
*** SHOWDOWN ***
f97c269e collected 21,050 from pot
*** SUMMARY ***
Total pot 21,050 | Rake 0 | Jackpot 0 | Bingo 0 | Fortune 0 | Tax 0
Board [Td Jh Qd Js 6d]
Seat 1: efff41bc folded before Flop
Seat 2: 516045fd folded before Flop
Seat 3: f97c269e showed [As Kc] and won (21,050) with Aces-High Straight
Seat 4: 10438ff8 folded before Flop
Seat 5: 66dad90a (button) folded before Flop
Seat 6: f0bce165 (small blind) folded before Flop
Seat 7: Hero (big blind) folded before Flop
Seat 8: d56fa4f5 showed [5d Ac] and lost with Pair of Jacks


Poker Hand #TM3552362407: Tournament #156543396, Bounty Hunters Special $1.08 Hold'em No Limit - Level9(250/500) - 2024/08/05 11:07:16
Table '119' 8-max Seat #4 is the button
Seat 1: efff41bc (21,559 in chips)
Seat 2: 516045fd (25,088 in chips)
Seat 3: f97c269e (10,000 in chips)
Seat 4: 10438ff8 (51,402 in chips)
Seat 5: 66dad90a (9,350 in chips)
Seat 6: f0bce165 (6,409 in chips)
Seat 7: Hero (16,659 in chips)
Seat 8: d56fa4f5 (36,520 in chips)
f97c269e: posts the ante 75
66dad90a: posts the ante 75
10438ff8: posts the ante 75
516045fd: posts the ante 75
efff41bc: posts the ante 75
f0bce165: posts the ante 75
d56fa4f5: posts the ante 75
Hero: posts the ante 75
66dad90a: posts small blind 250
f0bce165: posts big blind 500
*** HOLE CARDS ***
Dealt to efff41bc 
Dealt to 516045fd 
Dealt to f97c269e 
Dealt to 10438ff8 
Dealt to 66dad90a 
Dealt to f0bce165 
Dealt to Hero [As 4d]
Dealt to d56fa4f5 
Hero: folds
d56fa4f5: raises 500 to 1,000
efff41bc: folds
516045fd: folds
f97c269e: folds
10438ff8: folds
66dad90a: folds
f0bce165: folds
Uncalled bet (500) returned to d56fa4f5
*** SHOWDOWN ***
d56fa4f5 collected 1,850 from pot
*** SUMMARY ***
Total pot 1,850 | Rake 0 | Jackpot 0 | Bingo 0 | Fortune 0 | Tax 0
Seat 1: efff41bc folded before Flop
Seat 2: 516045fd folded before Flop
Seat 3: f97c269e folded before Flop
Seat 4: 10438ff8 (button) folded before Flop
Seat 5: 66dad90a (small blind) folded before Flop
Seat 6: f0bce165 (big blind) folded before Flop
Seat 7: Hero folded before Flop
Seat 8: d56fa4f5 collected (1,850)


Poker Hand #TM3552362396: Tournament #156543396, Bounty Hunters Special $1.08 Hold'em No Limit - Level9(250/500) - 2024/08/05 11:06:45
Table '119' 8-max Seat #2 is the button
Seat 1: efff41bc (21,634 in chips)
Seat 2: 516045fd (25,163 in chips)
Seat 4: 10438ff8 (50,452 in chips)
Seat 5: 66dad90a (9,925 in chips)
Seat 6: f0bce165 (6,484 in chips)
Seat 7: Hero (16,734 in chips)
Seat 8: d56fa4f5 (36,595 in chips)
66dad90a: posts the ante 75
10438ff8: posts the ante 75
516045fd: posts the ante 75
efff41bc: posts the ante 75
f0bce165: posts the ante 75
d56fa4f5: posts the ante 75
Hero: posts the ante 75
10438ff8: posts small blind 250
66dad90a: posts big blind 500
*** HOLE CARDS ***
Dealt to efff41bc 
Dealt to 516045fd 
Dealt to 10438ff8 
Dealt to 66dad90a 
Dealt to f0bce165 
Dealt to Hero [5c Ah]
Dealt to d56fa4f5 
f0bce165: folds
Hero: folds
d56fa4f5: folds
efff41bc: folds
516045fd: folds
10438ff8: raises 500 to 1,000
66dad90a: folds
Uncalled bet (500) returned to 10438ff8
*** SHOWDOWN ***
10438ff8 collected 1,525 from pot
*** SUMMARY ***
Total pot 1,525 | Rake 0 | Jackpot 0 | Bingo 0 | Fortune 0 | Tax 0
Seat 1: efff41bc folded before Flop
Seat 2: 516045fd (button) folded before Flop
Seat 4: 10438ff8 (small blind) collected (1,525)
Seat 5: 66dad90a (big blind) folded before Flop
Seat 6: f0bce165 folded before Flop
Seat 7: Hero folded before Flop
Seat 8: d56fa4f5 folded before Flop


Poker Hand #TM3552362370: Tournament #156543396, Bounty Hunters Special $1.08 Hold'em No Limit - Level9(250/500) - 2024/08/05 11:05:21
Table '119' 8-max Seat #1 is the button
Seat 1: efff41bc (22,709 in chips)
Seat 2: 516045fd (25,488 in chips)
Seat 3: d4f3a21f (11,334 in chips)
Seat 4: 10438ff8 (50,527 in chips)
Seat 5: 66dad90a (10,000 in chips)
Seat 6: f0bce165 (6,559 in chips)
Seat 7: Hero (16,809 in chips)
Seat 8: d56fa4f5 (23,561 in chips)
66dad90a: posts the ante 75
10438ff8: posts the ante 75
efff41bc: posts the ante 75
f0bce165: posts the ante 75
516045fd: posts the ante 75
d56fa4f5: posts the ante 75
Hero: posts the ante 75
d4f3a21f: posts the ante 75
516045fd: posts small blind 250
d4f3a21f: posts big blind 500
*** HOLE CARDS ***
Dealt to efff41bc 
Dealt to 516045fd 
Dealt to d4f3a21f 
Dealt to 10438ff8 
Dealt to 66dad90a 
Dealt to f0bce165 
Dealt to Hero [Td 7c]
Dealt to d56fa4f5 
10438ff8: folds
66dad90a: folds
f0bce165: folds
Hero: folds
d56fa4f5: raises 500 to 1,000
efff41bc: calls 1,000
516045fd: folds
d4f3a21f: calls 500
*** FLOP *** [Ks Jd Kd]
d4f3a21f: bets 2,000
d56fa4f5: calls 2,000
efff41bc: folds
*** TURN *** [Ks Jd Kd] [7h]
d4f3a21f: bets 8,259 and is all-in
d56fa4f5: calls 8,259
d4f3a21f: shows [Jc 7d] (Pair of Kings and Pair of Jacks)
d56fa4f5: shows [Js Qh] (Pair of Kings and Pair of Jacks)
*** RIVER *** [Ks Jd Kd 7h] [Qc]
*** SHOWDOWN ***
d56fa4f5 collected 24,368 from pot
*** SUMMARY ***
Total pot 24,368 | Rake 0 | Jackpot 0 | Bingo 0 | Fortune 0 | Tax 0
Board [Ks Jd Kd 7h Qc]
Seat 1: efff41bc (button) folded on the Flop
Seat 2: 516045fd (small blind) folded before Flop
Seat 3: d4f3a21f (big blind) showed [Jc 7d] and lost with Pair of Kings and Pair of Jacks
Seat 4: 10438ff8 folded before Flop
Seat 5: 66dad90a folded before Flop
Seat 6: f0bce165 folded before Flop
Seat 7: Hero folded before Flop
Seat 8: d56fa4f5 showed [Js Qh] and won (24,368) with Pair of Kings and Pair of Queens


Poker Hand #TM3552362345: Tournament #156543396, Bounty Hunters Special $1.08 Hold'em No Limit - Level9(250/500) - 2024/08/05 11:04:17
Table '119' 8-max Seat #8 is the button
Seat 1: efff41bc (10,917 in chips)
Seat 2: 516045fd (26,063 in chips)
Seat 3: d4f3a21f (11,409 in chips)
Seat 4: 10438ff8 (50,602 in chips)
Seat 6: f0bce165 (17,476 in chips)
Seat 7: Hero (16,884 in chips)
Seat 8: d56fa4f5 (23,636 in chips)
10438ff8: posts the ante 75
f0bce165: posts the ante 75
516045fd: posts the ante 75
efff41bc: posts the ante 75
d56fa4f5: posts the ante 75
Hero: posts the ante 75
d4f3a21f: posts the ante 75
efff41bc: posts small blind 250
516045fd: posts big blind 500
*** HOLE CARDS ***
Dealt to efff41bc 
Dealt to 516045fd 
Dealt to d4f3a21f 
Dealt to 10438ff8 
Dealt to f0bce165 
Dealt to Hero [9s 8d]
Dealt to d56fa4f5 
d4f3a21f: folds
10438ff8: folds
f0bce165: raises 750 to 1,250
Hero: folds
d56fa4f5: folds
efff41bc: raises 1,763 to 3,013
516045fd: folds
f0bce165: calls 1,763
*** FLOP *** [Th Jd Ad]
efff41bc: checks
f0bce165: bets 2,327
efff41bc: raises 5,502 to 7,829 and is all-in
f0bce165: calls 5,502
efff41bc: shows [Qd Kc] (Aces-High Straight)
f0bce165: shows [As Js] (Pair of Aces and Pair of Jacks)
*** TURN *** [Th Jd Ad] [2s]
*** RIVER *** [Th Jd Ad 2s] [Kh]
*** SHOWDOWN ***
efff41bc collected 22,709 from pot
*** SUMMARY ***
Total pot 22,709 | Rake 0 | Jackpot 0 | Bingo 0 | Fortune 0 | Tax 0
Board [Th Jd Ad 2s Kh]
Seat 1: efff41bc (small blind) showed [Qd Kc] and won (22,709) with Aces-High Straight
Seat 2: 516045fd (big blind) folded before Flop
Seat 3: d4f3a21f folded before Flop
Seat 4: 10438ff8 folded before Flop
Seat 6: f0bce165 showed [As Js] and lost with Pair of Aces and Pair of Jacks
Seat 7: Hero folded before Flop
Seat 8: d56fa4f5 (button) folded before Flop


Poker Hand #TM3552362335: Tournament #156543396, Bounty Hunters Special $1.08 Hold'em No Limit - Level9(250/500) - 2024/08/05 11:03:49
Table '119' 8-max Seat #7 is the button
Seat 1: efff41bc (10,217 in chips)
Seat 2: 516045fd (26,138 in chips)
Seat 3: d4f3a21f (11,484 in chips)
Seat 4: 10438ff8 (50,677 in chips)
Seat 6: f0bce165 (17,551 in chips)
Seat 7: Hero (16,959 in chips)
Seat 8: d56fa4f5 (23,961 in chips)
10438ff8: posts the ante 75
f0bce165: posts the ante 75
516045fd: posts the ante 75
efff41bc: posts the ante 75
d56fa4f5: posts the ante 75
Hero: posts the ante 75
d4f3a21f: posts the ante 75
d56fa4f5: posts small blind 250
efff41bc: posts big blind 500
*** HOLE CARDS ***
Dealt to efff41bc 
Dealt to 516045fd 
Dealt to d4f3a21f 
Dealt to 10438ff8 
Dealt to f0bce165 
Dealt to Hero [3h 8c]
Dealt to d56fa4f5 
516045fd: folds
d4f3a21f: folds
10438ff8: folds
f0bce165: folds
Hero: folds
d56fa4f5: folds
Uncalled bet (250) returned to efff41bc
*** SHOWDOWN ***
efff41bc collected 1,025 from pot
*** SUMMARY ***
Total pot 1,025 | Rake 0 | Jackpot 0 | Bingo 0 | Fortune 0 | Tax 0
Seat 1: efff41bc (big blind) collected (1,025)
Seat 2: 516045fd folded before Flop
Seat 3: d4f3a21f folded before Flop
Seat 4: 10438ff8 folded before Flop
Seat 6: f0bce165 folded before Flop
Seat 7: Hero (button) folded before Flop
Seat 8: d56fa4f5 (small blind) folded before Flop


Poker Hand #TM3552362317: Tournament #156543396, Bounty Hunters Special $1.08 Hold'em No Limit - Level8(200/400) - 2024/08/05 11:02:38
Table '119' 8-max Seat #6 is the button
Seat 1: efff41bc (12,585 in chips)
Seat 2: 516045fd (26,198 in chips)
Seat 3: d4f3a21f (11,544 in chips)
Seat 4: 10438ff8 (46,041 in chips)
Seat 5: e9dc2298 (1,368 in chips)
Seat 6: f0bce165 (17,611 in chips)
Seat 7: Hero (17,219 in chips)
Seat 8: d56fa4f5 (24,421 in chips)
e9dc2298: posts the ante 60
10438ff8: posts the ante 60
f0bce165: posts the ante 60
516045fd: posts the ante 60
efff41bc: posts the ante 60
d56fa4f5: posts the ante 60
d4f3a21f: posts the ante 60
Hero: posts the ante 60
Hero: posts small blind 200
d56fa4f5: posts big blind 400
*** HOLE CARDS ***
Dealt to efff41bc 
Dealt to 516045fd 
Dealt to d4f3a21f 
Dealt to 10438ff8 
Dealt to e9dc2298 
Dealt to f0bce165 
Dealt to Hero [4h 7d]
Dealt to d56fa4f5 
efff41bc: calls 400
516045fd: folds
d4f3a21f: folds
10438ff8: raises 440 to 840
e9dc2298: raises 468 to 1,308 and is all-in
f0bce165: folds
Hero: folds
d56fa4f5: folds
efff41bc: calls 908
10438ff8: calls 468
*** FLOP *** [Ac 9c 6h]
efff41bc: bets 1,000
10438ff8: raises 2,312 to 3,312
efff41bc: folds
Uncalled bet (2,312) returned to 10438ff8
10438ff8: shows [6c 6s] (Three Sixes)
e9dc2298: shows [Ad Ks] (Pair of Aces)
*** TURN *** [Ac 9c 6h] [8d]
*** RIVER *** [Ac 9c 6h 8d] [5s]
*** SHOWDOWN ***
10438ff8 collected 5,004 from pot
10438ff8 collected 2,000 from pot
*** SUMMARY ***
Total pot 7,004 | Rake 0 | Jackpot 0 | Bingo 0 | Fortune 0 | Tax 0
Board [Ac 9c 6h 8d 5s]
Seat 1: efff41bc folded on the Flop
Seat 2: 516045fd folded before Flop
Seat 3: d4f3a21f folded before Flop
Seat 4: 10438ff8 showed [6c 6s] and won (7,004) with Three Sixes
Seat 5: e9dc2298 showed [Ad Ks] and lost with Pair of Aces
Seat 6: f0bce165 (button) folded before Flop
Seat 7: Hero (small blind) folded before Flop
Seat 8: d56fa4f5 (big blind) folded before Flop


Poker Hand #TM3552362303: Tournament #156543396, Bounty Hunters Special $1.08 Hold'em No Limit - Level8(200/400) - 2024/08/05 11:01:44
Table '119' 8-max Seat #5 is the button
Seat 1: efff41bc (11,565 in chips)
Seat 2: 516045fd (26,258 in chips)
Seat 3: d4f3a21f (11,604 in chips)
Seat 4: 10438ff8 (46,101 in chips)
Seat 5: e9dc2298 (1,428 in chips)
Seat 6: f0bce165 (17,871 in chips)
Seat 7: Hero (17,679 in chips)
Seat 8: d56fa4f5 (24,481 in chips)
e9dc2298: posts the ante 60
10438ff8: posts the ante 60
516045fd: posts the ante 60
efff41bc: posts the ante 60
f0bce165: posts the ante 60
d56fa4f5: posts the ante 60
d4f3a21f: posts the ante 60
Hero: posts the ante 60
f0bce165: posts small blind 200
Hero: posts big blind 400
*** HOLE CARDS ***
Dealt to efff41bc 
Dealt to 516045fd 
Dealt to d4f3a21f 
Dealt to 10438ff8 
Dealt to e9dc2298 
Dealt to f0bce165 
Dealt to Hero [4h 7h]
Dealt to d56fa4f5 
d56fa4f5: folds
efff41bc: calls 400
516045fd: folds
d4f3a21f: folds
10438ff8: folds
e9dc2298: folds
f0bce165: folds
Hero: checks
*** FLOP *** [9d 3s 8c]
Hero: checks
efff41bc: bets 740
Hero: folds
Uncalled bet (740) returned to efff41bc
*** SHOWDOWN ***
efff41bc collected 1,480 from pot
*** SUMMARY ***
Total pot 1,480 | Rake 0 | Jackpot 0 | Bingo 0 | Fortune 0 | Tax 0
Board [9d 3s 8c]
Seat 1: efff41bc won (1,480)
Seat 2: 516045fd folded before Flop
Seat 3: d4f3a21f folded before Flop
Seat 4: 10438ff8 folded before Flop
Seat 5: e9dc2298 (button) folded before Flop
Seat 6: f0bce165 (small blind) folded before Flop
Seat 7: Hero (big blind) folded on the Flop
Seat 8: d56fa4f5 folded before Flop


Poker Hand #TM3552362290: Tournament #156543396, Bounty Hunters Special $1.08 Hold'em No Limit - Level8(200/400) - 2024/08/05 10:54:34
Table '119' 8-max Seat #4 is the button
Seat 1: efff41bc (12,025 in chips)
Seat 2: 516045fd (12,449 in chips)
Seat 3: d4f3a21f (24,053 in chips)
Seat 4: 10438ff8 (46,161 in chips)
Seat 5: e9dc2298 (1,688 in chips)
Seat 6: f0bce165 (18,331 in chips)
Seat 7: Hero (17,739 in chips)
Seat 8: d56fa4f5 (24,541 in chips)
e9dc2298: posts the ante 60
10438ff8: posts the ante 60
516045fd: posts the ante 60
efff41bc: posts the ante 60
f0bce165: posts the ante 60
d56fa4f5: posts the ante 60
d4f3a21f: posts the ante 60
Hero: posts the ante 60
e9dc2298: posts small blind 200
f0bce165: posts big blind 400
*** HOLE CARDS ***
Dealt to efff41bc 
Dealt to 516045fd 
Dealt to d4f3a21f 
Dealt to 10438ff8 
Dealt to e9dc2298 
Dealt to f0bce165 
Dealt to Hero [7h 2h]
Dealt to d56fa4f5 
Hero: folds
d56fa4f5: folds
efff41bc: calls 400
516045fd: calls 400
d4f3a21f: raises 23,593 to 23,993 and is all-in
10438ff8: folds
e9dc2298: folds
f0bce165: folds
efff41bc: folds
516045fd: calls 11,989 and is all-in
Uncalled bet (11,604) returned to d4f3a21f
d4f3a21f: shows [Jh Kh]
516045fd: shows [Ac Ts]
*** FLOP *** [6c Th 8d]
*** TURN *** [6c Th 8d] [2s]
*** RIVER *** [6c Th 8d 2s] [Qh]
*** SHOWDOWN ***
516045fd collected 26,258 from pot
*** SUMMARY ***
Total pot 26,258 | Rake 0 | Jackpot 0 | Bingo 0 | Fortune 0 | Tax 0
Board [6c Th 8d 2s Qh]
Seat 1: efff41bc folded before Flop
Seat 2: 516045fd showed [Ac Ts] and won (26,258) with Pair of Tens
Seat 3: d4f3a21f showed [Jh Kh] and lost with King-High
Seat 4: 10438ff8 (button) folded before Flop
Seat 5: e9dc2298 (small blind) folded before Flop
Seat 6: f0bce165 (big blind) folded before Flop
Seat 7: Hero folded before Flop
Seat 8: d56fa4f5 folded before Flop


Poker Hand #TM3552362278: Tournament #156543396, Bounty Hunters Special $1.08 Hold'em No Limit - Level8(200/400) - 2024/08/05 10:53:59
Table '119' 8-max Seat #3 is the button
Seat 1: efff41bc (12,485 in chips)
Seat 2: 516045fd (12,909 in chips)
Seat 3: d4f3a21f (22,233 in chips)
Seat 4: 10438ff8 (46,421 in chips)
Seat 5: e9dc2298 (2,148 in chips)
Seat 6: f0bce165 (18,391 in chips)
Seat 7: Hero (17,799 in chips)
Seat 8: d56fa4f5 (24,601 in chips)
e9dc2298: posts the ante 60
10438ff8: posts the ante 60
516045fd: posts the ante 60
efff41bc: posts the ante 60
f0bce165: posts the ante 60
d56fa4f5: posts the ante 60
d4f3a21f: posts the ante 60
Hero: posts the ante 60
10438ff8: posts small blind 200
e9dc2298: posts big blind 400
*** HOLE CARDS ***
Dealt to efff41bc 
Dealt to 516045fd 
Dealt to d4f3a21f 
Dealt to 10438ff8 
Dealt to e9dc2298 
Dealt to f0bce165 
Dealt to Hero [Ks 7h]
Dealt to d56fa4f5 
f0bce165: folds
Hero: folds
d56fa4f5: folds
efff41bc: calls 400
516045fd: calls 400
d4f3a21f: raises 21,773 to 22,173 and is all-in
10438ff8: folds
e9dc2298: folds
efff41bc: folds
516045fd: folds
Uncalled bet (21,773) returned to d4f3a21f
*** SHOWDOWN ***
d4f3a21f collected 2,280 from pot
*** SUMMARY ***
Total pot 2,280 | Rake 0 | Jackpot 0 | Bingo 0 | Fortune 0 | Tax 0
Seat 1: efff41bc folded before Flop
Seat 2: 516045fd folded before Flop
Seat 3: d4f3a21f (button) collected (2,280)
Seat 4: 10438ff8 (small blind) folded before Flop
Seat 5: e9dc2298 (big blind) folded before Flop
Seat 6: f0bce165 folded before Flop
Seat 7: Hero folded before Flop
Seat 8: d56fa4f5 folded before Flop


Poker Hand #TM3552362264: Tournament #156543396, Bounty Hunters Special $1.08 Hold'em No Limit - Level8(200/400) - 2024/08/05 10:53:07
Table '119' 8-max Seat #2 is the button
Seat 1: efff41bc (12,545 in chips)
Seat 2: 516045fd (12,969 in chips)
Seat 3: d4f3a21f (22,493 in chips)
Seat 4: 10438ff8 (46,881 in chips)
Seat 5: e9dc2298 (2,208 in chips)
Seat 6: f0bce165 (20,468 in chips)
Seat 7: Hero (14,762 in chips)
Seat 8: d56fa4f5 (24,661 in chips)
e9dc2298: posts the ante 60
10438ff8: posts the ante 60
516045fd: posts the ante 60
efff41bc: posts the ante 60
f0bce165: posts the ante 60
d56fa4f5: posts the ante 60
Hero: posts the ante 60
d4f3a21f: posts the ante 60
d4f3a21f: posts small blind 200
10438ff8: posts big blind 400
*** HOLE CARDS ***
Dealt to efff41bc 
Dealt to 516045fd 
Dealt to d4f3a21f 
Dealt to 10438ff8 
Dealt to e9dc2298 
Dealt to f0bce165 
Dealt to Hero [Qs Js]
Dealt to d56fa4f5 
e9dc2298: folds
f0bce165: raises 600 to 1,000
Hero: calls 1,000
d56fa4f5: folds
efff41bc: folds
516045fd: folds
d4f3a21f: folds
10438ff8: folds
*** FLOP *** [4h 7s Tc]
f0bce165: bets 1,017
Hero: calls 1,017
*** TURN *** [4h 7s Tc] [4s]
f0bce165: checks
Hero: checks
*** RIVER *** [4h 7s Tc 4s] [4c]
f0bce165: checks
Hero: bets 2,557
f0bce165: folds
Uncalled bet (2,557) returned to Hero
*** SHOWDOWN ***
Hero collected 5,114 from pot
*** SUMMARY ***
Total pot 5,114 | Rake 0 | Jackpot 0 | Bingo 0 | Fortune 0 | Tax 0
Board [4h 7s Tc 4s 4c]
Seat 1: efff41bc folded before Flop
Seat 2: 516045fd (button) folded before Flop
Seat 3: d4f3a21f (small blind) folded before Flop
Seat 4: 10438ff8 (big blind) folded before Flop
Seat 5: e9dc2298 folded before Flop
Seat 6: f0bce165 folded on the River
Seat 7: Hero won (5,114)
Seat 8: d56fa4f5 folded before Flop


Poker Hand #TM3552362250: Tournament #156543396, Bounty Hunters Special $1.08 Hold'em No Limit - Level8(200/400) - 2024/08/05 10:52:15
Table '119' 8-max Seat #1 is the button
Seat 1: efff41bc (12,605 in chips)
Seat 2: 516045fd (13,229 in chips)
Seat 3: d4f3a21f (18,673 in chips)
Seat 4: 10438ff8 (46,941 in chips)
Seat 5: e9dc2298 (2,268 in chips)
Seat 6: f0bce165 (20,528 in chips)
Seat 7: Hero (14,822 in chips)
Seat 8: d56fa4f5 (27,921 in chips)
e9dc2298: posts the ante 60
10438ff8: posts the ante 60
efff41bc: posts the ante 60
f0bce165: posts the ante 60
516045fd: posts the ante 60
d56fa4f5: posts the ante 60
Hero: posts the ante 60
d4f3a21f: posts the ante 60
516045fd: posts small blind 200
d4f3a21f: posts big blind 400
*** HOLE CARDS ***
Dealt to efff41bc 
Dealt to 516045fd 
Dealt to d4f3a21f 
Dealt to 10438ff8 
Dealt to e9dc2298 
Dealt to f0bce165 
Dealt to Hero [4c 3h]
Dealt to d56fa4f5 
10438ff8: folds
e9dc2298: folds
f0bce165: folds
Hero: folds
d56fa4f5: raises 440 to 840
efff41bc: folds
516045fd: folds
d4f3a21f: calls 440
*** FLOP *** [8h Th Jd]
d4f3a21f: bets 2,360
d56fa4f5: calls 2,360
*** TURN *** [8h Th Jd] [6d]
d4f3a21f: bets 15,413 and is all-in
d56fa4f5: folds
Uncalled bet (15,413) returned to d4f3a21f
*** SHOWDOWN ***
d4f3a21f collected 7,080 from pot
*** SUMMARY ***
Total pot 7,080 | Rake 0 | Jackpot 0 | Bingo 0 | Fortune 0 | Tax 0
Board [8h Th Jd 6d]
Seat 1: efff41bc (button) folded before Flop
Seat 2: 516045fd (small blind) folded before Flop
Seat 3: d4f3a21f (big blind) won (7,080)
Seat 4: 10438ff8 folded before Flop
Seat 5: e9dc2298 folded before Flop
Seat 6: f0bce165 folded before Flop
Seat 7: Hero folded before Flop
Seat 8: d56fa4f5 folded on the Turn


Poker Hand #TM3552362239: Tournament #156543396, Bounty Hunters Special $1.08 Hold'em No Limit - Level8(200/400) - 2024/08/05 10:51:29
Table '119' 8-max Seat #8 is the button
Seat 1: efff41bc (11,385 in chips)
Seat 2: 516045fd (13,689 in chips)
Seat 3: d4f3a21f (18,733 in chips)
Seat 4: 10438ff8 (47,001 in chips)
Seat 5: e9dc2298 (2,328 in chips)
Seat 6: f0bce165 (20,588 in chips)
Seat 7: Hero (15,282 in chips)
Seat 8: d56fa4f5 (27,981 in chips)
e9dc2298: posts the ante 60
10438ff8: posts the ante 60
f0bce165: posts the ante 60
516045fd: posts the ante 60
efff41bc: posts the ante 60
d56fa4f5: posts the ante 60
Hero: posts the ante 60
d4f3a21f: posts the ante 60
efff41bc: posts small blind 200
516045fd: posts big blind 400
*** HOLE CARDS ***
Dealt to efff41bc 
Dealt to 516045fd 
Dealt to d4f3a21f 
Dealt to 10438ff8 
Dealt to e9dc2298 
Dealt to f0bce165 
Dealt to Hero [3s 3c]
Dealt to d56fa4f5 
d4f3a21f: folds
10438ff8: folds
e9dc2298: folds
f0bce165: folds
Hero: calls 400
d56fa4f5: folds
efff41bc: raises 1,680 to 2,080
516045fd: folds
Hero: folds
Uncalled bet (1,680) returned to efff41bc
*** SHOWDOWN ***
efff41bc collected 1,680 from pot
*** SUMMARY ***
Total pot 1,680 | Rake 0 | Jackpot 0 | Bingo 0 | Fortune 0 | Tax 0
Seat 1: efff41bc (small blind) collected (1,680)
Seat 2: 516045fd (big blind) folded before Flop
Seat 3: d4f3a21f folded before Flop
Seat 4: 10438ff8 folded before Flop
Seat 5: e9dc2298 folded before Flop
Seat 6: f0bce165 folded before Flop
Seat 7: Hero folded before Flop
Seat 8: d56fa4f5 (button) folded before Flop


Poker Hand #TM3552362210: Tournament #156543396, Bounty Hunters Special $1.08 Hold'em No Limit - Level8(200/400) - 2024/08/05 10:49:45
Table '119' 8-max Seat #7 is the button
Seat 1: efff41bc (11,845 in chips)
Seat 2: 516045fd (13,749 in chips)
Seat 3: d4f3a21f (35,264 in chips)
Seat 4: 10438ff8 (15,367 in chips)
Seat 5: e9dc2298 (16,531 in chips)
Seat 6: f0bce165 (20,648 in chips)
Seat 7: Hero (15,342 in chips)
Seat 8: d56fa4f5 (28,241 in chips)
e9dc2298: posts the ante 60
10438ff8: posts the ante 60
f0bce165: posts the ante 60
516045fd: posts the ante 60
efff41bc: posts the ante 60
d56fa4f5: posts the ante 60
Hero: posts the ante 60
d4f3a21f: posts the ante 60
d56fa4f5: posts small blind 200
efff41bc: posts big blind 400
*** HOLE CARDS ***
Dealt to efff41bc 
Dealt to 516045fd 
Dealt to d4f3a21f 
Dealt to 10438ff8 
Dealt to e9dc2298 
Dealt to f0bce165 
Dealt to Hero [5s Ks]
Dealt to d56fa4f5 
516045fd: folds
d4f3a21f: calls 400
10438ff8: raises 440 to 840
e9dc2298: raises 1,560 to 2,400
f0bce165: folds
Hero: folds
d56fa4f5: folds
efff41bc: folds
d4f3a21f: calls 2,000
10438ff8: calls 1,560
*** FLOP *** [Jh 6h Td]
d4f3a21f: checks
10438ff8: bets 12,907 and is all-in
e9dc2298: calls 12,907
d4f3a21f: raises 12,907 to 25,814
e9dc2298: calls 1,164 and is all-in
Uncalled bet (11,743) returned to d4f3a21f
d4f3a21f: shows [9d 6d] (Pair of Sixes)
10438ff8: shows [Js Ad] (Pair of Jacks)
e9dc2298: shows [Qh Jd] (Pair of Jacks)
*** TURN *** [Jh 6h Td] [3h]
*** RIVER *** [Jh 6h Td 3h] [8d]
*** SHOWDOWN ***
10438ff8 collected 47,001 from pot
e9dc2298 collected 2,328 from pot
*** SUMMARY ***
Total pot 49,329 | Rake 0 | Jackpot 0 | Bingo 0 | Fortune 0 | Tax 0
Board [Jh 6h Td 3h 8d]
Seat 1: efff41bc (big blind) folded before Flop
Seat 2: 516045fd folded before Flop
Seat 3: d4f3a21f showed [9d 6d] and lost with Pair of Sixes
Seat 4: 10438ff8 showed [Js Ad] and won (47,001) with Pair of Jacks
Seat 5: e9dc2298 showed [Qh Jd] and won (2,328) with Pair of Jacks
Seat 6: f0bce165 folded before Flop
Seat 7: Hero (button) folded before Flop
Seat 8: d56fa4f5 (small blind) folded before Flop


Poker Hand #TM3552362187: Tournament #156543396, Bounty Hunters Special $1.08 Hold'em No Limit - Level8(200/400) - 2024/08/05 10:48:25
Table '119' 8-max Seat #6 is the button
Seat 1: efff41bc (12,305 in chips)
Seat 2: 516045fd (13,809 in chips)
Seat 3: d4f3a21f (35,324 in chips)
Seat 4: 10438ff8 (11,547 in chips)
Seat 5: e9dc2298 (18,991 in chips)
Seat 6: f0bce165 (20,708 in chips)
Seat 7: Hero (15,602 in chips)
Seat 8: d56fa4f5 (28,701 in chips)
e9dc2298: posts the ante 60
10438ff8: posts the ante 60
f0bce165: posts the ante 60
516045fd: posts the ante 60
efff41bc: posts the ante 60
d56fa4f5: posts the ante 60
d4f3a21f: posts the ante 60
Hero: posts the ante 60
Hero: posts small blind 200
d56fa4f5: posts big blind 400
*** HOLE CARDS ***
Dealt to efff41bc 
Dealt to 516045fd 
Dealt to d4f3a21f 
Dealt to 10438ff8 
Dealt to e9dc2298 
Dealt to f0bce165 
Dealt to Hero [Js Qs]
Dealt to d56fa4f5 
efff41bc: calls 400
516045fd: folds
d4f3a21f: folds
10438ff8: raises 440 to 840
e9dc2298: raises 1,560 to 2,400
f0bce165: folds
Hero: folds
d56fa4f5: folds
efff41bc: folds
10438ff8: raises 6,280 to 8,680
e9dc2298: folds
Uncalled bet (6,280) returned to 10438ff8
*** SHOWDOWN ***
10438ff8 collected 6,280 from pot
*** SUMMARY ***
Total pot 6,280 | Rake 0 | Jackpot 0 | Bingo 0 | Fortune 0 | Tax 0
Seat 1: efff41bc folded before Flop
Seat 2: 516045fd folded before Flop
Seat 3: d4f3a21f folded before Flop
Seat 4: 10438ff8 collected (6,280)
Seat 5: e9dc2298 folded before Flop
Seat 6: f0bce165 (button) folded before Flop
Seat 7: Hero (small blind) folded before Flop
Seat 8: d56fa4f5 (big blind) folded before Flop


Poker Hand #TM3552362162: Tournament #156543396, Bounty Hunters Special $1.08 Hold'em No Limit - Level8(200/400) - 2024/08/05 10:47:06
Table '119' 8-max Seat #5 is the button
Seat 1: efff41bc (12,365 in chips)
Seat 2: 516045fd (13,869 in chips)
Seat 3: d4f3a21f (36,984 in chips)
Seat 4: 10438ff8 (13,207 in chips)
Seat 5: e9dc2298 (19,051 in chips)
Seat 6: f0bce165 (21,168 in chips)
Seat 7: Hero (11,582 in chips)
Seat 8: d56fa4f5 (28,761 in chips)
e9dc2298: posts the ante 60
10438ff8: posts the ante 60
516045fd: posts the ante 60
efff41bc: posts the ante 60
f0bce165: posts the ante 60
d56fa4f5: posts the ante 60
d4f3a21f: posts the ante 60
Hero: posts the ante 60
f0bce165: posts small blind 200
Hero: posts big blind 400
*** HOLE CARDS ***
Dealt to efff41bc 
Dealt to 516045fd 
Dealt to d4f3a21f 
Dealt to 10438ff8 
Dealt to e9dc2298 
Dealt to f0bce165 
Dealt to Hero [As Jd]
Dealt to d56fa4f5 
d56fa4f5: folds
efff41bc: folds
516045fd: folds
d4f3a21f: calls 400
10438ff8: calls 400
e9dc2298: folds
f0bce165: calls 200
Hero: raises 1,200 to 1,600
d4f3a21f: calls 1,200
10438ff8: calls 1,200
f0bce165: folds
*** FLOP *** [9h 2c 3c]
Hero: checks
d4f3a21f: checks
10438ff8: checks
*** TURN *** [9h 2c 3c] [4s]
Hero: bets 2,840
d4f3a21f: folds
10438ff8: folds
Uncalled bet (2,840) returned to Hero
*** SHOWDOWN ***
Hero collected 5,680 from pot
*** SUMMARY ***
Total pot 5,680 | Rake 0 | Jackpot 0 | Bingo 0 | Fortune 0 | Tax 0
Board [9h 2c 3c 4s]
Seat 1: efff41bc folded before Flop
Seat 2: 516045fd folded before Flop
Seat 3: d4f3a21f folded on the Turn
Seat 4: 10438ff8 folded on the Turn
Seat 5: e9dc2298 (button) folded before Flop
Seat 6: f0bce165 (small blind) folded before Flop
Seat 7: Hero (big blind) won (5,680)
Seat 8: d56fa4f5 folded before Flop


Poker Hand #TM3552362138: Tournament #156543396, Bounty Hunters Special $1.08 Hold'em No Limit - Level7(175/350) - 2024/08/05 10:45:57
Table '119' 8-max Seat #4 is the button
Seat 2: 516045fd (13,919 in chips)
Seat 3: d4f3a21f (31,959 in chips)
Seat 4: 10438ff8 (13,257 in chips)
Seat 5: e9dc2298 (19,276 in chips)
Seat 6: f0bce165 (21,568 in chips)
Seat 7: Hero (11,632 in chips)
Seat 8: d56fa4f5 (33,011 in chips)
e9dc2298: posts the ante 50
10438ff8: posts the ante 50
516045fd: posts the ante 50
f0bce165: posts the ante 50
d56fa4f5: posts the ante 50
d4f3a21f: posts the ante 50
Hero: posts the ante 50
e9dc2298: posts small blind 175
f0bce165: posts big blind 350
*** HOLE CARDS ***
Dealt to 516045fd 
Dealt to d4f3a21f 
Dealt to 10438ff8 
Dealt to e9dc2298 
Dealt to f0bce165 
Dealt to Hero [5h 8s]
Dealt to d56fa4f5 
Hero: folds
d56fa4f5: raises 350 to 700
516045fd: folds
d4f3a21f: calls 700
10438ff8: folds
e9dc2298: folds
f0bce165: folds
*** FLOP *** [9c Ks 4d]
d56fa4f5: checks
d4f3a21f: checks
*** TURN *** [9c Ks 4d] [2d]
d56fa4f5: checks
d4f3a21f: bets 1,050
d56fa4f5: calls 1,050
*** RIVER *** [9c Ks 4d 2d] [Th]
d56fa4f5: checks
d4f3a21f: bets 2,450
d56fa4f5: calls 2,450
d4f3a21f: shows [Kd Qd] (Pair of Kings)
d56fa4f5: shows [Jc Ts] (Pair of Tens)
*** SHOWDOWN ***
d4f3a21f collected 9,275 from pot
*** SUMMARY ***
Total pot 9,275 | Rake 0 | Jackpot 0 | Bingo 0 | Fortune 0 | Tax 0
Board [9c Ks 4d 2d Th]
Seat 2: 516045fd folded before Flop
Seat 3: d4f3a21f showed [Kd Qd] and won (9,275) with Pair of Kings
Seat 4: 10438ff8 (button) folded before Flop
Seat 5: e9dc2298 (small blind) folded before Flop
Seat 6: f0bce165 (big blind) folded before Flop
Seat 7: Hero folded before Flop
Seat 8: d56fa4f5 showed [Jc Ts] and lost with Pair of Tens


Poker Hand #TM3552362117: Tournament #156543396, Bounty Hunters Special $1.08 Hold'em No Limit - Level7(175/350) - 2024/08/05 10:44:56
Table '119' 8-max Seat #3 is the button
Seat 1: b895559f (7,710 in chips)
Seat 2: 516045fd (13,969 in chips)
Seat 3: d4f3a21f (32,009 in chips)
Seat 4: 10438ff8 (13,482 in chips)
Seat 5: e9dc2298 (19,676 in chips)
Seat 6: f0bce165 (21,618 in chips)
Seat 7: Hero (11,682 in chips)
Seat 8: d56fa4f5 (24,476 in chips)
e9dc2298: posts the ante 50
b895559f: posts the ante 50
10438ff8: posts the ante 50
516045fd: posts the ante 50
f0bce165: posts the ante 50
d56fa4f5: posts the ante 50
d4f3a21f: posts the ante 50
Hero: posts the ante 50
10438ff8: posts small blind 175
e9dc2298: posts big blind 350
*** HOLE CARDS ***
Dealt to b895559f 
Dealt to 516045fd 
Dealt to d4f3a21f 
Dealt to 10438ff8 
Dealt to e9dc2298 
Dealt to f0bce165 
Dealt to Hero [Ad 3s]
Dealt to d56fa4f5 
f0bce165: folds
Hero: folds
d56fa4f5: raises 350 to 700
b895559f: raises 6,960 to 7,660 and is all-in
516045fd: folds
d4f3a21f: folds
10438ff8: folds
e9dc2298: folds
d56fa4f5: calls 6,960
b895559f: shows [5c 5s]
d56fa4f5: shows [Qc 9c]
*** FLOP *** [8d Qs 3h]
*** TURN *** [8d Qs 3h] [9d]
*** RIVER *** [8d Qs 3h 9d] [2h]
*** SHOWDOWN ***
d56fa4f5 collected 16,245 from pot
*** SUMMARY ***
Total pot 16,245 | Rake 0 | Jackpot 0 | Bingo 0 | Fortune 0 | Tax 0
Board [8d Qs 3h 9d 2h]
Seat 1: b895559f showed [5c 5s] and lost with Pair of Fives
Seat 2: 516045fd folded before Flop
Seat 3: d4f3a21f (button) folded before Flop
Seat 4: 10438ff8 (small blind) folded before Flop
Seat 5: e9dc2298 (big blind) folded before Flop
Seat 6: f0bce165 folded before Flop
Seat 7: Hero folded before Flop
Seat 8: d56fa4f5 showed [Qc 9c] and won (16,245) with Pair of Queens and Pair of Nines


Poker Hand #TM3552362104: Tournament #156543396, Bounty Hunters Special $1.08 Hold'em No Limit - Level7(175/350) - 2024/08/05 10:44:02
Table '119' 8-max Seat #2 is the button
Seat 1: b895559f (13,932 in chips)
Seat 2: 516045fd (6,222 in chips)
Seat 3: d4f3a21f (32,234 in chips)
Seat 4: 10438ff8 (13,882 in chips)
Seat 5: e9dc2298 (19,726 in chips)
Seat 6: f0bce165 (21,668 in chips)
Seat 7: Hero (11,732 in chips)
Seat 8: d56fa4f5 (25,226 in chips)
e9dc2298: posts the ante 50
b895559f: posts the ante 50
10438ff8: posts the ante 50
516045fd: posts the ante 50
f0bce165: posts the ante 50
d56fa4f5: posts the ante 50
Hero: posts the ante 50
d4f3a21f: posts the ante 50
d4f3a21f: posts small blind 175
10438ff8: posts big blind 350
*** HOLE CARDS ***
Dealt to b895559f 
Dealt to 516045fd 
Dealt to d4f3a21f 
Dealt to 10438ff8 
Dealt to e9dc2298 
Dealt to f0bce165 
Dealt to Hero [6s 2d]
Dealt to d56fa4f5 
e9dc2298: folds
f0bce165: folds
Hero: folds
d56fa4f5: raises 350 to 700
b895559f: raises 13,182 to 13,882 and is all-in
516045fd: calls 6,172 and is all-in
d4f3a21f: folds
10438ff8: folds
d56fa4f5: folds
Uncalled bet (7,710) returned to b895559f
b895559f: shows [3c As]
516045fd: shows [Ts Ah]
*** FLOP *** [Jc 5d 2c]
*** TURN *** [Jc 5d 2c] [9s]
*** RIVER *** [Jc 5d 2c 9s] [9h]
*** SHOWDOWN ***
516045fd collected 13,969 from pot
*** SUMMARY ***
Total pot 13,969 | Rake 0 | Jackpot 0 | Bingo 0 | Fortune 0 | Tax 0
Board [Jc 5d 2c 9s 9h]
Seat 1: b895559f showed [3c As] and lost with Pair of Nines
Seat 2: 516045fd (button) showed [Ts Ah] and won (13,969) with Pair of Nines
Seat 3: d4f3a21f (small blind) folded before Flop
Seat 4: 10438ff8 (big blind) folded before Flop
Seat 5: e9dc2298 folded before Flop
Seat 6: f0bce165 folded before Flop
Seat 7: Hero folded before Flop
Seat 8: d56fa4f5 folded before Flop


Poker Hand #TM3552362086: Tournament #156543396, Bounty Hunters Special $1.08 Hold'em No Limit - Level7(175/350) - 2024/08/05 10:42:44
Table '119' 8-max Seat #1 is the button
Seat 1: b895559f (13,982 in chips)
Seat 2: 516045fd (6,972 in chips)
Seat 3: d4f3a21f (31,184 in chips)
Seat 4: 10438ff8 (13,932 in chips)
Seat 5: e9dc2298 (19,776 in chips)
Seat 6: f0bce165 (21,718 in chips)
Seat 7: Hero (11,782 in chips)
Seat 8: d56fa4f5 (25,276 in chips)
e9dc2298: posts the ante 50
b895559f: posts the ante 50
10438ff8: posts the ante 50
f0bce165: posts the ante 50
516045fd: posts the ante 50
d56fa4f5: posts the ante 50
Hero: posts the ante 50
d4f3a21f: posts the ante 50
516045fd: posts small blind 175
d4f3a21f: posts big blind 350
*** HOLE CARDS ***
Dealt to b895559f 
Dealt to 516045fd 
Dealt to d4f3a21f 
Dealt to 10438ff8 
Dealt to e9dc2298 
Dealt to f0bce165 
Dealt to Hero [2h 4c]
Dealt to d56fa4f5 
10438ff8: folds
e9dc2298: folds
f0bce165: folds
Hero: folds
d56fa4f5: folds
b895559f: folds
516045fd: calls 175
d4f3a21f: checks
*** FLOP *** [7c Ks 6h]
516045fd: bets 350
d4f3a21f: calls 350
*** TURN *** [7c Ks 6h] [Ah]
516045fd: checks
d4f3a21f: bets 1,400
516045fd: folds
Uncalled bet (1,400) returned to d4f3a21f
*** SHOWDOWN ***
d4f3a21f collected 1,800 from pot
*** SUMMARY ***
Total pot 1,800 | Rake 0 | Jackpot 0 | Bingo 0 | Fortune 0 | Tax 0
Board [7c Ks 6h Ah]
Seat 1: b895559f (button) folded before Flop
Seat 2: 516045fd (small blind) folded on the Turn
Seat 3: d4f3a21f (big blind) won (1,800)
Seat 4: 10438ff8 folded before Flop
Seat 5: e9dc2298 folded before Flop
Seat 6: f0bce165 folded before Flop
Seat 7: Hero folded before Flop
Seat 8: d56fa4f5 folded before Flop


Poker Hand #TM3552362075: Tournament #156543396, Bounty Hunters Special $1.08 Hold'em No Limit - Level7(175/350) - 2024/08/05 10:42:07
Table '119' 8-max Seat #8 is the button
Seat 1: b895559f (14,207 in chips)
Seat 2: 516045fd (7,372 in chips)
Seat 3: d4f3a21f (31,584 in chips)
Seat 4: 10438ff8 (16,782 in chips)
Seat 5: e9dc2298 (15,751 in chips)
Seat 6: f0bce165 (21,768 in chips)
Seat 7: Hero (11,832 in chips)
Seat 8: d56fa4f5 (25,326 in chips)
e9dc2298: posts the ante 50
b895559f: posts the ante 50
10438ff8: posts the ante 50
f0bce165: posts the ante 50
516045fd: posts the ante 50
d56fa4f5: posts the ante 50
Hero: posts the ante 50
d4f3a21f: posts the ante 50
b895559f: posts small blind 175
516045fd: posts big blind 350
*** HOLE CARDS ***
Dealt to b895559f 
Dealt to 516045fd 
Dealt to d4f3a21f 
Dealt to 10438ff8 
Dealt to e9dc2298 
Dealt to f0bce165 
Dealt to Hero [2s 8s]
Dealt to d56fa4f5 
d4f3a21f: calls 350
10438ff8: raises 385 to 735
e9dc2298: raises 2,065 to 2,800
f0bce165: folds
Hero: folds
d56fa4f5: folds
b895559f: folds
516045fd: folds
d4f3a21f: folds
10438ff8: calls 2,065
*** FLOP *** [7h 3s 2h]
10438ff8: checks
e9dc2298: bets 3,438
10438ff8: folds
Uncalled bet (3,438) returned to e9dc2298
*** SHOWDOWN ***
e9dc2298 collected 6,875 from pot
*** SUMMARY ***
Total pot 6,875 | Rake 0 | Jackpot 0 | Bingo 0 | Fortune 0 | Tax 0
Board [7h 3s 2h]
Seat 1: b895559f (small blind) folded before Flop
Seat 2: 516045fd (big blind) folded before Flop
Seat 3: d4f3a21f folded before Flop
Seat 4: 10438ff8 folded on the Flop
Seat 5: e9dc2298 won (6,875)
Seat 6: f0bce165 folded before Flop
Seat 7: Hero folded before Flop
Seat 8: d56fa4f5 (button) folded before Flop


Poker Hand #TM3552362067: Tournament #156543396, Bounty Hunters Special $1.08 Hold'em No Limit - Level7(175/350) - 2024/08/05 10:41:21
Table '119' 8-max Seat #7 is the button
Seat 1: b895559f (14,607 in chips)
Seat 2: 516045fd (7,422 in chips)
Seat 3: d4f3a21f (31,634 in chips)
Seat 4: 10438ff8 (15,172 in chips)
Seat 5: e9dc2298 (15,801 in chips)
Seat 6: f0bce165 (21,818 in chips)
Seat 7: Hero (12,617 in chips)
Seat 8: d56fa4f5 (25,551 in chips)
e9dc2298: posts the ante 50
b895559f: posts the ante 50
10438ff8: posts the ante 50
f0bce165: posts the ante 50
516045fd: posts the ante 50
d56fa4f5: posts the ante 50
Hero: posts the ante 50
d4f3a21f: posts the ante 50
d56fa4f5: posts small blind 175
b895559f: posts big blind 350
*** HOLE CARDS ***
Dealt to b895559f 
Dealt to 516045fd 
Dealt to d4f3a21f 
Dealt to 10438ff8 
Dealt to e9dc2298 
Dealt to f0bce165 
Dealt to Hero [6c 7s]
Dealt to d56fa4f5 
516045fd: folds
d4f3a21f: folds
10438ff8: raises 385 to 735
e9dc2298: folds
f0bce165: folds
Hero: calls 735
d56fa4f5: folds
b895559f: folds
*** FLOP *** [6h As Tc]
10438ff8: bets 1,198
Hero: folds
Uncalled bet (1,198) returned to 10438ff8
*** SHOWDOWN ***
10438ff8 collected 2,395 from pot
*** SUMMARY ***
Total pot 2,395 | Rake 0 | Jackpot 0 | Bingo 0 | Fortune 0 | Tax 0
Board [6h As Tc]
Seat 1: b895559f (big blind) folded before Flop
Seat 2: 516045fd folded before Flop
Seat 3: d4f3a21f folded before Flop
Seat 4: 10438ff8 won (2,395)
Seat 5: e9dc2298 folded before Flop
Seat 6: f0bce165 folded before Flop
Seat 7: Hero (button) folded on the Flop
Seat 8: d56fa4f5 (small blind) folded before Flop


Poker Hand #TM3552362049: Tournament #156543396, Bounty Hunters Special $1.08 Hold'em No Limit - Level7(175/350) - 2024/08/05 10:40:27
Table '119' 8-max Seat #6 is the button
Seat 1: b895559f (14,657 in chips)
Seat 2: 516045fd (8,547 in chips)
Seat 3: d4f3a21f (31,684 in chips)
Seat 4: 10438ff8 (15,222 in chips)
Seat 5: e9dc2298 (15,851 in chips)
Seat 6: f0bce165 (21,868 in chips)
Seat 7: Hero (10,842 in chips)
Seat 8: d56fa4f5 (25,951 in chips)
e9dc2298: posts the ante 50
b895559f: posts the ante 50
10438ff8: posts the ante 50
f0bce165: posts the ante 50
516045fd: posts the ante 50
d56fa4f5: posts the ante 50
d4f3a21f: posts the ante 50
Hero: posts the ante 50
Hero: posts small blind 175
d56fa4f5: posts big blind 350
*** HOLE CARDS ***
Dealt to b895559f 
Dealt to 516045fd 
Dealt to d4f3a21f 
Dealt to 10438ff8 
Dealt to e9dc2298 
Dealt to f0bce165 
Dealt to Hero [Qc Ah]
Dealt to d56fa4f5 
b895559f: folds
516045fd: calls 350
d4f3a21f: folds
10438ff8: folds
e9dc2298: folds
f0bce165: folds
Hero: raises 725 to 1,075
d56fa4f5: folds
516045fd: calls 725
*** FLOP *** [2h 6h 6s]
Hero: checks
516045fd: checks
*** TURN *** [2h 6h 6s] [Qd]
Hero: bets 1,450
516045fd: folds
Uncalled bet (1,450) returned to Hero
*** SHOWDOWN ***
Hero collected 2,900 from pot
*** SUMMARY ***
Total pot 2,900 | Rake 0 | Jackpot 0 | Bingo 0 | Fortune 0 | Tax 0
Board [2h 6h 6s Qd]
Seat 1: b895559f folded before Flop
Seat 2: 516045fd folded on the Turn
Seat 3: d4f3a21f folded before Flop
Seat 4: 10438ff8 folded before Flop
Seat 5: e9dc2298 folded before Flop
Seat 6: f0bce165 (button) folded before Flop
Seat 7: Hero (small blind) won (2,900)
Seat 8: d56fa4f5 (big blind) folded before Flop


Poker Hand #TM3552362033: Tournament #156543396, Bounty Hunters Special $1.08 Hold'em No Limit - Level7(175/350) - 2024/08/05 10:39:31
Table '119' 8-max Seat #5 is the button
Seat 1: b895559f (14,707 in chips)
Seat 2: 516045fd (8,597 in chips)
Seat 3: d4f3a21f (31,734 in chips)
Seat 4: 10438ff8 (17,722 in chips)
Seat 5: e9dc2298 (12,526 in chips)
Seat 6: f0bce165 (22,093 in chips)
Seat 7: Hero (11,242 in chips)
Seat 8: d56fa4f5 (26,001 in chips)
e9dc2298: posts the ante 50
b895559f: posts the ante 50
10438ff8: posts the ante 50
516045fd: posts the ante 50
f0bce165: posts the ante 50
d56fa4f5: posts the ante 50
d4f3a21f: posts the ante 50
Hero: posts the ante 50
f0bce165: posts small blind 175
Hero: posts big blind 350
*** HOLE CARDS ***
Dealt to b895559f 
Dealt to 516045fd 
Dealt to d4f3a21f 
Dealt to 10438ff8 
Dealt to e9dc2298 
Dealt to f0bce165 
Dealt to Hero [9d Jh]
Dealt to d56fa4f5 
d56fa4f5: folds
b895559f: folds
516045fd: folds
d4f3a21f: folds
10438ff8: raises 385 to 735
e9dc2298: raises 1,715 to 2,450
f0bce165: folds
Hero: folds
10438ff8: calls 1,715
*** FLOP *** [4h Qc Jd]
10438ff8: checks
e9dc2298: bets 1,923
10438ff8: folds
Uncalled bet (1,923) returned to e9dc2298
*** SHOWDOWN ***
e9dc2298 collected 5,825 from pot
*** SUMMARY ***
Total pot 5,825 | Rake 0 | Jackpot 0 | Bingo 0 | Fortune 0 | Tax 0
Board [4h Qc Jd]
Seat 1: b895559f folded before Flop
Seat 2: 516045fd folded before Flop
Seat 3: d4f3a21f folded before Flop
Seat 4: 10438ff8 folded on the Flop
Seat 5: e9dc2298 (button) won (5,825)
Seat 6: f0bce165 (small blind) folded before Flop
Seat 7: Hero (big blind) folded before Flop
Seat 8: d56fa4f5 folded before Flop


Poker Hand #TM3552362017: Tournament #156543396, Bounty Hunters Special $1.08 Hold'em No Limit - Level7(175/350) - 2024/08/05 10:38:16
Table '119' 8-max Seat #4 is the button
Seat 1: b895559f (26,945 in chips)
Seat 2: 516045fd (8,647 in chips)
Seat 3: d4f3a21f (31,784 in chips)
Seat 4: 10438ff8 (17,772 in chips)
Seat 5: e9dc2298 (12,751 in chips)
Seat 6: f0bce165 (22,493 in chips)
Seat 7: Hero (11,992 in chips)
Seat 8: d56fa4f5 (12,238 in chips)
e9dc2298: posts the ante 50
b895559f: posts the ante 50
10438ff8: posts the ante 50
516045fd: posts the ante 50
f0bce165: posts the ante 50
d56fa4f5: posts the ante 50
d4f3a21f: posts the ante 50
Hero: posts the ante 50
e9dc2298: posts small blind 175
f0bce165: posts big blind 350
*** HOLE CARDS ***
Dealt to b895559f 
Dealt to 516045fd 
Dealt to d4f3a21f 
Dealt to 10438ff8 
Dealt to e9dc2298 
Dealt to f0bce165 
Dealt to Hero [Kh Td]
Dealt to d56fa4f5 
Hero: raises 350 to 700
d56fa4f5: raises 11,488 to 12,188 and is all-in
b895559f: raises 14,707 to 26,895 and is all-in
516045fd: folds
d4f3a21f: folds
10438ff8: folds
e9dc2298: folds
f0bce165: folds
Hero: folds
Uncalled bet (14,707) returned to b895559f
b895559f: shows [Jc Qd]
d56fa4f5: shows [Qs Ah]
*** FLOP *** [2d 7h 8c]
*** TURN *** [2d 7h 8c] [2s]
*** RIVER *** [2d 7h 8c 2s] [2c]
*** SHOWDOWN ***
d56fa4f5 collected 26,001 from pot
*** SUMMARY ***
Total pot 26,001 | Rake 0 | Jackpot 0 | Bingo 0 | Fortune 0 | Tax 0
Board [2d 7h 8c 2s 2c]
Seat 1: b895559f showed [Jc Qd] and lost with Three Twos
Seat 2: 516045fd folded before Flop
Seat 3: d4f3a21f folded before Flop
Seat 4: 10438ff8 (button) folded before Flop
Seat 5: e9dc2298 (small blind) folded before Flop
Seat 6: f0bce165 (big blind) folded before Flop
Seat 7: Hero folded before Flop
Seat 8: d56fa4f5 showed [Qs Ah] and won (26,001) with Three Twos


Poker Hand #TM3552362003: Tournament #156543396, Bounty Hunters Special $1.08 Hold'em No Limit - Level7(175/350) - 2024/08/05 10:37:14
Table '119' 8-max Seat #3 is the button
Seat 1: b895559f (26,995 in chips)
Seat 2: 516045fd (9,397 in chips)
Seat 3: d4f3a21f (30,209 in chips)
Seat 4: 10438ff8 (17,997 in chips)
Seat 5: e9dc2298 (13,151 in chips)
Seat 6: f0bce165 (22,543 in chips)
Seat 7: Hero (12,042 in chips)
Seat 8: d56fa4f5 (12,288 in chips)
e9dc2298: posts the ante 50
b895559f: posts the ante 50
10438ff8: posts the ante 50
516045fd: posts the ante 50
f0bce165: posts the ante 50
d56fa4f5: posts the ante 50
d4f3a21f: posts the ante 50
Hero: posts the ante 50
10438ff8: posts small blind 175
e9dc2298: posts big blind 350
*** HOLE CARDS ***
Dealt to b895559f 
Dealt to 516045fd 
Dealt to d4f3a21f 
Dealt to 10438ff8 
Dealt to e9dc2298 
Dealt to f0bce165 
Dealt to Hero [3h Tc]
Dealt to d56fa4f5 
f0bce165: folds
Hero: folds
d56fa4f5: folds
b895559f: folds
516045fd: raises 350 to 700
d4f3a21f: raises 1,050 to 1,750
10438ff8: folds
e9dc2298: folds
516045fd: folds
Uncalled bet (1,050) returned to d4f3a21f
*** SHOWDOWN ***
d4f3a21f collected 2,325 from pot
*** SUMMARY ***
Total pot 2,325 | Rake 0 | Jackpot 0 | Bingo 0 | Fortune 0 | Tax 0
Seat 1: b895559f folded before Flop
Seat 2: 516045fd folded before Flop
Seat 3: d4f3a21f (button) collected (2,325)
Seat 4: 10438ff8 (small blind) folded before Flop
Seat 5: e9dc2298 (big blind) folded before Flop
Seat 6: f0bce165 folded before Flop
Seat 7: Hero folded before Flop
Seat 8: d56fa4f5 folded before Flop


Poker Hand #TM3552361988: Tournament #156543396, Bounty Hunters Special $1.08 Hold'em No Limit - Level6(150/300) - 2024/08/05 10:36:31
Table '119' 8-max Seat #2 is the button
Seat 1: b895559f (27,040 in chips)
Seat 2: 516045fd (9,442 in chips)
Seat 3: d4f3a21f (30,404 in chips)
Seat 4: 10438ff8 (18,342 in chips)
Seat 5: e9dc2298 (12,386 in chips)
Seat 6: f0bce165 (22,588 in chips)
Seat 7: Hero (12,087 in chips)
Seat 8: d56fa4f5 (12,333 in chips)
e9dc2298: posts the ante 45
b895559f: posts the ante 45
10438ff8: posts the ante 45
516045fd: posts the ante 45
f0bce165: posts the ante 45
d56fa4f5: posts the ante 45
Hero: posts the ante 45
d4f3a21f: posts the ante 45
d4f3a21f: posts small blind 150
10438ff8: posts big blind 300
*** HOLE CARDS ***
Dealt to b895559f 
Dealt to 516045fd 
Dealt to d4f3a21f 
Dealt to 10438ff8 
Dealt to e9dc2298 
Dealt to f0bce165 
Dealt to Hero [2h 8c]
Dealt to d56fa4f5 
e9dc2298: raises 300 to 600
f0bce165: folds
Hero: folds
d56fa4f5: folds
b895559f: folds
516045fd: folds
d4f3a21f: folds
10438ff8: folds
Uncalled bet (300) returned to e9dc2298
*** SHOWDOWN ***
e9dc2298 collected 1,110 from pot
*** SUMMARY ***
Total pot 1,110 | Rake 0 | Jackpot 0 | Bingo 0 | Fortune 0 | Tax 0
Seat 1: b895559f folded before Flop
Seat 2: 516045fd (button) folded before Flop
Seat 3: d4f3a21f (small blind) folded before Flop
Seat 4: 10438ff8 (big blind) folded before Flop
Seat 5: e9dc2298 collected (1,110)
Seat 6: f0bce165 folded before Flop
Seat 7: Hero folded before Flop
Seat 8: d56fa4f5 folded before Flop


Poker Hand #TM3552361969: Tournament #156543396, Bounty Hunters Special $1.08 Hold'em No Limit - Level6(150/300) - 2024/08/05 10:35:30
Table '119' 8-max Seat #1 is the button
Seat 1: b895559f (12,860 in chips)
Seat 2: 516045fd (9,637 in chips)
Seat 3: d4f3a21f (43,264 in chips)
Seat 4: 10438ff8 (18,387 in chips)
Seat 5: e9dc2298 (12,431 in chips)
Seat 6: f0bce165 (22,633 in chips)
Seat 7: Hero (12,132 in chips)
Seat 8: d56fa4f5 (13,278 in chips)
e9dc2298: posts the ante 45
b895559f: posts the ante 45
10438ff8: posts the ante 45
f0bce165: posts the ante 45
516045fd: posts the ante 45
d56fa4f5: posts the ante 45
Hero: posts the ante 45
d4f3a21f: posts the ante 45
516045fd: posts small blind 150
d4f3a21f: posts big blind 300
*** HOLE CARDS ***
Dealt to b895559f 
Dealt to 516045fd 
Dealt to d4f3a21f 
Dealt to 10438ff8 
Dealt to e9dc2298 
Dealt to f0bce165 
Dealt to Hero [4s Th]
Dealt to d56fa4f5 
10438ff8: folds
e9dc2298: folds
f0bce165: folds
Hero: folds
d56fa4f5: raises 600 to 900
b895559f: raises 11,915 to 12,815 and is all-in
516045fd: folds
d4f3a21f: calls 12,515
d56fa4f5: folds
b895559f: shows [Qd Tc]
d4f3a21f: shows [5d 5h]
*** FLOP *** [9h 8c Jh]
*** TURN *** [9h 8c Jh] [3s]
*** RIVER *** [9h 8c Jh 3s] [Jc]
*** SHOWDOWN ***
b895559f collected 27,040 from pot
*** SUMMARY ***
Total pot 27,040 | Rake 0 | Jackpot 0 | Bingo 0 | Fortune 0 | Tax 0
Board [9h 8c Jh 3s Jc]
Seat 1: b895559f (button) showed [Qd Tc] and won (27,040) with Queens-High Straight
Seat 2: 516045fd (small blind) folded before Flop
Seat 3: d4f3a21f (big blind) showed [5d 5h] and lost with Pair of Jacks and Pair of Fives
Seat 4: 10438ff8 folded before Flop
Seat 5: e9dc2298 folded before Flop
Seat 6: f0bce165 folded before Flop
Seat 7: Hero folded before Flop
Seat 8: d56fa4f5 folded before Flop


Poker Hand #TM3552361944: Tournament #156543396, Bounty Hunters Special $1.08 Hold'em No Limit - Level6(150/300) - 2024/08/05 10:33:41
Table '119' 8-max Seat #8 is the button
Seat 1: b895559f (13,055 in chips)
Seat 2: 516045fd (12,266 in chips)
Seat 3: d4f3a21f (43,309 in chips)
Seat 4: 10438ff8 (18,432 in chips)
Seat 5: e9dc2298 (12,476 in chips)
Seat 6: f0bce165 (22,678 in chips)
Seat 7: Hero (9,083 in chips)
Seat 8: d56fa4f5 (13,323 in chips)
e9dc2298: posts the ante 45
b895559f: posts the ante 45
10438ff8: posts the ante 45
f0bce165: posts the ante 45
516045fd: posts the ante 45
d56fa4f5: posts the ante 45
Hero: posts the ante 45
d4f3a21f: posts the ante 45
b895559f: posts small blind 150
516045fd: posts big blind 300
*** HOLE CARDS ***
Dealt to b895559f 
Dealt to 516045fd 
Dealt to d4f3a21f 
Dealt to 10438ff8 
Dealt to e9dc2298 
Dealt to f0bce165 
Dealt to Hero [Kh Td]
Dealt to d56fa4f5 
d4f3a21f: folds
10438ff8: folds
e9dc2298: folds
f0bce165: folds
Hero: raises 300 to 600
d56fa4f5: folds
b895559f: folds
516045fd: calls 300
*** FLOP *** [7c 3d 5d]
516045fd: checks
Hero: bets 855
516045fd: calls 855
*** TURN *** [7c 3d 5d] [Ts]
516045fd: checks
Hero: bets 1,129
516045fd: calls 1,129
*** RIVER *** [7c 3d 5d Ts] [Ac]
516045fd: checks
Hero: checks
516045fd: shows [4s 5h] (Pair of Fives)
Hero: shows [Kh Td] (Pair of Tens)
*** SHOWDOWN ***
Hero collected 5,678 from pot
*** SUMMARY ***
Total pot 5,678 | Rake 0 | Jackpot 0 | Bingo 0 | Fortune 0 | Tax 0
Board [7c 3d 5d Ts Ac]
Seat 1: b895559f (small blind) folded before Flop
Seat 2: 516045fd (big blind) showed [4s 5h] and lost with Pair of Fives
Seat 3: d4f3a21f folded before Flop
Seat 4: 10438ff8 folded before Flop
Seat 5: e9dc2298 folded before Flop
Seat 6: f0bce165 folded before Flop
Seat 7: Hero showed [Kh Td] and won (5,678) with Pair of Tens
Seat 8: d56fa4f5 (button) folded before Flop


Poker Hand #TM3552361929: Tournament #156543396, Bounty Hunters Special $1.08 Hold'em No Limit - Level6(150/300) - 2024/08/05 10:32:51
Table '119' 8-max Seat #7 is the button
Seat 1: b895559f (6,415 in chips)
Seat 3: d4f3a21f (43,354 in chips)
Seat 4: 10438ff8 (18,477 in chips)
Seat 5: e9dc2298 (12,521 in chips)
Seat 6: f0bce165 (22,723 in chips)
Seat 7: Hero (9,128 in chips)
Seat 8: d56fa4f5 (19,738 in chips)
e9dc2298: posts the ante 45
b895559f: posts the ante 45
10438ff8: posts the ante 45
f0bce165: posts the ante 45
d56fa4f5: posts the ante 45
Hero: posts the ante 45
d4f3a21f: posts the ante 45
d56fa4f5: posts small blind 150
b895559f: posts big blind 300
*** HOLE CARDS ***
Dealt to b895559f 
Dealt to d4f3a21f 
Dealt to 10438ff8 
Dealt to e9dc2298 
Dealt to f0bce165 
Dealt to Hero [4h 5c]
Dealt to d56fa4f5 
d4f3a21f: folds
10438ff8: folds
e9dc2298: folds
f0bce165: folds
Hero: folds
d56fa4f5: raises 19,393 to 19,693 and is all-in
b895559f: calls 6,070 and is all-in
Uncalled bet (13,323) returned to d56fa4f5
d56fa4f5: shows [Jd Qc]
b895559f: shows [Ac 8c]
*** FLOP *** [4d 9s 3h]
*** TURN *** [4d 9s 3h] [Ks]
*** RIVER *** [4d 9s 3h Ks] [6d]
*** SHOWDOWN ***
b895559f collected 13,055 from pot
*** SUMMARY ***
Total pot 13,055 | Rake 0 | Jackpot 0 | Bingo 0 | Fortune 0 | Tax 0
Board [4d 9s 3h Ks 6d]
Seat 1: b895559f (big blind) showed [Ac 8c] and won (13,055) with Ace-High
Seat 3: d4f3a21f folded before Flop
Seat 4: 10438ff8 folded before Flop
Seat 5: e9dc2298 folded before Flop
Seat 6: f0bce165 folded before Flop
Seat 7: Hero (button) folded before Flop
Seat 8: d56fa4f5 (small blind) showed [Jd Qc] and lost with King-High


Poker Hand #TM3552361909: Tournament #156543396, Bounty Hunters Special $1.08 Hold'em No Limit - Level6(150/300) - 2024/08/05 10:31:40
Table '119' 8-max Seat #6 is the button
Seat 1: b895559f (6,460 in chips)
Seat 2: ab157e6 (8,705 in chips)
Seat 3: d4f3a21f (43,399 in chips)
Seat 4: 10438ff8 (9,052 in chips)
Seat 5: e9dc2298 (12,566 in chips)
Seat 6: f0bce165 (22,768 in chips)
Seat 7: Hero (9,323 in chips)
Seat 8: d56fa4f5 (20,083 in chips)
e9dc2298: posts the ante 45
b895559f: posts the ante 45
10438ff8: posts the ante 45
f0bce165: posts the ante 45
ab157e6: posts the ante 45
d56fa4f5: posts the ante 45
d4f3a21f: posts the ante 45
Hero: posts the ante 45
Hero: posts small blind 150
d56fa4f5: posts big blind 300
*** HOLE CARDS ***
Dealt to b895559f 
Dealt to ab157e6 
Dealt to d4f3a21f 
Dealt to 10438ff8 
Dealt to e9dc2298 
Dealt to f0bce165 
Dealt to Hero [4c 9h]
Dealt to d56fa4f5 
b895559f: folds
ab157e6: raises 300 to 600
d4f3a21f: folds
10438ff8: calls 600
e9dc2298: folds
f0bce165: folds
Hero: folds
d56fa4f5: folds
*** FLOP *** [Qd 7c Jc]
ab157e6: bets 1,046
10438ff8: calls 1,046
*** TURN *** [Qd 7c Jc] [Tc]
ab157e6: bets 2,831
10438ff8: raises 4,530 to 7,361 and is all-in
ab157e6: calls 4,183 and is all-in
Uncalled bet (347) returned to 10438ff8
10438ff8: shows [Ts Qs] (Pair of Queens and Pair of Tens)
ab157e6: shows [Ad Ah] (Pair of Aces)
*** RIVER *** [Qd 7c Jc Tc] [6c]
Hero: shows [4c] (Jack High Flush)
*** SHOWDOWN ***
10438ff8 collected 18,130 from pot
*** SUMMARY ***
Total pot 18,130 | Rake 0 | Jackpot 0 | Bingo 0 | Fortune 0 | Tax 0
Board [Qd 7c Jc Tc 6c]
Seat 1: b895559f folded before Flop
Seat 2: ab157e6 showed [Ad Ah] and lost with Pair of Aces
Seat 3: d4f3a21f folded before Flop
Seat 4: 10438ff8 showed [Ts Qs] and won (18,130) with Pair of Queens and Pair of Tens
Seat 5: e9dc2298 folded before Flop
Seat 6: f0bce165 (button) folded before Flop
Seat 7: Hero (small blind) folded before Flop
Seat 8: d56fa4f5 (big blind) folded before Flop


Poker Hand #TM3552361893: Tournament #156543396, Bounty Hunters Special $1.08 Hold'em No Limit - Level6(150/300) - 2024/08/05 10:30:40
Table '119' 8-max Seat #5 is the button
Seat 1: b895559f (6,505 in chips)
Seat 2: ab157e6 (8,750 in chips)
Seat 3: d4f3a21f (33,400 in chips)
Seat 4: 10438ff8 (9,097 in chips)
Seat 5: e9dc2298 (12,611 in chips)
Seat 6: f0bce165 (22,963 in chips)
Seat 7: Hero (9,668 in chips)
Seat 8: 689584e1 (9,279 in chips)
e9dc2298: posts the ante 45
b895559f: posts the ante 45
10438ff8: posts the ante 45
f0bce165: posts the ante 45
ab157e6: posts the ante 45
689584e1: posts the ante 45
d4f3a21f: posts the ante 45
Hero: posts the ante 45
f0bce165: posts small blind 150
Hero: posts big blind 300
*** HOLE CARDS ***
Dealt to b895559f 
Dealt to ab157e6 
Dealt to d4f3a21f 
Dealt to 10438ff8 
Dealt to e9dc2298 
Dealt to f0bce165 
Dealt to Hero [6d 7h]
Dealt to 689584e1 
689584e1: raises 330 to 630
b895559f: folds
ab157e6: folds
d4f3a21f: raises 32,725 to 33,355 and is all-in
10438ff8: folds
e9dc2298: folds
f0bce165: folds
Hero: folds
689584e1: calls 8,604 and is all-in
Uncalled bet (24,121) returned to d4f3a21f
d4f3a21f: shows [Ad Kc]
689584e1: shows [Ah Qd]
*** FLOP *** [2d As 5s]
*** TURN *** [2d As 5s] [Jd]
*** RIVER *** [2d As 5s Jd] [7c]
*** SHOWDOWN ***
d4f3a21f collected 19,278 from pot
*** SUMMARY ***
Total pot 19,278 | Rake 0 | Jackpot 0 | Bingo 0 | Fortune 0 | Tax 0
Board [2d As 5s Jd 7c]
Seat 1: b895559f folded before Flop
Seat 2: ab157e6 folded before Flop
Seat 3: d4f3a21f showed [Ad Kc] and won (19,278) with Pair of Aces
Seat 4: 10438ff8 folded before Flop
Seat 5: e9dc2298 (button) folded before Flop
Seat 6: f0bce165 (small blind) folded before Flop
Seat 7: Hero (big blind) folded before Flop
Seat 8: 689584e1 showed [Ah Qd] and lost with Pair of Aces


Poker Hand #TM3552361873: Tournament #156543396, Bounty Hunters Special $1.08 Hold'em No Limit - Level6(150/300) - 2024/08/05 10:29:47
Table '119' 8-max Seat #4 is the button
Seat 1: b895559f (6,550 in chips)
Seat 2: ab157e6 (8,795 in chips)
Seat 3: d4f3a21f (33,445 in chips)
Seat 4: 10438ff8 (9,142 in chips)
Seat 5: e9dc2298 (12,806 in chips)
Seat 6: f0bce165 (23,308 in chips)
Seat 7: Hero (8,903 in chips)
Seat 8: 689584e1 (9,324 in chips)
e9dc2298: posts the ante 45
b895559f: posts the ante 45
10438ff8: posts the ante 45
f0bce165: posts the ante 45
ab157e6: posts the ante 45
689584e1: posts the ante 45
d4f3a21f: posts the ante 45
Hero: posts the ante 45
e9dc2298: posts small blind 150
f0bce165: posts big blind 300
*** HOLE CARDS ***
Dealt to b895559f 
Dealt to ab157e6 
Dealt to d4f3a21f 
Dealt to 10438ff8 
Dealt to e9dc2298 
Dealt to f0bce165 
Dealt to Hero [Ac Qc]
Dealt to 689584e1 
Hero: calls 300
689584e1: folds
b895559f: folds
ab157e6: folds
d4f3a21f: folds
10438ff8: folds
e9dc2298: folds
f0bce165: checks
*** FLOP *** [9c 2d 7c]
f0bce165: checks
Hero: bets 1,110
f0bce165: folds
Uncalled bet (1,110) returned to Hero
*** SHOWDOWN ***
Hero collected 1,110 from pot
*** SUMMARY ***
Total pot 1,110 | Rake 0 | Jackpot 0 | Bingo 0 | Fortune 0 | Tax 0
Board [9c 2d 7c]
Seat 1: b895559f folded before Flop
Seat 2: ab157e6 folded before Flop
Seat 3: d4f3a21f folded before Flop
Seat 4: 10438ff8 (button) folded before Flop
Seat 5: e9dc2298 (small blind) folded before Flop
Seat 6: f0bce165 (big blind) folded on the Flop
Seat 7: Hero won (1,110)
Seat 8: 689584e1 folded before Flop


Poker Hand #TM3552361862: Tournament #156543396, Bounty Hunters Special $1.08 Hold'em No Limit - Level6(150/300) - 2024/08/05 10:29:13
Table '119' 8-max Seat #2 is the button
Seat 1: b895559f (5,830 in chips)
Seat 2: ab157e6 (8,840 in chips)
Seat 4: 10438ff8 (9,337 in chips)
Seat 5: e9dc2298 (13,151 in chips)
Seat 6: f0bce165 (23,353 in chips)
Seat 7: Hero (8,948 in chips)
Seat 8: 689584e1 (9,369 in chips)
e9dc2298: posts the ante 45
b895559f: posts the ante 45
10438ff8: posts the ante 45
f0bce165: posts the ante 45
ab157e6: posts the ante 45
689584e1: posts the ante 45
Hero: posts the ante 45
10438ff8: posts small blind 150
e9dc2298: posts big blind 300
*** HOLE CARDS ***
Dealt to b895559f 
Dealt to ab157e6 
Dealt to 10438ff8 
Dealt to e9dc2298 
Dealt to f0bce165 
Dealt to Hero [7h Kd]
Dealt to 689584e1 
f0bce165: folds
Hero: folds
689584e1: folds
b895559f: raises 5,485 to 5,785 and is all-in
ab157e6: folds
10438ff8: folds
e9dc2298: folds
Uncalled bet (5,485) returned to b895559f
*** SHOWDOWN ***
b895559f collected 1,065 from pot
*** SUMMARY ***
Total pot 1,065 | Rake 0 | Jackpot 0 | Bingo 0 | Fortune 0 | Tax 0
Seat 1: b895559f collected (1,065)
Seat 2: ab157e6 (button) folded before Flop
Seat 4: 10438ff8 (small blind) folded before Flop
Seat 5: e9dc2298 (big blind) folded before Flop
Seat 6: f0bce165 folded before Flop
Seat 7: Hero folded before Flop
Seat 8: 689584e1 folded before Flop


Poker Hand #TM3552361850: Tournament #156543396, Bounty Hunters Special $1.08 Hold'em No Limit - Level6(150/300) - 2024/08/05 10:28:35
Table '119' 8-max Seat #1 is the button
Seat 1: b895559f (5,110 in chips)
Seat 2: ab157e6 (9,035 in chips)
Seat 4: 10438ff8 (9,682 in chips)
Seat 5: e9dc2298 (13,196 in chips)
Seat 6: f0bce165 (23,398 in chips)
Seat 7: Hero (8,993 in chips)
Seat 8: 689584e1 (9,414 in chips)
e9dc2298: posts the ante 45
b895559f: posts the ante 45
10438ff8: posts the ante 45
f0bce165: posts the ante 45
ab157e6: posts the ante 45
689584e1: posts the ante 45
Hero: posts the ante 45
ab157e6: posts small blind 150
10438ff8: posts big blind 300
*** HOLE CARDS ***
Dealt to b895559f 
Dealt to ab157e6 
Dealt to 10438ff8 
Dealt to e9dc2298 
Dealt to f0bce165 
Dealt to Hero [5h Ts]
Dealt to 689584e1 
e9dc2298: folds
f0bce165: folds
Hero: folds
689584e1: folds
b895559f: raises 4,765 to 5,065 and is all-in
ab157e6: folds
10438ff8: folds
Uncalled bet (4,765) returned to b895559f
*** SHOWDOWN ***
b895559f collected 1,065 from pot
*** SUMMARY ***
Total pot 1,065 | Rake 0 | Jackpot 0 | Bingo 0 | Fortune 0 | Tax 0
Seat 1: b895559f (button) collected (1,065)
Seat 2: ab157e6 (small blind) folded before Flop
Seat 4: 10438ff8 (big blind) folded before Flop
Seat 5: e9dc2298 folded before Flop
Seat 6: f0bce165 folded before Flop
Seat 7: Hero folded before Flop
Seat 8: 689584e1 folded before Flop


Poker Hand #TM3552361839: Tournament #156543396, Bounty Hunters Special $1.08 Hold'em No Limit - Level6(150/300) - 2024/08/05 10:27:51
Table '119' 8-max Seat #8 is the button
Seat 1: b895559f (5,305 in chips)
Seat 2: ab157e6 (9,980 in chips)
Seat 3: 7cdddcd (13,760 in chips)
Seat 4: 10438ff8 (9,727 in chips)
Seat 5: e9dc2298 (13,241 in chips)
Seat 6: f0bce165 (23,443 in chips)
Seat 7: Hero (7,628 in chips)
Seat 8: 689584e1 (9,459 in chips)
e9dc2298: posts the ante 45
b895559f: posts the ante 45
10438ff8: posts the ante 45
f0bce165: posts the ante 45
7cdddcd: posts the ante 45
ab157e6: posts the ante 45
689584e1: posts the ante 45
Hero: posts the ante 45
b895559f: posts small blind 150
ab157e6: posts big blind 300
*** HOLE CARDS ***
Dealt to b895559f 
Dealt to ab157e6 
Dealt to 7cdddcd 
Dealt to 10438ff8 
Dealt to e9dc2298 
Dealt to f0bce165 
Dealt to Hero [Kc Qc]
Dealt to 689584e1 
7cdddcd: folds
10438ff8: folds
e9dc2298: folds
f0bce165: folds
Hero: raises 600 to 900
689584e1: folds
b895559f: folds
ab157e6: calls 600
*** FLOP *** [7c 9d 2d]
ab157e6: checks
Hero: bets 1,155
ab157e6: folds
Uncalled bet (1,155) returned to Hero
*** SHOWDOWN ***
Hero collected 2,310 from pot
*** SUMMARY ***
Total pot 2,310 | Rake 0 | Jackpot 0 | Bingo 0 | Fortune 0 | Tax 0
Board [7c 9d 2d]
Seat 1: b895559f (small blind) folded before Flop
Seat 2: ab157e6 (big blind) folded on the Flop
Seat 3: 7cdddcd folded before Flop
Seat 4: 10438ff8 folded before Flop
Seat 5: e9dc2298 folded before Flop
Seat 6: f0bce165 folded before Flop
Seat 7: Hero won (2,310)
Seat 8: 689584e1 (button) folded before Flop


Poker Hand #TM3552361826: Tournament #156543396, Bounty Hunters Special $1.08 Hold'em No Limit - Level6(150/300) - 2024/08/05 10:27:11
Table '119' 8-max Seat #7 is the button
Seat 1: b895559f (5,650 in chips)
Seat 2: ab157e6 (10,025 in chips)
Seat 3: 7cdddcd (13,805 in chips)
Seat 4: 10438ff8 (8,962 in chips)
Seat 5: e9dc2298 (13,286 in chips)
Seat 6: f0bce165 (23,488 in chips)
Seat 7: Hero (7,673 in chips)
Seat 8: 689584e1 (9,654 in chips)
e9dc2298: posts the ante 45
b895559f: posts the ante 45
10438ff8: posts the ante 45
f0bce165: posts the ante 45
7cdddcd: posts the ante 45
ab157e6: posts the ante 45
689584e1: posts the ante 45
Hero: posts the ante 45
689584e1: posts small blind 150
b895559f: posts big blind 300
*** HOLE CARDS ***
Dealt to b895559f 
Dealt to ab157e6 
Dealt to 7cdddcd 
Dealt to 10438ff8 
Dealt to e9dc2298 
Dealt to f0bce165 
Dealt to Hero [2d 4s]
Dealt to 689584e1 
ab157e6: folds
7cdddcd: folds
10438ff8: raises 330 to 630
e9dc2298: folds
f0bce165: folds
Hero: folds
689584e1: folds
b895559f: folds
Uncalled bet (330) returned to 10438ff8
*** SHOWDOWN ***
10438ff8 collected 1,110 from pot
*** SUMMARY ***
Total pot 1,110 | Rake 0 | Jackpot 0 | Bingo 0 | Fortune 0 | Tax 0
Seat 1: b895559f (big blind) folded before Flop
Seat 2: ab157e6 folded before Flop
Seat 3: 7cdddcd folded before Flop
Seat 4: 10438ff8 collected (1,110)
Seat 5: e9dc2298 folded before Flop
Seat 6: f0bce165 folded before Flop
Seat 7: Hero (button) folded before Flop
Seat 8: 689584e1 (small blind) folded before Flop


Poker Hand #TM3552361808: Tournament #156543396, Bounty Hunters Special $1.08 Hold'em No Limit - Level5(125/250) - 2024/08/05 10:26:19
Table '119' 8-max Seat #6 is the button
Seat 1: b895559f (5,685 in chips)
Seat 2: ab157e6 (10,060 in chips)
Seat 3: 7cdddcd (13,840 in chips)
Seat 4: 10438ff8 (8,997 in chips)
Seat 5: e9dc2298 (14,285 in chips)
Seat 6: f0bce165 (23,523 in chips)
Seat 7: Hero (7,833 in chips)
Seat 8: 689584e1 (8,320 in chips)
e9dc2298: posts the ante 35
b895559f: posts the ante 35
10438ff8: posts the ante 35
f0bce165: posts the ante 35
7cdddcd: posts the ante 35
ab157e6: posts the ante 35
689584e1: posts the ante 35
Hero: posts the ante 35
Hero: posts small blind 125
689584e1: posts big blind 250
*** HOLE CARDS ***
Dealt to b895559f 
Dealt to ab157e6 
Dealt to 7cdddcd 
Dealt to 10438ff8 
Dealt to e9dc2298 
Dealt to f0bce165 
Dealt to Hero [4d 7d]
Dealt to 689584e1 
b895559f: folds
ab157e6: folds
7cdddcd: folds
10438ff8: folds
e9dc2298: raises 250 to 500
f0bce165: folds
Hero: folds
689584e1: calls 250
*** FLOP *** [6c 2s 6h]
689584e1: checks
e9dc2298: bets 464
689584e1: raises 1,167 to 1,631
e9dc2298: folds
Uncalled bet (1,167) returned to 689584e1
*** SHOWDOWN ***
689584e1 collected 2,333 from pot
*** SUMMARY ***
Total pot 2,333 | Rake 0 | Jackpot 0 | Bingo 0 | Fortune 0 | Tax 0
Board [6c 2s 6h]
Seat 1: b895559f folded before Flop
Seat 2: ab157e6 folded before Flop
Seat 3: 7cdddcd folded before Flop
Seat 4: 10438ff8 folded before Flop
Seat 5: e9dc2298 folded on the Flop
Seat 6: f0bce165 (button) folded before Flop
Seat 7: Hero (small blind) folded before Flop
Seat 8: 689584e1 (big blind) won (2,333)


Poker Hand #TM3552361796: Tournament #156543396, Bounty Hunters Special $1.08 Hold'em No Limit - Level5(125/250) - 2024/08/05 10:25:45
Table '119' 8-max Seat #5 is the button
Seat 1: b895559f (5,720 in chips)
Seat 2: ab157e6 (10,095 in chips)
Seat 3: 7cdddcd (13,875 in chips)
Seat 4: 10438ff8 (9,032 in chips)
Seat 5: e9dc2298 (13,665 in chips)
Seat 6: f0bce165 (23,683 in chips)
Seat 7: Hero (8,118 in chips)
Seat 8: 689584e1 (8,355 in chips)
e9dc2298: posts the ante 35
b895559f: posts the ante 35
10438ff8: posts the ante 35
f0bce165: posts the ante 35
7cdddcd: posts the ante 35
ab157e6: posts the ante 35
689584e1: posts the ante 35
Hero: posts the ante 35
f0bce165: posts small blind 125
Hero: posts big blind 250
*** HOLE CARDS ***
Dealt to b895559f 
Dealt to ab157e6 
Dealt to 7cdddcd 
Dealt to 10438ff8 
Dealt to e9dc2298 
Dealt to f0bce165 
Dealt to Hero [3d 9d]
Dealt to 689584e1 
689584e1: folds
b895559f: folds
ab157e6: folds
7cdddcd: folds
10438ff8: folds
e9dc2298: raises 250 to 500
f0bce165: folds
Hero: folds
Uncalled bet (250) returned to e9dc2298
*** SHOWDOWN ***
e9dc2298 collected 905 from pot
*** SUMMARY ***
Total pot 905 | Rake 0 | Jackpot 0 | Bingo 0 | Fortune 0 | Tax 0
Seat 1: b895559f folded before Flop
Seat 2: ab157e6 folded before Flop
Seat 3: 7cdddcd folded before Flop
Seat 4: 10438ff8 folded before Flop
Seat 5: e9dc2298 (button) collected (905)
Seat 6: f0bce165 (small blind) folded before Flop
Seat 7: Hero (big blind) folded before Flop
Seat 8: 689584e1 folded before Flop


Poker Hand #TM3552361783: Tournament #156543396, Bounty Hunters Special $1.08 Hold'em No Limit - Level5(125/250) - 2024/08/05 10:25:03
Table '119' 8-max Seat #4 is the button
Seat 1: b895559f (5,755 in chips)
Seat 2: ab157e6 (8,475 in chips)
Seat 3: 7cdddcd (13,910 in chips)
Seat 4: 10438ff8 (9,067 in chips)
Seat 5: e9dc2298 (13,825 in chips)
Seat 6: f0bce165 (23,968 in chips)
Seat 7: Hero (8,653 in chips)
Seat 8: 689584e1 (8,890 in chips)
e9dc2298: posts the ante 35
b895559f: posts the ante 35
10438ff8: posts the ante 35
f0bce165: posts the ante 35
7cdddcd: posts the ante 35
ab157e6: posts the ante 35
689584e1: posts the ante 35
Hero: posts the ante 35
e9dc2298: posts small blind 125
f0bce165: posts big blind 250
*** HOLE CARDS ***
Dealt to b895559f 
Dealt to ab157e6 
Dealt to 7cdddcd 
Dealt to 10438ff8 
Dealt to e9dc2298 
Dealt to f0bce165 
Dealt to Hero [Ks 8s]
Dealt to 689584e1 
Hero: raises 250 to 500
689584e1: calls 500
b895559f: folds
ab157e6: raises 1,121 to 1,621
7cdddcd: folds
10438ff8: folds
e9dc2298: folds
f0bce165: folds
Hero: folds
689584e1: folds
Uncalled bet (1,121) returned to ab157e6
*** SHOWDOWN ***
ab157e6 collected 2,155 from pot
*** SUMMARY ***
Total pot 2,155 | Rake 0 | Jackpot 0 | Bingo 0 | Fortune 0 | Tax 0
Seat 1: b895559f folded before Flop
Seat 2: ab157e6 collected (2,155)
Seat 3: 7cdddcd folded before Flop
Seat 4: 10438ff8 (button) folded before Flop
Seat 5: e9dc2298 (small blind) folded before Flop
Seat 6: f0bce165 (big blind) folded before Flop
Seat 7: Hero folded before Flop
Seat 8: 689584e1 folded before Flop


Poker Hand #TM3552361761: Tournament #156543396, Bounty Hunters Special $1.08 Hold'em No Limit - Level5(125/250) - 2024/08/05 10:24:09
Table '119' 8-max Seat #3 is the button
Seat 1: b895559f (2,585 in chips)
Seat 2: ab157e6 (8,510 in chips)
Seat 3: 7cdddcd (13,945 in chips)
Seat 4: 10438ff8 (9,227 in chips)
Seat 5: e9dc2298 (14,110 in chips)
Seat 6: f0bce165 (24,003 in chips)
Seat 7: Hero (11,238 in chips)
Seat 8: 689584e1 (8,925 in chips)
e9dc2298: posts the ante 35
b895559f: posts the ante 35
10438ff8: posts the ante 35
f0bce165: posts the ante 35
7cdddcd: posts the ante 35
ab157e6: posts the ante 35
689584e1: posts the ante 35
Hero: posts the ante 35
10438ff8: posts small blind 125
e9dc2298: posts big blind 250
*** HOLE CARDS ***
Dealt to b895559f 
Dealt to ab157e6 
Dealt to 7cdddcd 
Dealt to 10438ff8 
Dealt to e9dc2298 
Dealt to f0bce165 
Dealt to Hero [Td As]
Dealt to 689584e1 
f0bce165: folds
Hero: raises 250 to 500
689584e1: folds
b895559f: raises 2,050 to 2,550 and is all-in
ab157e6: folds
7cdddcd: folds
10438ff8: folds
e9dc2298: folds
Hero: calls 2,050
b895559f: shows [7h Th]
Hero: shows [Td As]
*** FLOP *** [8d 7d 7s]
*** TURN *** [8d 7d 7s] [Jc]
*** RIVER *** [8d 7d 7s Jc] [5c]
*** SHOWDOWN ***
b895559f collected 5,755 from pot
*** SUMMARY ***
Total pot 5,755 | Rake 0 | Jackpot 0 | Bingo 0 | Fortune 0 | Tax 0
Board [8d 7d 7s Jc 5c]
Seat 1: b895559f showed [7h Th] and won (5,755) with Three Sevens
Seat 2: ab157e6 folded before Flop
Seat 3: 7cdddcd (button) folded before Flop
Seat 4: 10438ff8 (small blind) folded before Flop
Seat 5: e9dc2298 (big blind) folded before Flop
Seat 6: f0bce165 folded before Flop
Seat 7: Hero showed [Td As] and lost with Pair of Sevens
Seat 8: 689584e1 folded before Flop


Poker Hand #TM3552361747: Tournament #156543396, Bounty Hunters Special $1.08 Hold'em No Limit - Level5(125/250) - 2024/08/05 10:23:31
Table '119' 8-max Seat #2 is the button
Seat 1: b895559f (2,620 in chips)
Seat 2: ab157e6 (8,545 in chips)
Seat 3: 7cdddcd (12,450 in chips)
Seat 4: 10438ff8 (9,512 in chips)
Seat 5: e9dc2298 (14,145 in chips)
Seat 6: f0bce165 (24,538 in chips)
Seat 7: Hero (11,773 in chips)
Seat 8: 689584e1 (8,960 in chips)
e9dc2298: posts the ante 35
b895559f: posts the ante 35
10438ff8: posts the ante 35
f0bce165: posts the ante 35
ab157e6: posts the ante 35
7cdddcd: posts the ante 35
689584e1: posts the ante 35
Hero: posts the ante 35
7cdddcd: posts small blind 125
10438ff8: posts big blind 250
*** HOLE CARDS ***
Dealt to b895559f 
Dealt to ab157e6 
Dealt to 7cdddcd 
Dealt to 10438ff8 
Dealt to e9dc2298 
Dealt to f0bce165 
Dealt to Hero [Jh Qs]
Dealt to 689584e1 
e9dc2298: folds
f0bce165: raises 250 to 500
Hero: calls 500
689584e1: folds
b895559f: folds
ab157e6: folds
7cdddcd: raises 11,915 to 12,415 and is all-in
10438ff8: folds
f0bce165: folds
Hero: folds
Uncalled bet (11,915) returned to 7cdddcd
*** SHOWDOWN ***
7cdddcd collected 2,030 from pot
*** SUMMARY ***
Total pot 2,030 | Rake 0 | Jackpot 0 | Bingo 0 | Fortune 0 | Tax 0
Seat 1: b895559f folded before Flop
Seat 2: ab157e6 (button) folded before Flop
Seat 3: 7cdddcd (small blind) collected (2,030)
Seat 4: 10438ff8 (big blind) folded before Flop
Seat 5: e9dc2298 folded before Flop
Seat 6: f0bce165 folded before Flop
Seat 7: Hero folded before Flop
Seat 8: 689584e1 folded before Flop


Poker Hand #TM3552361724: Tournament #156543396, Bounty Hunters Special $1.08 Hold'em No Limit - Level5(125/250) - 2024/08/05 10:22:25
Table '119' 8-max Seat #1 is the button
Seat 1: b895559f (2,655 in chips)
Seat 2: ab157e6 (10,080 in chips)
Seat 3: 7cdddcd (12,735 in chips)
Seat 4: 10438ff8 (11,047 in chips)
Seat 5: e9dc2298 (10,650 in chips)
Seat 6: f0bce165 (24,573 in chips)
Seat 7: Hero (11,808 in chips)
Seat 8: 689584e1 (8,995 in chips)
e9dc2298: posts the ante 35
b895559f: posts the ante 35
10438ff8: posts the ante 35
f0bce165: posts the ante 35
7cdddcd: posts the ante 35
ab157e6: posts the ante 35
689584e1: posts the ante 35
Hero: posts the ante 35
ab157e6: posts small blind 125
7cdddcd: posts big blind 250
*** HOLE CARDS ***
Dealt to b895559f 
Dealt to ab157e6 
Dealt to 7cdddcd 
Dealt to 10438ff8 
Dealt to e9dc2298 
Dealt to f0bce165 
Dealt to Hero [Th Js]
Dealt to 689584e1 
10438ff8: raises 275 to 525
e9dc2298: raises 975 to 1,500
f0bce165: folds
Hero: folds
689584e1: folds
b895559f: folds
ab157e6: calls 1,375
7cdddcd: folds
10438ff8: calls 975
*** FLOP *** [8h 6s 5d]
ab157e6: checks
10438ff8: checks
e9dc2298: bets 1,660
ab157e6: folds
10438ff8: folds
Uncalled bet (1,660) returned to e9dc2298
*** SHOWDOWN ***
e9dc2298 collected 5,030 from pot
*** SUMMARY ***
Total pot 5,030 | Rake 0 | Jackpot 0 | Bingo 0 | Fortune 0 | Tax 0
Board [8h 6s 5d]
Seat 1: b895559f (button) folded before Flop
Seat 2: ab157e6 (small blind) folded on the Flop
Seat 3: 7cdddcd (big blind) folded before Flop
Seat 4: 10438ff8 folded on the Flop
Seat 5: e9dc2298 won (5,030)
Seat 6: f0bce165 folded before Flop
Seat 7: Hero folded before Flop
Seat 8: 689584e1 folded before Flop


Poker Hand #TM3552361698: Tournament #156543396, Bounty Hunters Special $1.08 Hold'em No Limit - Level5(125/250) - 2024/08/05 10:20:56
Table '119' 8-max Seat #8 is the button
Seat 1: b895559f (2,815 in chips)
Seat 2: ab157e6 (10,365 in chips)
Seat 3: 7cdddcd (12,770 in chips)
Seat 4: 10438ff8 (11,082 in chips)
Seat 5: e9dc2298 (10,685 in chips)
Seat 6: f0bce165 (21,625 in chips)
Seat 7: Hero (14,171 in chips)
Seat 8: 689584e1 (9,030 in chips)
e9dc2298: posts the ante 35
b895559f: posts the ante 35
10438ff8: posts the ante 35
f0bce165: posts the ante 35
7cdddcd: posts the ante 35
ab157e6: posts the ante 35
689584e1: posts the ante 35
Hero: posts the ante 35
b895559f: posts small blind 125
ab157e6: posts big blind 250
*** HOLE CARDS ***
Dealt to b895559f 
Dealt to ab157e6 
Dealt to 7cdddcd 
Dealt to 10438ff8 
Dealt to e9dc2298 
Dealt to f0bce165 
Dealt to Hero [Tc Td]
Dealt to 689584e1 
7cdddcd: folds
10438ff8: folds
e9dc2298: folds
f0bce165: raises 375 to 625
Hero: raises 375 to 1,000
689584e1: folds
b895559f: folds
ab157e6: folds
f0bce165: calls 375
*** FLOP *** [Ad As 5h]
f0bce165: checks
Hero: bets 1,328
f0bce165: calls 1,328
*** TURN *** [Ad As 5h] [Ks]
f0bce165: checks
Hero: checks
*** RIVER *** [Ad As 5h Ks] [5c]
f0bce165: bets 2,656
Hero: folds
Uncalled bet (2,656) returned to f0bce165
*** SHOWDOWN ***
f0bce165 collected 5,311 from pot
*** SUMMARY ***
Total pot 5,311 | Rake 0 | Jackpot 0 | Bingo 0 | Fortune 0 | Tax 0
Board [Ad As 5h Ks 5c]
Seat 1: b895559f (small blind) folded before Flop
Seat 2: ab157e6 (big blind) folded before Flop
Seat 3: 7cdddcd folded before Flop
Seat 4: 10438ff8 folded before Flop
Seat 5: e9dc2298 folded before Flop
Seat 6: f0bce165 won (5,311)
Seat 7: Hero folded on the River
Seat 8: 689584e1 (button) folded before Flop


Poker Hand #TM3552361667: Tournament #156543396, Bounty Hunters Special $1.08 Hold'em No Limit - Level5(125/250) - 2024/08/05 10:19:25
Table '119' 8-max Seat #7 is the button
Seat 1: b895559f (3,100 in chips)
Seat 2: ab157e6 (10,900 in chips)
Seat 3: 7cdddcd (12,805 in chips)
Seat 4: 10438ff8 (9,587 in chips)
Seat 5: e9dc2298 (10,720 in chips)
Seat 6: f0bce165 (21,660 in chips)
Seat 7: Hero (14,206 in chips)
Seat 8: 689584e1 (9,565 in chips)
e9dc2298: posts the ante 35
b895559f: posts the ante 35
10438ff8: posts the ante 35
f0bce165: posts the ante 35
7cdddcd: posts the ante 35
ab157e6: posts the ante 35
689584e1: posts the ante 35
Hero: posts the ante 35
689584e1: posts small blind 125
b895559f: posts big blind 250
*** HOLE CARDS ***
Dealt to b895559f 
Dealt to ab157e6 
Dealt to 7cdddcd 
Dealt to 10438ff8 
Dealt to e9dc2298 
Dealt to f0bce165 
Dealt to Hero [7h Jd]
Dealt to 689584e1 
ab157e6: raises 250 to 500
7cdddcd: folds
10438ff8: calls 500
e9dc2298: folds
f0bce165: folds
Hero: folds
689584e1: calls 375
b895559f: folds
*** FLOP *** [4s 3d Qc]
689584e1: checks
ab157e6: checks
10438ff8: bets 1,015
689584e1: folds
ab157e6: folds
Uncalled bet (1,015) returned to 10438ff8
*** SHOWDOWN ***
10438ff8 collected 2,030 from pot
*** SUMMARY ***
Total pot 2,030 | Rake 0 | Jackpot 0 | Bingo 0 | Fortune 0 | Tax 0
Board [4s 3d Qc]
Seat 1: b895559f (big blind) folded before Flop
Seat 2: ab157e6 folded on the Flop
Seat 3: 7cdddcd folded before Flop
Seat 4: 10438ff8 won (2,030)
Seat 5: e9dc2298 folded before Flop
Seat 6: f0bce165 folded before Flop
Seat 7: Hero (button) folded before Flop
Seat 8: 689584e1 (small blind) folded on the Flop


Poker Hand #TM3552361653: Tournament #156543396, Bounty Hunters Special $1.08 Hold'em No Limit - Level5(125/250) - 2024/08/05 10:18:54
Table '119' 8-max Seat #6 is the button
Seat 1: b895559f (3,135 in chips)
Seat 2: ab157e6 (10,935 in chips)
Seat 3: 7cdddcd (12,840 in chips)
Seat 4: 10438ff8 (9,622 in chips)
Seat 5: e9dc2298 (10,755 in chips)
Seat 6: f0bce165 (21,695 in chips)
Seat 7: Hero (14,366 in chips)
Seat 8: 689584e1 (9,195 in chips)
e9dc2298: posts the ante 35
b895559f: posts the ante 35
10438ff8: posts the ante 35
f0bce165: posts the ante 35
7cdddcd: posts the ante 35
ab157e6: posts the ante 35
689584e1: posts the ante 35
Hero: posts the ante 35
Hero: posts small blind 125
689584e1: posts big blind 250
*** HOLE CARDS ***
Dealt to b895559f 
Dealt to ab157e6 
Dealt to 7cdddcd 
Dealt to 10438ff8 
Dealt to e9dc2298 
Dealt to f0bce165 
Dealt to Hero [Ks 2c]
Dealt to 689584e1 
b895559f: folds
ab157e6: folds
7cdddcd: folds
10438ff8: folds
e9dc2298: folds
f0bce165: folds
Hero: folds
Uncalled bet (125) returned to 689584e1
*** SHOWDOWN ***
689584e1 collected 530 from pot
*** SUMMARY ***
Total pot 530 | Rake 0 | Jackpot 0 | Bingo 0 | Fortune 0 | Tax 0
Seat 1: b895559f folded before Flop
Seat 2: ab157e6 folded before Flop
Seat 3: 7cdddcd folded before Flop
Seat 4: 10438ff8 folded before Flop
Seat 5: e9dc2298 folded before Flop
Seat 6: f0bce165 (button) folded before Flop
Seat 7: Hero (small blind) folded before Flop
Seat 8: 689584e1 (big blind) collected (530)


Poker Hand #TM3552361648: Tournament #156543396, Bounty Hunters Special $1.08 Hold'em No Limit - Level5(125/250) - 2024/08/05 10:18:30
Table '119' 8-max Seat #5 is the button
Seat 1: b895559f (3,170 in chips)
Seat 2: ab157e6 (10,970 in chips)
Seat 3: 7cdddcd (12,875 in chips)
Seat 4: 10438ff8 (9,657 in chips)
Seat 5: e9dc2298 (10,790 in chips)
Seat 6: f0bce165 (21,855 in chips)
Seat 7: Hero (13,996 in chips)
Seat 8: 689584e1 (9,230 in chips)
e9dc2298: posts the ante 35
b895559f: posts the ante 35
10438ff8: posts the ante 35
f0bce165: posts the ante 35
7cdddcd: posts the ante 35
ab157e6: posts the ante 35
689584e1: posts the ante 35
Hero: posts the ante 35
f0bce165: posts small blind 125
Hero: posts big blind 250
*** HOLE CARDS ***
Dealt to b895559f 
Dealt to ab157e6 
Dealt to 7cdddcd 
Dealt to 10438ff8 
Dealt to e9dc2298 
Dealt to f0bce165 
Dealt to Hero [9s 7h]
Dealt to 689584e1 
689584e1: folds
b895559f: folds
ab157e6: folds
7cdddcd: folds
10438ff8: folds
e9dc2298: folds
f0bce165: folds
Uncalled bet (125) returned to Hero
*** SHOWDOWN ***
Hero collected 530 from pot
*** SUMMARY ***
Total pot 530 | Rake 0 | Jackpot 0 | Bingo 0 | Fortune 0 | Tax 0
Seat 1: b895559f folded before Flop
Seat 2: ab157e6 folded before Flop
Seat 3: 7cdddcd folded before Flop
Seat 4: 10438ff8 folded before Flop
Seat 5: e9dc2298 (button) folded before Flop
Seat 6: f0bce165 (small blind) folded before Flop
Seat 7: Hero (big blind) collected (530)
Seat 8: 689584e1 folded before Flop


Poker Hand #TM3552361634: Tournament #156543396, Bounty Hunters Special $1.08 Hold'em No Limit - Level5(125/250) - 2024/08/05 10:17:54
Table '119' 8-max Seat #4 is the button
Seat 1: b895559f (3,205 in chips)
Seat 2: ab157e6 (11,005 in chips)
Seat 3: 7cdddcd (13,410 in chips)
Seat 4: 10438ff8 (9,692 in chips)
Seat 5: e9dc2298 (9,795 in chips)
Seat 6: f0bce165 (22,140 in chips)
Seat 7: Hero (14,031 in chips)
Seat 8: 689584e1 (9,265 in chips)
e9dc2298: posts the ante 35
b895559f: posts the ante 35
10438ff8: posts the ante 35
f0bce165: posts the ante 35
7cdddcd: posts the ante 35
ab157e6: posts the ante 35
689584e1: posts the ante 35
Hero: posts the ante 35
e9dc2298: posts small blind 125
f0bce165: posts big blind 250
*** HOLE CARDS ***
Dealt to b895559f 
Dealt to ab157e6 
Dealt to 7cdddcd 
Dealt to 10438ff8 
Dealt to e9dc2298 
Dealt to f0bce165 
Dealt to Hero [8c Qc]
Dealt to 689584e1 
Hero: folds
689584e1: folds
b895559f: folds
ab157e6: folds
7cdddcd: raises 250 to 500
10438ff8: folds
e9dc2298: raises 1,500 to 2,000
f0bce165: folds
7cdddcd: folds
Uncalled bet (1,500) returned to e9dc2298
*** SHOWDOWN ***
e9dc2298 collected 1,530 from pot
*** SUMMARY ***
Total pot 1,530 | Rake 0 | Jackpot 0 | Bingo 0 | Fortune 0 | Tax 0
Seat 1: b895559f folded before Flop
Seat 2: ab157e6 folded before Flop
Seat 3: 7cdddcd folded before Flop
Seat 4: 10438ff8 (button) folded before Flop
Seat 5: e9dc2298 (small blind) collected (1,530)
Seat 6: f0bce165 (big blind) folded before Flop
Seat 7: Hero folded before Flop
Seat 8: 689584e1 folded before Flop


Poker Hand #TM3552361614: Tournament #156543396, Bounty Hunters Special $1.08 Hold'em No Limit - Level5(125/250) - 2024/08/05 10:16:53
Table '119' 8-max Seat #3 is the button
Seat 1: b895559f (1,060 in chips)
Seat 2: ab157e6 (11,040 in chips)
Seat 3: 7cdddcd (14,470 in chips)
Seat 4: 10438ff8 (9,852 in chips)
Seat 5: e9dc2298 (10,080 in chips)
Seat 6: f0bce165 (22,175 in chips)
Seat 7: Hero (14,066 in chips)
Seat 8: 689584e1 (9,800 in chips)
e9dc2298: posts the ante 35
b895559f: posts the ante 35
10438ff8: posts the ante 35
f0bce165: posts the ante 35
7cdddcd: posts the ante 35
ab157e6: posts the ante 35
689584e1: posts the ante 35
Hero: posts the ante 35
10438ff8: posts small blind 125
e9dc2298: posts big blind 250
*** HOLE CARDS ***
Dealt to b895559f 
Dealt to ab157e6 
Dealt to 7cdddcd 
Dealt to 10438ff8 
Dealt to e9dc2298 
Dealt to f0bce165 
Dealt to Hero [Qc 8c]
Dealt to 689584e1 
f0bce165: folds
Hero: folds
689584e1: raises 250 to 500
b895559f: raises 525 to 1,025 and is all-in
ab157e6: folds
7cdddcd: raises 13,410 to 14,435 and is all-in
10438ff8: folds
e9dc2298: folds
689584e1: folds
Uncalled bet (13,410) returned to 7cdddcd
7cdddcd: shows [5h 5s]
b895559f: shows [5c 6d]
*** FLOP *** [Tc 6c 4c]
*** TURN *** [Tc 6c 4c] [9c]
*** RIVER *** [Tc 6c 4c 9c] [Ks]
Hero: shows [Qc 8c] (Queen High Flush)
*** SHOWDOWN ***
b895559f collected 3,205 from pot
*** SUMMARY ***
Total pot 3,205 | Rake 0 | Jackpot 0 | Bingo 0 | Fortune 0 | Tax 0
Board [Tc 6c 4c 9c Ks]
Seat 1: b895559f showed [5c 6d] and won (3,205) with Ten High Flush
Seat 2: ab157e6 folded before Flop
Seat 3: 7cdddcd (button) showed [5h 5s] and lost with Pair of Fives
Seat 4: 10438ff8 (small blind) folded before Flop
Seat 5: e9dc2298 (big blind) folded before Flop
Seat 6: f0bce165 folded before Flop
Seat 7: Hero folded before Flop
Seat 8: 689584e1 folded before Flop


Poker Hand #TM3552361596: Tournament #156543396, Bounty Hunters Special $1.08 Hold'em No Limit - Level4(100/200) - 2024/08/05 10:16:11
Table '119' 8-max Seat #2 is the button
Seat 1: b895559f (1,090 in chips)
Seat 2: ab157e6 (11,470 in chips)
Seat 3: 7cdddcd (14,600 in chips)
Seat 4: 10438ff8 (10,082 in chips)
Seat 5: e9dc2298 (10,110 in chips)
Seat 6: f0bce165 (22,205 in chips)
Seat 7: Hero (14,096 in chips)
Seat 8: 689584e1 (8,890 in chips)
e9dc2298: posts the ante 30
b895559f: posts the ante 30
10438ff8: posts the ante 30
f0bce165: posts the ante 30
ab157e6: posts the ante 30
7cdddcd: posts the ante 30
689584e1: posts the ante 30
Hero: posts the ante 30
7cdddcd: posts small blind 100
10438ff8: posts big blind 200
*** HOLE CARDS ***
Dealt to b895559f 
Dealt to ab157e6 
Dealt to 7cdddcd 
Dealt to 10438ff8 
Dealt to e9dc2298 
Dealt to f0bce165 
Dealt to Hero [Qc 8s]
Dealt to 689584e1 
e9dc2298: folds
f0bce165: folds
Hero: folds
689584e1: raises 200 to 400
b895559f: folds
ab157e6: calls 400
7cdddcd: folds
10438ff8: folds
*** FLOP *** [Tc 5c As]
689584e1: checks
ab157e6: checks
*** TURN *** [Tc 5c As] [7c]
689584e1: bets 670
ab157e6: folds
Uncalled bet (670) returned to 689584e1
*** SHOWDOWN ***
689584e1 collected 1,340 from pot
*** SUMMARY ***
Total pot 1,340 | Rake 0 | Jackpot 0 | Bingo 0 | Fortune 0 | Tax 0
Board [Tc 5c As 7c]
Seat 1: b895559f folded before Flop
Seat 2: ab157e6 (button) folded on the Turn
Seat 3: 7cdddcd (small blind) folded before Flop
Seat 4: 10438ff8 (big blind) folded before Flop
Seat 5: e9dc2298 folded before Flop
Seat 6: f0bce165 folded before Flop
Seat 7: Hero folded before Flop
Seat 8: 689584e1 won (1,340)


Poker Hand #TM3552361575: Tournament #156543396, Bounty Hunters Special $1.08 Hold'em No Limit - Level4(100/200) - 2024/08/05 10:14:54
Table '119' 8-max Seat #1 is the button
Seat 1: b895559f (200 in chips)
Seat 2: ab157e6 (11,180 in chips)
Seat 3: 7cdddcd (14,830 in chips)
Seat 4: 10438ff8 (10,112 in chips)
Seat 5: e9dc2298 (10,140 in chips)
Seat 6: f0bce165 (22,235 in chips)
Seat 7: Hero (14,526 in chips)
Seat 8: 689584e1 (9,320 in chips)
e9dc2298: posts the ante 30
b895559f: posts the ante 30
10438ff8: posts the ante 30
f0bce165: posts the ante 30
7cdddcd: posts the ante 30
ab157e6: posts the ante 30
689584e1: posts the ante 30
Hero: posts the ante 30
ab157e6: posts small blind 100
7cdddcd: posts big blind 200
*** HOLE CARDS ***
Dealt to b895559f 
Dealt to ab157e6 
Dealt to 7cdddcd 
Dealt to 10438ff8 
Dealt to e9dc2298 
Dealt to f0bce165 
Dealt to Hero [Tc 8c]
Dealt to 689584e1 
10438ff8: folds
e9dc2298: folds
f0bce165: folds
Hero: raises 200 to 400
689584e1: calls 400
b895559f: calls 170 and is all-in
ab157e6: raises 10,750 to 11,150 and is all-in
7cdddcd: folds
Hero: folds
689584e1: folds
Uncalled bet (10,750) returned to ab157e6
ab157e6: shows [Ac Qd]
b895559f: shows [As 6d]
*** FLOP *** [6s Jh 2s]
*** TURN *** [6s Jh 2s] [5c]
*** RIVER *** [6s Jh 2s 5c] [Td]
7cdddcd: shows [Qc] (Queen-High)
*** SHOWDOWN ***
b895559f collected 1,090 from pot
ab157e6 collected 720 from pot
*** SUMMARY ***
Total pot 1,810 | Rake 0 | Jackpot 0 | Bingo 0 | Fortune 0 | Tax 0
Board [6s Jh 2s 5c Td]
Seat 1: b895559f (button) showed [As 6d] and won (1,090) with Pair of Sixes
Seat 2: ab157e6 (small blind) showed [Ac Qd] and won (720) with Ace-High
Seat 3: 7cdddcd (big blind) folded before Flop
Seat 4: 10438ff8 folded before Flop
Seat 5: e9dc2298 folded before Flop
Seat 6: f0bce165 folded before Flop
Seat 7: Hero folded before Flop
Seat 8: 689584e1 folded before Flop


Poker Hand #TM3552361550: Tournament #156543396, Bounty Hunters Special $1.08 Hold'em No Limit - Level4(100/200) - 2024/08/05 10:13:30
Table '119' 8-max Seat #8 is the button
Seat 1: b895559f (9,540 in chips)
Seat 2: ab157e6 (11,410 in chips)
Seat 3: 7cdddcd (4,680 in chips)
Seat 4: 10438ff8 (10,142 in chips)
Seat 5: e9dc2298 (10,170 in chips)
Seat 6: f0bce165 (22,265 in chips)
Seat 7: Hero (14,996 in chips)
Seat 8: 689584e1 (9,340 in chips)
e9dc2298: posts the ante 30
b895559f: posts the ante 30
10438ff8: posts the ante 30
f0bce165: posts the ante 30
7cdddcd: posts the ante 30
ab157e6: posts the ante 30
689584e1: posts the ante 30
Hero: posts the ante 30
b895559f: posts small blind 100
ab157e6: posts big blind 200
*** HOLE CARDS ***
Dealt to b895559f 
Dealt to ab157e6 
Dealt to 7cdddcd 
Dealt to 10438ff8 
Dealt to e9dc2298 
Dealt to f0bce165 
Dealt to Hero [8d Ad]
Dealt to 689584e1 
7cdddcd: raises 240 to 440
10438ff8: folds
e9dc2298: folds
f0bce165: folds
Hero: calls 440
689584e1: calls 440
b895559f: raises 9,070 to 9,510 and is all-in
ab157e6: folds
7cdddcd: calls 4,210 and is all-in
Hero: folds
689584e1: calls 8,870 and is all-in
Uncalled bet (200) returned to b895559f
b895559f: shows [Ac Qc]
7cdddcd: shows [Tc Th]
689584e1: shows [Td 7c]
*** FLOP *** [3h Ts 3c]
*** TURN *** [3h Ts 3c] [4s]
*** RIVER *** [3h Ts 3c 4s] [2s]
*** SHOWDOWN ***
7cdddcd collected 14,830 from pot
689584e1 collected 9,320 from pot
*** SUMMARY ***
Total pot 24,150 | Rake 0 | Jackpot 0 | Bingo 0 | Fortune 0 | Tax 0
Board [3h Ts 3c 4s 2s]
Seat 1: b895559f (small blind) showed [Ac Qc] and lost with Pair of Treys
Seat 2: ab157e6 (big blind) folded before Flop
Seat 3: 7cdddcd showed [Tc Th] and won (14,830) with Tens Full over Treys
Seat 4: 10438ff8 folded before Flop
Seat 5: e9dc2298 folded before Flop
Seat 6: f0bce165 folded before Flop
Seat 7: Hero folded before Flop
Seat 8: 689584e1 (button) showed [Td 7c] and won (9,320) with Pair of Tens and Pair of Treys


Poker Hand #TM3552361531: Tournament #156543396, Bounty Hunters Special $1.08 Hold'em No Limit - Level4(100/200) - 2024/08/05 10:12:43
Table '119' 8-max Seat #7 is the button
Seat 1: b895559f (9,970 in chips)
Seat 2: ab157e6 (10,000 in chips)
Seat 3: 7cdddcd (4,710 in chips)
Seat 4: 10438ff8 (10,172 in chips)
Seat 5: e9dc2298 (10,200 in chips)
Seat 6: f0bce165 (22,295 in chips)
Seat 7: Hero (15,426 in chips)
Seat 8: 689584e1 (9,770 in chips)
e9dc2298: posts the ante 30
b895559f: posts the ante 30
10438ff8: posts the ante 30
f0bce165: posts the ante 30
7cdddcd: posts the ante 30
ab157e6: posts the ante 30
689584e1: posts the ante 30
Hero: posts the ante 30
689584e1: posts small blind 100
b895559f: posts big blind 200
*** HOLE CARDS ***
Dealt to b895559f 
Dealt to ab157e6 
Dealt to 7cdddcd 
Dealt to 10438ff8 
Dealt to e9dc2298 
Dealt to f0bce165 
Dealt to Hero [8d Kd]
Dealt to 689584e1 
ab157e6: raises 200 to 400
7cdddcd: folds
10438ff8: folds
e9dc2298: folds
f0bce165: folds
Hero: calls 400
689584e1: calls 300
b895559f: calls 200
*** FLOP *** [Td 5s 4h]
689584e1: checks
b895559f: checks
ab157e6: bets 957
Hero: folds
689584e1: folds
b895559f: folds
Uncalled bet (957) returned to ab157e6
*** SHOWDOWN ***
ab157e6 collected 1,840 from pot
*** SUMMARY ***
Total pot 1,840 | Rake 0 | Jackpot 0 | Bingo 0 | Fortune 0 | Tax 0
Board [Td 5s 4h]
Seat 1: b895559f (big blind) folded on the Flop
Seat 2: ab157e6 won (1,840)
Seat 3: 7cdddcd folded before Flop
Seat 4: 10438ff8 folded before Flop
Seat 5: e9dc2298 folded before Flop
Seat 6: f0bce165 folded before Flop
Seat 7: Hero (button) folded on the Flop
Seat 8: 689584e1 (small blind) folded on the Flop


Poker Hand #TM3552361510: Tournament #156543396, Bounty Hunters Special $1.08 Hold'em No Limit - Level4(100/200) - 2024/08/05 10:11:46
Table '119' 8-max Seat #6 is the button
Seat 1: b895559f (10,000 in chips)
Seat 4: 10438ff8 (13,552 in chips)
Seat 5: e9dc2298 (10,230 in chips)
Seat 6: f0bce165 (22,325 in chips)
Seat 7: Hero (11,726 in chips)
Seat 8: 689584e1 (10,000 in chips)
e9dc2298: posts the ante 30
b895559f: posts the ante 30
10438ff8: posts the ante 30
f0bce165: posts the ante 30
689584e1: posts the ante 30
Hero: posts the ante 30
Hero: posts small blind 100
689584e1: posts big blind 200
*** HOLE CARDS ***
Dealt to b895559f 
Dealt to 10438ff8 
Dealt to e9dc2298 
Dealt to f0bce165 
Dealt to Hero [Ac Jd]
Dealt to 689584e1 
b895559f: folds
10438ff8: raises 200 to 400
e9dc2298: folds
f0bce165: folds
Hero: calls 300
689584e1: folds
*** FLOP *** [2d Ah Js]
Hero: checks
10438ff8: checks
*** TURN *** [2d Ah Js] [Tc]
Hero: bets 590
10438ff8: calls 590
*** RIVER *** [2d Ah Js Tc] [Th]
Hero: checks
10438ff8: bets 2,360
Hero: calls 2,360
10438ff8: shows [Ad 6d] (Pair of Aces and Pair of Tens)
Hero: shows [Ac Jd] (Pair of Aces and Pair of Jacks)
*** SHOWDOWN ***
Hero collected 7,080 from pot
*** SUMMARY ***
Total pot 7,080 | Rake 0 | Jackpot 0 | Bingo 0 | Fortune 0 | Tax 0
Board [2d Ah Js Tc Th]
Seat 1: b895559f folded before Flop
Seat 4: 10438ff8 showed [Ad 6d] and lost with Pair of Aces and Pair of Tens
Seat 5: e9dc2298 folded before Flop
Seat 6: f0bce165 (button) folded before Flop
Seat 7: Hero (small blind) showed [Ac Jd] and won (7,080) with Pair of Aces and Pair of Jacks
Seat 8: 689584e1 (big blind) folded before Flop


Poker Hand #TM3552489426: Tournament #156543396, Bounty Hunters Special $1.08 Hold'em No Limit - Level4(100/200) - 2024/08/05 10:10:56
Table '55' 8-max Seat #3 is the button
Seat 1: 4cd0385d (4,436 in chips)
Seat 2: c9185546 (17,785 in chips)
Seat 3: 5b10812e (12,423 in chips)
Seat 4: fdf33aa2 (22,814 in chips)
Seat 5: 6f03c89e (15,204 in chips)
Seat 6: Hero (9,457 in chips)
Seat 7: 82802c28 (9,298 in chips)
Seat 8: 49831e93 (7,298 in chips)
49831e93: posts the ante 30
6f03c89e: posts the ante 30
c9185546: posts the ante 30
fdf33aa2: posts the ante 30
82802c28: posts the ante 30
4cd0385d: posts the ante 30
Hero: posts the ante 30
5b10812e: posts the ante 30
fdf33aa2: posts small blind 100
6f03c89e: posts big blind 200
*** HOLE CARDS ***
Dealt to 4cd0385d 
Dealt to c9185546 
Dealt to 5b10812e 
Dealt to fdf33aa2 
Dealt to 6f03c89e 
Dealt to Hero [8s 8d]
Dealt to 82802c28 
Dealt to 49831e93 
Hero: raises 200 to 400
82802c28: raises 496 to 896
49831e93: folds
4cd0385d: folds
c9185546: folds
5b10812e: folds
fdf33aa2: folds
6f03c89e: folds
Hero: calls 496
*** FLOP *** [Th 8h 7h]
Hero: checks
82802c28: bets 863
Hero: raises 2,029 to 2,892
82802c28: folds
Uncalled bet (2,029) returned to Hero
*** SHOWDOWN ***
Hero collected 4,058 from pot
*** SUMMARY ***
Total pot 4,058 | Rake 0 | Jackpot 0 | Bingo 0 | Fortune 0 | Tax 0
Board [Th 8h 7h]
Seat 1: 4cd0385d folded before Flop
Seat 2: c9185546 folded before Flop
Seat 3: 5b10812e (button) folded before Flop
Seat 4: fdf33aa2 (small blind) folded before Flop
Seat 5: 6f03c89e (big blind) folded before Flop
Seat 6: Hero won (4,058)
Seat 7: 82802c28 folded on the Flop
Seat 8: 49831e93 folded before Flop


Poker Hand #TM3552489395: Tournament #156543396, Bounty Hunters Special $1.08 Hold'em No Limit - Level4(100/200) - 2024/08/05 10:10:02
Table '55' 8-max Seat #2 is the button
Seat 1: 4cd0385d (4,466 in chips)
Seat 2: c9185546 (21,015 in chips)
Seat 3: 5b10812e (12,853 in chips)
Seat 4: fdf33aa2 (19,004 in chips)
Seat 5: 6f03c89e (15,234 in chips)
Seat 6: Hero (9,487 in chips)
Seat 7: 82802c28 (9,328 in chips)
Seat 8: 49831e93 (7,328 in chips)
49831e93: posts the ante 30
6f03c89e: posts the ante 30
c9185546: posts the ante 30
fdf33aa2: posts the ante 30
82802c28: posts the ante 30
4cd0385d: posts the ante 30
Hero: posts the ante 30
5b10812e: posts the ante 30
5b10812e: posts small blind 100
fdf33aa2: posts big blind 200
*** HOLE CARDS ***
Dealt to 4cd0385d 
Dealt to c9185546 
Dealt to 5b10812e 
Dealt to fdf33aa2 
Dealt to 6f03c89e 
Dealt to Hero [6c 2s]
Dealt to 82802c28 
Dealt to 49831e93 
6f03c89e: folds
Hero: folds
82802c28: folds
49831e93: folds
4cd0385d: folds
c9185546: raises 200 to 400
5b10812e: calls 300
fdf33aa2: raises 1,100 to 1,500
c9185546: calls 1,100
5b10812e: folds
*** FLOP *** [8h Ah Kh]
fdf33aa2: bets 1,700
c9185546: calls 1,700
*** TURN *** [8h Ah Kh] [9h]
fdf33aa2: checks
c9185546: checks
*** RIVER *** [8h Ah Kh 9h] [4c]
fdf33aa2: checks
c9185546: checks
fdf33aa2: shows [Ad 8d] (Pair of Aces and Pair of Eights)
c9185546: shows [As 6s] (Pair of Aces)
*** SHOWDOWN ***
fdf33aa2 collected 7,040 from pot
*** SUMMARY ***
Total pot 7,040 | Rake 0 | Jackpot 0 | Bingo 0 | Fortune 0 | Tax 0
Board [8h Ah Kh 9h 4c]
Seat 1: 4cd0385d folded before Flop
Seat 2: c9185546 (button) showed [As 6s] and lost with Pair of Aces
Seat 3: 5b10812e (small blind) folded before Flop
Seat 4: fdf33aa2 (big blind) showed [Ad 8d] and won (7,040) with Pair of Aces and Pair of Eights
Seat 5: 6f03c89e folded before Flop
Seat 6: Hero folded before Flop
Seat 7: 82802c28 folded before Flop
Seat 8: 49831e93 folded before Flop


Poker Hand #TM3552489364: Tournament #156543396, Bounty Hunters Special $1.08 Hold'em No Limit - Level4(100/200) - 2024/08/05 10:08:55
Table '55' 8-max Seat #1 is the button
Seat 1: 4cd0385d (4,496 in chips)
Seat 2: c9185546 (21,445 in chips)
Seat 3: 5b10812e (13,583 in chips)
Seat 4: fdf33aa2 (19,034 in chips)
Seat 5: 6f03c89e (15,264 in chips)
Seat 6: Hero (9,517 in chips)
Seat 7: 82802c28 (8,018 in chips)
Seat 8: 49831e93 (7,358 in chips)
49831e93: posts the ante 30
6f03c89e: posts the ante 30
c9185546: posts the ante 30
fdf33aa2: posts the ante 30
82802c28: posts the ante 30
4cd0385d: posts the ante 30
Hero: posts the ante 30
5b10812e: posts the ante 30
c9185546: posts small blind 100
5b10812e: posts big blind 200
*** HOLE CARDS ***
Dealt to 4cd0385d 
Dealt to c9185546 
Dealt to 5b10812e 
Dealt to fdf33aa2 
Dealt to 6f03c89e 
Dealt to Hero [2d As]
Dealt to 82802c28 
Dealt to 49831e93 
fdf33aa2: folds
6f03c89e: folds
Hero: folds
82802c28: raises 200 to 400
49831e93: folds
4cd0385d: folds
c9185546: calls 300
5b10812e: calls 200
*** FLOP *** [7h Jh 6s]
c9185546: checks
5b10812e: checks
82802c28: bets 300
c9185546: folds
5b10812e: calls 300
*** TURN *** [7h Jh 6s] [4h]
5b10812e: checks
82802c28: bets 1,265
5b10812e: folds
Uncalled bet (1,265) returned to 82802c28
*** SHOWDOWN ***
82802c28 collected 2,040 from pot
*** SUMMARY ***
Total pot 2,040 | Rake 0 | Jackpot 0 | Bingo 0 | Fortune 0 | Tax 0
Board [7h Jh 6s 4h]
Seat 1: 4cd0385d (button) folded before Flop
Seat 2: c9185546 (small blind) folded on the Flop
Seat 3: 5b10812e (big blind) folded on the Turn
Seat 4: fdf33aa2 folded before Flop
Seat 5: 6f03c89e folded before Flop
Seat 6: Hero folded before Flop
Seat 7: 82802c28 won (2,040)
Seat 8: 49831e93 folded before Flop


Poker Hand #TM3552489335: Tournament #156543396, Bounty Hunters Special $1.08 Hold'em No Limit - Level4(100/200) - 2024/08/05 10:07:59
Table '55' 8-max Seat #8 is the button
Seat 1: 4cd0385d (4,626 in chips)
Seat 2: c9185546 (22,645 in chips)
Seat 3: 5b10812e (10,933 in chips)
Seat 4: fdf33aa2 (19,064 in chips)
Seat 5: 6f03c89e (15,294 in chips)
Seat 6: Hero (9,547 in chips)
Seat 7: 82802c28 (8,048 in chips)
Seat 8: 49831e93 (8,558 in chips)
49831e93: posts the ante 30
6f03c89e: posts the ante 30
c9185546: posts the ante 30
fdf33aa2: posts the ante 30
82802c28: posts the ante 30
4cd0385d: posts the ante 30
Hero: posts the ante 30
5b10812e: posts the ante 30
4cd0385d: posts small blind 100
c9185546: posts big blind 200
*** HOLE CARDS ***
Dealt to 4cd0385d 
Dealt to c9185546 
Dealt to 5b10812e 
Dealt to fdf33aa2 
Dealt to 6f03c89e 
Dealt to Hero [Jh 7h]
Dealt to 82802c28 
Dealt to 49831e93 
5b10812e: calls 200
fdf33aa2: folds
6f03c89e: folds
Hero: folds
82802c28: folds
49831e93: raises 200 to 400
4cd0385d: folds
c9185546: calls 200
5b10812e: calls 200
*** FLOP *** [Kd 3d Td]
c9185546: checks
5b10812e: bets 770
49831e93: calls 770
c9185546: calls 770
*** TURN *** [Kd 3d Td] [9c]
c9185546: checks
5b10812e: bets 2,580
49831e93: folds
c9185546: folds
Uncalled bet (2,580) returned to 5b10812e
*** SHOWDOWN ***
5b10812e collected 3,850 from pot
*** SUMMARY ***
Total pot 3,850 | Rake 0 | Jackpot 0 | Bingo 0 | Fortune 0 | Tax 0
Board [Kd 3d Td 9c]
Seat 1: 4cd0385d (small blind) folded before Flop
Seat 2: c9185546 (big blind) folded on the Turn
Seat 3: 5b10812e won (3,850)
Seat 4: fdf33aa2 folded before Flop
Seat 5: 6f03c89e folded before Flop
Seat 6: Hero folded before Flop
Seat 7: 82802c28 folded before Flop
Seat 8: 49831e93 (button) folded on the Turn


Poker Hand #TM3552489314: Tournament #156543396, Bounty Hunters Special $1.08 Hold'em No Limit - Level4(100/200) - 2024/08/05 10:07:06
Table '55' 8-max Seat #7 is the button
Seat 1: 4cd0385d (5,856 in chips)
Seat 2: c9185546 (22,675 in chips)
Seat 3: 5b10812e (10,963 in chips)
Seat 4: fdf33aa2 (17,054 in chips)
Seat 5: 6f03c89e (15,824 in chips)
Seat 6: Hero (9,577 in chips)
Seat 7: 82802c28 (8,078 in chips)
Seat 8: 49831e93 (8,688 in chips)
49831e93: posts the ante 30
6f03c89e: posts the ante 30
c9185546: posts the ante 30
fdf33aa2: posts the ante 30
82802c28: posts the ante 30
4cd0385d: posts the ante 30
Hero: posts the ante 30
5b10812e: posts the ante 30
49831e93: posts small blind 100
4cd0385d: posts big blind 200
*** HOLE CARDS ***
Dealt to 4cd0385d 
Dealt to c9185546 
Dealt to 5b10812e 
Dealt to fdf33aa2 
Dealt to 6f03c89e 
Dealt to Hero [Ac Td]
Dealt to 82802c28 
Dealt to 49831e93 
c9185546: folds
5b10812e: folds
fdf33aa2: raises 300 to 500
6f03c89e: calls 500
Hero: folds
82802c28: folds
49831e93: folds
4cd0385d: calls 300
*** FLOP *** [Ad 7s Jc]
4cd0385d: checks
fdf33aa2: bets 700
6f03c89e: folds
4cd0385d: calls 700
*** TURN *** [Ad 7s Jc] [Ks]
4cd0385d: checks
fdf33aa2: bets 1,500
4cd0385d: folds
Uncalled bet (1,500) returned to fdf33aa2
*** SHOWDOWN ***
fdf33aa2 collected 3,240 from pot
*** SUMMARY ***
Total pot 3,240 | Rake 0 | Jackpot 0 | Bingo 0 | Fortune 0 | Tax 0
Board [Ad 7s Jc Ks]
Seat 1: 4cd0385d (big blind) folded on the Turn
Seat 2: c9185546 folded before Flop
Seat 3: 5b10812e folded before Flop
Seat 4: fdf33aa2 won (3,240)
Seat 5: 6f03c89e folded on the Flop
Seat 6: Hero folded before Flop
Seat 7: 82802c28 (button) folded before Flop
Seat 8: 49831e93 (small blind) folded before Flop


Poker Hand #TM3552489302: Tournament #156543396, Bounty Hunters Special $1.08 Hold'em No Limit - Level3(80/160) - 2024/08/05 10:06:37
Table '55' 8-max Seat #6 is the button
Seat 1: 4cd0385d (5,880 in chips)
Seat 2: c9185546 (22,699 in chips)
Seat 3: 5b10812e (11,523 in chips)
Seat 4: fdf33aa2 (17,078 in chips)
Seat 5: 6f03c89e (15,848 in chips)
Seat 6: Hero (8,633 in chips)
Seat 7: 82802c28 (8,182 in chips)
Seat 8: 49831e93 (8,872 in chips)
49831e93: posts the ante 24
6f03c89e: posts the ante 24
c9185546: posts the ante 24
fdf33aa2: posts the ante 24
82802c28: posts the ante 24
4cd0385d: posts the ante 24
Hero: posts the ante 24
5b10812e: posts the ante 24
82802c28: posts small blind 80
49831e93: posts big blind 160
*** HOLE CARDS ***
Dealt to 4cd0385d 
Dealt to c9185546 
Dealt to 5b10812e 
Dealt to fdf33aa2 
Dealt to 6f03c89e 
Dealt to Hero [9c 9d]
Dealt to 82802c28 
Dealt to 49831e93 
4cd0385d: folds
c9185546: folds
5b10812e: calls 160
fdf33aa2: folds
6f03c89e: folds
Hero: raises 376 to 536
82802c28: folds
49831e93: folds
5b10812e: calls 376
*** FLOP *** [Ts 3d 8c]
5b10812e: checks
Hero: bets 752
5b10812e: folds
Uncalled bet (752) returned to Hero
*** SHOWDOWN ***
Hero collected 1,504 from pot
*** SUMMARY ***
Total pot 1,504 | Rake 0 | Jackpot 0 | Bingo 0 | Fortune 0 | Tax 0
Board [Ts 3d 8c]
Seat 1: 4cd0385d folded before Flop
Seat 2: c9185546 folded before Flop
Seat 3: 5b10812e folded on the Flop
Seat 4: fdf33aa2 folded before Flop
Seat 5: 6f03c89e folded before Flop
Seat 6: Hero (button) won (1,504)
Seat 7: 82802c28 (small blind) folded before Flop
Seat 8: 49831e93 (big blind) folded before Flop


Poker Hand #TM3552489277: Tournament #156543396, Bounty Hunters Special $1.08 Hold'em No Limit - Level3(80/160) - 2024/08/05 10:05:43
Table '55' 8-max Seat #5 is the button
Seat 1: 4cd0385d (5,904 in chips)
Seat 2: c9185546 (22,723 in chips)
Seat 3: 5b10812e (10,699 in chips)
Seat 4: fdf33aa2 (17,102 in chips)
Seat 5: 6f03c89e (15,872 in chips)
Seat 6: Hero (9,153 in chips)
Seat 7: 82802c28 (8,366 in chips)
Seat 8: 49831e93 (8,896 in chips)
49831e93: posts the ante 24
6f03c89e: posts the ante 24
c9185546: posts the ante 24
fdf33aa2: posts the ante 24
82802c28: posts the ante 24
4cd0385d: posts the ante 24
Hero: posts the ante 24
5b10812e: posts the ante 24
Hero: posts small blind 80
82802c28: posts big blind 160
*** HOLE CARDS ***
Dealt to 4cd0385d 
Dealt to c9185546 
Dealt to 5b10812e 
Dealt to fdf33aa2 
Dealt to 6f03c89e 
Dealt to Hero [8s 8h]
Dealt to 82802c28 
Dealt to 49831e93 
49831e93: folds
4cd0385d: folds
c9185546: folds
5b10812e: calls 160
fdf33aa2: folds
6f03c89e: folds
Hero: calls 80
82802c28: checks
*** FLOP *** [5h Jh 5c]
Hero: checks
82802c28: checks
5b10812e: bets 336
Hero: calls 336
82802c28: folds
*** TURN *** [5h Jh 5c] [Qs]
Hero: checks
5b10812e: checks
*** RIVER *** [5h Jh 5c Qs] [Kh]
Hero: checks
5b10812e: bets 672
Hero: folds
Uncalled bet (672) returned to 5b10812e
*** SHOWDOWN ***
5b10812e collected 1,344 from pot
*** SUMMARY ***
Total pot 1,344 | Rake 0 | Jackpot 0 | Bingo 0 | Fortune 0 | Tax 0
Board [5h Jh 5c Qs Kh]
Seat 1: 4cd0385d folded before Flop
Seat 2: c9185546 folded before Flop
Seat 3: 5b10812e won (1,344)
Seat 4: fdf33aa2 folded before Flop
Seat 5: 6f03c89e (button) folded before Flop
Seat 6: Hero (small blind) folded on the River
Seat 7: 82802c28 (big blind) folded on the Flop
Seat 8: 49831e93 folded before Flop


Poker Hand #TM3552489243: Tournament #156543396, Bounty Hunters Special $1.08 Hold'em No Limit - Level3(80/160) - 2024/08/05 10:04:26
Table '55' 8-max Seat #4 is the button
Seat 1: 4cd0385d (5,928 in chips)
Seat 2: c9185546 (22,747 in chips)
Seat 3: 5b10812e (10,723 in chips)
Seat 4: fdf33aa2 (15,254 in chips)
Seat 5: 6f03c89e (15,976 in chips)
Seat 6: Hero (9,337 in chips)
Seat 7: 82802c28 (8,390 in chips)
Seat 8: 49831e93 (10,360 in chips)
49831e93: posts the ante 24
6f03c89e: posts the ante 24
c9185546: posts the ante 24
fdf33aa2: posts the ante 24
82802c28: posts the ante 24
4cd0385d: posts the ante 24
Hero: posts the ante 24
5b10812e: posts the ante 24
6f03c89e: posts small blind 80
Hero: posts big blind 160
*** HOLE CARDS ***
Dealt to 4cd0385d 
Dealt to c9185546 
Dealt to 5b10812e 
Dealt to fdf33aa2 
Dealt to 6f03c89e 
Dealt to Hero [6s Jh]
Dealt to 82802c28 
Dealt to 49831e93 
82802c28: folds
49831e93: raises 160 to 320
4cd0385d: folds
c9185546: folds
5b10812e: folds
fdf33aa2: calls 320
6f03c89e: folds
Hero: folds
*** FLOP *** [Qh Td 9d]
49831e93: checks
fdf33aa2: bets 400
49831e93: calls 400
*** TURN *** [Qh Td 9d] [3h]
49831e93: checks
fdf33aa2: bets 720
49831e93: calls 720
*** RIVER *** [Qh Td 9d 3h] [Tc]
49831e93: checks
fdf33aa2: checks
49831e93: shows [7d Ad] (Pair of Tens)
fdf33aa2: shows [8h 9h] (Pair of Tens and Pair of Nines)
*** SHOWDOWN ***
fdf33aa2 collected 3,312 from pot
*** SUMMARY ***
Total pot 3,312 | Rake 0 | Jackpot 0 | Bingo 0 | Fortune 0 | Tax 0
Board [Qh Td 9d 3h Tc]
Seat 1: 4cd0385d folded before Flop
Seat 2: c9185546 folded before Flop
Seat 3: 5b10812e folded before Flop
Seat 4: fdf33aa2 (button) showed [8h 9h] and won (3,312) with Pair of Tens and Pair of Nines
Seat 5: 6f03c89e (small blind) folded before Flop
Seat 6: Hero (big blind) folded before Flop
Seat 7: 82802c28 folded before Flop
Seat 8: 49831e93 showed [7d Ad] and lost with Pair of Tens


Poker Hand #TM3552489221: Tournament #156543396, Bounty Hunters Special $1.08 Hold'em No Limit - Level3(80/160) - 2024/08/05 10:03:51
Table '55' 8-max Seat #3 is the button
Seat 1: 4cd0385d (5,952 in chips)
Seat 2: c9185546 (22,771 in chips)
Seat 3: 5b10812e (10,747 in chips)
Seat 4: fdf33aa2 (15,358 in chips)
Seat 5: 6f03c89e (16,160 in chips)
Seat 6: Hero (9,361 in chips)
Seat 7: 82802c28 (8,414 in chips)
Seat 8: 49831e93 (9,952 in chips)
49831e93: posts the ante 24
6f03c89e: posts the ante 24
c9185546: posts the ante 24
fdf33aa2: posts the ante 24
82802c28: posts the ante 24
4cd0385d: posts the ante 24
Hero: posts the ante 24
5b10812e: posts the ante 24
fdf33aa2: posts small blind 80
6f03c89e: posts big blind 160
*** HOLE CARDS ***
Dealt to 4cd0385d 
Dealt to c9185546 
Dealt to 5b10812e 
Dealt to fdf33aa2 
Dealt to 6f03c89e 
Dealt to Hero [3d Ac]
Dealt to 82802c28 
Dealt to 49831e93 
Hero: folds
82802c28: folds
49831e93: raises 160 to 320
4cd0385d: folds
c9185546: folds
5b10812e: folds
fdf33aa2: folds
6f03c89e: folds
Uncalled bet (160) returned to 49831e93
*** SHOWDOWN ***
49831e93 collected 592 from pot
*** SUMMARY ***
Total pot 592 | Rake 0 | Jackpot 0 | Bingo 0 | Fortune 0 | Tax 0
Seat 1: 4cd0385d folded before Flop
Seat 2: c9185546 folded before Flop
Seat 3: 5b10812e (button) folded before Flop
Seat 4: fdf33aa2 (small blind) folded before Flop
Seat 5: 6f03c89e (big blind) folded before Flop
Seat 6: Hero folded before Flop
Seat 7: 82802c28 folded before Flop
Seat 8: 49831e93 collected (592)


Poker Hand #TM3552489166: Tournament #156543396, Bounty Hunters Special $1.08 Hold'em No Limit - Level3(80/160) - 2024/08/05 10:01:52
Table '55' 8-max Seat #2 is the button
Seat 1: 4cd0385d (5,976 in chips)
Seat 2: c9185546 (22,795 in chips)
Seat 3: 5b10812e (12,654 in chips)
Seat 4: fdf33aa2 (15,542 in chips)
Seat 5: 6f03c89e (13,949 in chips)
Seat 6: Hero (9,385 in chips)
Seat 7: 82802c28 (8,438 in chips)
Seat 8: 49831e93 (9,976 in chips)
49831e93: posts the ante 24
6f03c89e: posts the ante 24
c9185546: posts the ante 24
fdf33aa2: posts the ante 24
82802c28: posts the ante 24
4cd0385d: posts the ante 24
Hero: posts the ante 24
5b10812e: posts the ante 24
5b10812e: posts small blind 80
fdf33aa2: posts big blind 160
*** HOLE CARDS ***
Dealt to 4cd0385d 
Dealt to c9185546 
Dealt to 5b10812e 
Dealt to fdf33aa2 
Dealt to 6f03c89e 
Dealt to Hero [2c 8d]
Dealt to 82802c28 
Dealt to 49831e93 
6f03c89e: raises 160 to 320
Hero: folds
82802c28: folds
49831e93: folds
4cd0385d: folds
c9185546: folds
5b10812e: calls 240
fdf33aa2: folds
*** FLOP *** [5d Td 7h]
5b10812e: checks
6f03c89e: bets 744
5b10812e: calls 744
*** TURN *** [5d Td 7h] [Qd]
5b10812e: checks
6f03c89e: checks
*** RIVER *** [5d Td 7h Qd] [2s]
5b10812e: bets 819
6f03c89e: raises 1,101 to 1,920
5b10812e: folds
Uncalled bet (1,101) returned to 6f03c89e
*** SHOWDOWN ***
6f03c89e collected 4,118 from pot
*** SUMMARY ***
Total pot 4,118 | Rake 0 | Jackpot 0 | Bingo 0 | Fortune 0 | Tax 0
Board [5d Td 7h Qd 2s]
Seat 1: 4cd0385d folded before Flop
Seat 2: c9185546 (button) folded before Flop
Seat 3: 5b10812e (small blind) folded on the River
Seat 4: fdf33aa2 (big blind) folded before Flop
Seat 5: 6f03c89e won (4,118)
Seat 6: Hero folded before Flop
Seat 7: 82802c28 folded before Flop
Seat 8: 49831e93 folded before Flop


Poker Hand #TM3552489104: Tournament #156543396, Bounty Hunters Special $1.08 Hold'em No Limit - Level3(80/160) - 2024/08/05 09:54:22
Table '55' 8-max Seat #1 is the button
Seat 1: 4cd0385d (6,000 in chips)
Seat 2: c9185546 (21,667 in chips)
Seat 3: 5b10812e (12,838 in chips)
Seat 4: fdf33aa2 (15,966 in chips)
Seat 5: 6f03c89e (13,973 in chips)
Seat 6: Hero (9,809 in chips)
Seat 7: 82802c28 (8,462 in chips)
Seat 8: 49831e93 (10,000 in chips)
49831e93: posts the ante 24
6f03c89e: posts the ante 24
c9185546: posts the ante 24
fdf33aa2: posts the ante 24
82802c28: posts the ante 24
4cd0385d: posts the ante 24
Hero: posts the ante 24
5b10812e: posts the ante 24
c9185546: posts small blind 80
5b10812e: posts big blind 160
*** HOLE CARDS ***
Dealt to 4cd0385d 
Dealt to c9185546 
Dealt to 5b10812e 
Dealt to fdf33aa2 
Dealt to 6f03c89e 
Dealt to Hero [Jc 8c]
Dealt to 82802c28 
Dealt to 49831e93 
fdf33aa2: raises 240 to 400
6f03c89e: folds
Hero: calls 400
82802c28: folds
49831e93: folds
4cd0385d: folds
c9185546: calls 320
5b10812e: folds
*** FLOP *** [3c 5d 2s]
c9185546: checks
fdf33aa2: checks
Hero: checks
*** TURN *** [3c 5d 2s] [Kd]
c9185546: checks
fdf33aa2: checks
Hero: checks
*** RIVER *** [3c 5d 2s Kd] [7d]
c9185546: checks
fdf33aa2: checks
Hero: checks
c9185546: shows [6c 7h] (Pair of Sevens)
fdf33aa2: shows [9s As] (Ace-High)
Hero: shows [Jc 8c] (King-High)
*** SHOWDOWN ***
c9185546 collected 1,552 from pot
*** SUMMARY ***
Total pot 1,552 | Rake 0 | Jackpot 0 | Bingo 0 | Fortune 0 | Tax 0
Board [3c 5d 2s Kd 7d]
Seat 1: 4cd0385d (button) folded before Flop
Seat 2: c9185546 (small blind) showed [6c 7h] and won (1,552) with Pair of Sevens
Seat 3: 5b10812e (big blind) folded before Flop
Seat 4: fdf33aa2 showed [9s As] and lost with Ace-High
Seat 5: 6f03c89e folded before Flop
Seat 6: Hero showed [Jc 8c] and lost with King-High
Seat 7: 82802c28 folded before Flop
Seat 8: 49831e93 folded before Flop


Poker Hand #TM3552489077: Tournament #156543396, Bounty Hunters Special $1.08 Hold'em No Limit - Level3(80/160) - 2024/08/05 09:53:31
Table '55' 8-max Seat #7 is the button
Seat 1: 4cd0385d (6,104 in chips)
Seat 2: c9185546 (21,851 in chips)
Seat 3: 5b10812e (12,862 in chips)
Seat 4: fdf33aa2 (16,870 in chips)
Seat 5: 6f03c89e (13,997 in chips)
Seat 6: Hero (8,545 in chips)
Seat 7: 82802c28 (8,486 in chips)
6f03c89e: posts the ante 24
c9185546: posts the ante 24
fdf33aa2: posts the ante 24
82802c28: posts the ante 24
4cd0385d: posts the ante 24
Hero: posts the ante 24
5b10812e: posts the ante 24
4cd0385d: posts small blind 80
c9185546: posts big blind 160
*** HOLE CARDS ***
Dealt to 4cd0385d 
Dealt to c9185546 
Dealt to 5b10812e 
Dealt to fdf33aa2 
Dealt to 6f03c89e 
Dealt to Hero [6c Ac]
Dealt to 82802c28 
5b10812e: folds
fdf33aa2: raises 160 to 320
6f03c89e: folds
Hero: calls 320
82802c28: folds
4cd0385d: folds
c9185546: folds
*** FLOP *** [9c Td 2c]
fdf33aa2: checks
Hero: checks
*** TURN *** [9c Td 2c] [5c]
fdf33aa2: bets 560
Hero: calls 560
*** RIVER *** [9c Td 2c 5c] [Th]
fdf33aa2: checks
Hero: bets 1,084
fdf33aa2: folds
Uncalled bet (1,084) returned to Hero
*** SHOWDOWN ***
Hero collected 2,168 from pot
*** SUMMARY ***
Total pot 2,168 | Rake 0 | Jackpot 0 | Bingo 0 | Fortune 0 | Tax 0
Board [9c Td 2c 5c Th]
Seat 1: 4cd0385d (small blind) folded before Flop
Seat 2: c9185546 (big blind) folded before Flop
Seat 3: 5b10812e folded before Flop
Seat 4: fdf33aa2 folded on the River
Seat 5: 6f03c89e folded before Flop
Seat 6: Hero won (2,168)
Seat 7: 82802c28 (button) folded before Flop


Poker Hand #TM3552049067: Tournament #156543396, Bounty Hunters Special $1.08 Hold'em No Limit - Level3(80/160) - 2024/08/05 09:53:11
Table '55' 8-max Seat #6 is the button
Seat 1: 4cd0385d (6,288 in chips)
Seat 2: c9185546 (21,467 in chips)
Seat 3: 5b10812e (12,886 in chips)
Seat 4: fdf33aa2 (16,894 in chips)
Seat 5: 6f03c89e (14,021 in chips)
Seat 6: Hero (8,569 in chips)
Seat 7: 82802c28 (8,590 in chips)
6f03c89e: posts the ante 24
c9185546: posts the ante 24
fdf33aa2: posts the ante 24
82802c28: posts the ante 24
4cd0385d: posts the ante 24
Hero: posts the ante 24
5b10812e: posts the ante 24
82802c28: posts small blind 80
4cd0385d: posts big blind 160
*** HOLE CARDS ***
Dealt to 4cd0385d 
Dealt to c9185546 
Dealt to 5b10812e 
Dealt to fdf33aa2 
Dealt to 6f03c89e 
Dealt to Hero [5s 2d]
Dealt to 82802c28 
c9185546: raises 240 to 400
5b10812e: folds
fdf33aa2: folds
6f03c89e: folds
Hero: folds
82802c28: folds
4cd0385d: folds
Uncalled bet (240) returned to c9185546
*** SHOWDOWN ***
c9185546 collected 568 from pot
*** SUMMARY ***
Total pot 568 | Rake 0 | Jackpot 0 | Bingo 0 | Fortune 0 | Tax 0
Seat 1: 4cd0385d (big blind) folded before Flop
Seat 2: c9185546 collected (568)
Seat 3: 5b10812e folded before Flop
Seat 4: fdf33aa2 folded before Flop
Seat 5: 6f03c89e folded before Flop
Seat 6: Hero (button) folded before Flop
Seat 7: 82802c28 (small blind) folded before Flop


Poker Hand #TM3552049034: Tournament #156543396, Bounty Hunters Special $1.08 Hold'em No Limit - Level3(80/160) - 2024/08/05 09:52:01
Table '55' 8-max Seat #5 is the button
Seat 1: 4cd0385d (6,312 in chips)
Seat 2: c9185546 (21,491 in chips)
Seat 3: 5b10812e (12,910 in chips)
Seat 4: fdf33aa2 (19,354 in chips)
Seat 5: 6f03c89e (11,201 in chips)
Seat 6: Hero (8,673 in chips)
Seat 7: 82802c28 (8,774 in chips)
6f03c89e: posts the ante 24
c9185546: posts the ante 24
fdf33aa2: posts the ante 24
82802c28: posts the ante 24
4cd0385d: posts the ante 24
Hero: posts the ante 24
5b10812e: posts the ante 24
Hero: posts small blind 80
82802c28: posts big blind 160
*** HOLE CARDS ***
Dealt to 4cd0385d 
Dealt to c9185546 
Dealt to 5b10812e 
Dealt to fdf33aa2 
Dealt to 6f03c89e 
Dealt to Hero [4h 2d]
Dealt to 82802c28 
4cd0385d: folds
c9185546: folds
5b10812e: folds
fdf33aa2: raises 160 to 320
6f03c89e: calls 320
Hero: folds
82802c28: folds
*** FLOP *** [7d 9s 3s]
fdf33aa2: bets 346
6f03c89e: calls 346
*** TURN *** [7d 9s 3s] [Kc]
fdf33aa2: bets 720
6f03c89e: calls 720
*** RIVER *** [7d 9s 3s Kc] [Ks]
fdf33aa2: checks
6f03c89e: bets 1,050
fdf33aa2: calls 1,050
6f03c89e: shows [7c 7h] (Sevens Full over Kings)
fdf33aa2: shows [Ah 9c] (Pair of Kings and Pair of Nines)
*** SHOWDOWN ***
6f03c89e collected 5,280 from pot
*** SUMMARY ***
Total pot 5,280 | Rake 0 | Jackpot 0 | Bingo 0 | Fortune 0 | Tax 0
Board [7d 9s 3s Kc Ks]
Seat 1: 4cd0385d folded before Flop
Seat 2: c9185546 folded before Flop
Seat 3: 5b10812e folded before Flop
Seat 4: fdf33aa2 showed [Ah 9c] and lost with Pair of Kings and Pair of Nines
Seat 5: 6f03c89e (button) showed [7c 7h] and won (5,280) with Sevens Full over Kings
Seat 6: Hero (small blind) folded before Flop
Seat 7: 82802c28 (big blind) folded before Flop


Poker Hand #TM3552049007: Tournament #156543396, Bounty Hunters Special $1.08 Hold'em No Limit - Level3(80/160) - 2024/08/05 09:51:02
Table '55' 8-max Seat #4 is the button
Seat 1: 4cd0385d (6,336 in chips)
Seat 2: c9185546 (21,835 in chips)
Seat 3: 5b10812e (12,934 in chips)
Seat 4: fdf33aa2 (18,626 in chips)
Seat 5: 6f03c89e (11,305 in chips)
Seat 6: Hero (8,857 in chips)
Seat 7: 82802c28 (8,798 in chips)
Seat 8: 22cc398a (10,555 in chips)
6f03c89e: posts the ante 24
c9185546: posts the ante 24
fdf33aa2: posts the ante 24
82802c28: posts the ante 24
4cd0385d: posts the ante 24
22cc398a: posts the ante 24
Hero: posts the ante 24
5b10812e: posts the ante 24
6f03c89e: posts small blind 80
Hero: posts big blind 160
*** HOLE CARDS ***
Dealt to 4cd0385d 
Dealt to c9185546 
Dealt to 5b10812e 
Dealt to fdf33aa2 
Dealt to 6f03c89e 
Dealt to Hero [3h Jh]
Dealt to 82802c28 
Dealt to 22cc398a 
82802c28: folds
22cc398a: folds
4cd0385d: folds
c9185546: raises 160 to 320
5b10812e: folds
fdf33aa2: raises 880 to 1,200
6f03c89e: folds
Hero: folds
c9185546: folds
Uncalled bet (880) returned to fdf33aa2
*** SHOWDOWN ***
fdf33aa2 collected 1,072 from pot
*** SUMMARY ***
Total pot 1,072 | Rake 0 | Jackpot 0 | Bingo 0 | Fortune 0 | Tax 0
Seat 1: 4cd0385d folded before Flop
Seat 2: c9185546 folded before Flop
Seat 3: 5b10812e folded before Flop
Seat 4: fdf33aa2 (button) collected (1,072)
Seat 5: 6f03c89e (small blind) folded before Flop
Seat 6: Hero (big blind) folded before Flop
Seat 7: 82802c28 folded before Flop
Seat 8: 22cc398a folded before Flop


Poker Hand #TM3552048969: Tournament #156543396, Bounty Hunters Special $1.08 Hold'em No Limit - Level3(80/160) - 2024/08/05 09:50:01
Table '55' 8-max Seat #3 is the button
Seat 1: 4cd0385d (6,360 in chips)
Seat 3: 5b10812e (12,958 in chips)
Seat 4: fdf33aa2 (18,730 in chips)
Seat 5: 6f03c89e (12,093 in chips)
Seat 6: Hero (7,869 in chips)
Seat 7: 82802c28 (8,822 in chips)
Seat 8: 22cc398a (10,579 in chips)
6f03c89e: posts the ante 24
fdf33aa2: posts the ante 24
82802c28: posts the ante 24
4cd0385d: posts the ante 24
22cc398a: posts the ante 24
Hero: posts the ante 24
5b10812e: posts the ante 24
fdf33aa2: posts small blind 80
6f03c89e: posts big blind 160
*** HOLE CARDS ***
Dealt to 4cd0385d 
Dealt to 5b10812e 
Dealt to fdf33aa2 
Dealt to 6f03c89e 
Dealt to Hero [9c 9d]
Dealt to 82802c28 
Dealt to 22cc398a 
Hero: raises 160 to 320
82802c28: folds
22cc398a: folds
4cd0385d: folds
5b10812e: folds
fdf33aa2: folds
6f03c89e: calls 160
*** FLOP *** [Jh Kc 2d]
6f03c89e: checks
Hero: checks
*** TURN *** [Jh Kc 2d] [8h]
6f03c89e: checks
Hero: bets 444
6f03c89e: calls 444
*** RIVER *** [Jh Kc 2d 8h] [4s]
6f03c89e: checks
Hero: checks
6f03c89e: shows [3c 3d] (Pair of Treys)
Hero: shows [9c 9d] (Pair of Nines)
*** SHOWDOWN ***
Hero collected 1,776 from pot
*** SUMMARY ***
Total pot 1,776 | Rake 0 | Jackpot 0 | Bingo 0 | Fortune 0 | Tax 0
Board [Jh Kc 2d 8h 4s]
Seat 1: 4cd0385d folded before Flop
Seat 3: 5b10812e (button) folded before Flop
Seat 4: fdf33aa2 (small blind) folded before Flop
Seat 5: 6f03c89e (big blind) showed [3c 3d] and lost with Pair of Treys
Seat 6: Hero showed [9c 9d] and won (1,776) with Pair of Nines
Seat 7: 82802c28 folded before Flop
Seat 8: 22cc398a folded before Flop


Poker Hand #TM3552048922: Tournament #156543396, Bounty Hunters Special $1.08 Hold'em No Limit - Level2(60/120) - 2024/08/05 09:48:33
Table '55' 8-max Seat #2 is the button
Seat 1: 4cd0385d (6,378 in chips)
Seat 2: 3bd708cb (3,501 in chips)
Seat 3: 5b10812e (9,229 in chips)
Seat 4: fdf33aa2 (18,868 in chips)
Seat 5: 6f03c89e (12,111 in chips)
Seat 6: Hero (7,887 in chips)
Seat 7: 82802c28 (8,840 in chips)
Seat 8: 22cc398a (10,597 in chips)
6f03c89e: posts the ante 18
fdf33aa2: posts the ante 18
3bd708cb: posts the ante 18
82802c28: posts the ante 18
4cd0385d: posts the ante 18
22cc398a: posts the ante 18
Hero: posts the ante 18
5b10812e: posts the ante 18
5b10812e: posts small blind 60
fdf33aa2: posts big blind 120
*** HOLE CARDS ***
Dealt to 4cd0385d 
Dealt to 3bd708cb 
Dealt to 5b10812e 
Dealt to fdf33aa2 
Dealt to 6f03c89e 
Dealt to Hero [7s Kd]
Dealt to 82802c28 
Dealt to 22cc398a 
6f03c89e: folds
Hero: folds
82802c28: folds
22cc398a: folds
4cd0385d: folds
3bd708cb: raises 132 to 252
5b10812e: calls 192
fdf33aa2: folds
*** FLOP *** [Tc 5d 9c]
5b10812e: checks
3bd708cb: bets 254
5b10812e: calls 254
*** TURN *** [Tc 5d 9c] [8d]
5b10812e: checks
3bd708cb: bets 957
5b10812e: raises 7,748 to 8,705 and is all-in
3bd708cb: calls 2,020 and is all-in
Uncalled bet (5,728) returned to 5b10812e
5b10812e: shows [Kh 9h] (Pair of Nines)
3bd708cb: shows [Jh 9d] (Pair of Nines)
*** RIVER *** [Tc 5d 9c 8d] [9s]
*** SHOWDOWN ***
5b10812e collected 7,230 from pot
*** SUMMARY ***
Total pot 7,230 | Rake 0 | Jackpot 0 | Bingo 0 | Fortune 0 | Tax 0
Board [Tc 5d 9c 8d 9s]
Seat 1: 4cd0385d folded before Flop
Seat 2: 3bd708cb (button) showed [Jh 9d] and lost with Three Nines
Seat 3: 5b10812e (small blind) showed [Kh 9h] and won (7,230) with Three Nines
Seat 4: fdf33aa2 (big blind) folded before Flop
Seat 5: 6f03c89e folded before Flop
Seat 6: Hero folded before Flop
Seat 7: 82802c28 folded before Flop
Seat 8: 22cc398a folded before Flop


Poker Hand #TM3552048881: Tournament #156543396, Bounty Hunters Special $1.08 Hold'em No Limit - Level2(60/120) - 2024/08/05 09:47:17
Table '55' 8-max Seat #1 is the button
Seat 1: 4cd0385d (6,396 in chips)
Seat 2: 3bd708cb (3,579 in chips)
Seat 3: 5b10812e (9,487 in chips)
Seat 4: fdf33aa2 (19,126 in chips)
Seat 5: 6f03c89e (12,369 in chips)
Seat 6: Hero (7,905 in chips)
Seat 7: 82802c28 (8,858 in chips)
Seat 8: 22cc398a (9,691 in chips)
6f03c89e: posts the ante 18
fdf33aa2: posts the ante 18
82802c28: posts the ante 18
3bd708cb: posts the ante 18
4cd0385d: posts the ante 18
22cc398a: posts the ante 18
Hero: posts the ante 18
5b10812e: posts the ante 18
3bd708cb: posts small blind 60
5b10812e: posts big blind 120
*** HOLE CARDS ***
Dealt to 4cd0385d 
Dealt to 3bd708cb 
Dealt to 5b10812e 
Dealt to fdf33aa2 
Dealt to 6f03c89e 
Dealt to Hero [4d Js]
Dealt to 82802c28 
Dealt to 22cc398a 
fdf33aa2: raises 120 to 240
6f03c89e: calls 240
Hero: folds
82802c28: folds
22cc398a: calls 240
4cd0385d: folds
3bd708cb: folds
5b10812e: calls 120
*** FLOP *** [5d 6c 6h]
5b10812e: checks
fdf33aa2: checks
6f03c89e: checks
22cc398a: bets 385
5b10812e: folds
fdf33aa2: folds
6f03c89e: folds
Uncalled bet (385) returned to 22cc398a
*** SHOWDOWN ***
22cc398a collected 1,164 from pot
*** SUMMARY ***
Total pot 1,164 | Rake 0 | Jackpot 0 | Bingo 0 | Fortune 0 | Tax 0
Board [5d 6c 6h]
Seat 1: 4cd0385d (button) folded before Flop
Seat 2: 3bd708cb (small blind) folded before Flop
Seat 3: 5b10812e (big blind) folded on the Flop
Seat 4: fdf33aa2 folded on the Flop
Seat 5: 6f03c89e folded on the Flop
Seat 6: Hero folded before Flop
Seat 7: 82802c28 folded before Flop
Seat 8: 22cc398a won (1,164)


Poker Hand #TM3552048850: Tournament #156543396, Bounty Hunters Special $1.08 Hold'em No Limit - Level2(60/120) - 2024/08/05 09:46:19
Table '55' 8-max Seat #8 is the button
Seat 1: 4cd0385d (6,786 in chips)
Seat 2: 3bd708cb (2,961 in chips)
Seat 3: 5b10812e (9,505 in chips)
Seat 4: fdf33aa2 (19,144 in chips)
Seat 5: 6f03c89e (12,387 in chips)
Seat 6: Hero (7,923 in chips)
Seat 7: 82802c28 (8,876 in chips)
Seat 8: 22cc398a (9,829 in chips)
6f03c89e: posts the ante 18
fdf33aa2: posts the ante 18
82802c28: posts the ante 18
3bd708cb: posts the ante 18
4cd0385d: posts the ante 18
22cc398a: posts the ante 18
Hero: posts the ante 18
5b10812e: posts the ante 18
4cd0385d: posts small blind 60
3bd708cb: posts big blind 120
*** HOLE CARDS ***
Dealt to 4cd0385d 
Dealt to 3bd708cb 
Dealt to 5b10812e 
Dealt to fdf33aa2 
Dealt to 6f03c89e 
Dealt to Hero [Ad 7d]
Dealt to 82802c28 
Dealt to 22cc398a 
5b10812e: folds
fdf33aa2: folds
6f03c89e: folds
Hero: folds
82802c28: folds
22cc398a: calls 120
4cd0385d: calls 60
3bd708cb: checks
*** FLOP *** [Jc 7s Kh]
4cd0385d: checks
3bd708cb: bets 252
22cc398a: folds
4cd0385d: calls 252
*** TURN *** [Jc 7s Kh] [Js]
4cd0385d: checks
3bd708cb: checks
*** RIVER *** [Jc 7s Kh Js] [Kc]
4cd0385d: checks
3bd708cb: bets 1,008
4cd0385d: folds
Uncalled bet (1,008) returned to 3bd708cb
*** SHOWDOWN ***
3bd708cb collected 1,008 from pot
*** SUMMARY ***
Total pot 1,008 | Rake 0 | Jackpot 0 | Bingo 0 | Fortune 0 | Tax 0
Board [Jc 7s Kh Js Kc]
Seat 1: 4cd0385d (small blind) folded on the River
Seat 2: 3bd708cb (big blind) won (1,008)
Seat 3: 5b10812e folded before Flop
Seat 4: fdf33aa2 folded before Flop
Seat 5: 6f03c89e folded before Flop
Seat 6: Hero folded before Flop
Seat 7: 82802c28 folded before Flop
Seat 8: 22cc398a (button) folded on the Flop


Poker Hand #TM3552048829: Tournament #156543396, Bounty Hunters Special $1.08 Hold'em No Limit - Level2(60/120) - 2024/08/05 09:45:40
Table '55' 8-max Seat #7 is the button
Seat 1: 4cd0385d (7,044 in chips)
Seat 2: 3bd708cb (2,295 in chips)
Seat 3: 5b10812e (9,523 in chips)
Seat 4: fdf33aa2 (19,402 in chips)
Seat 5: 6f03c89e (12,405 in chips)
Seat 6: Hero (7,941 in chips)
Seat 7: 82802c28 (8,894 in chips)
Seat 8: 22cc398a (9,907 in chips)
6f03c89e: posts the ante 18
fdf33aa2: posts the ante 18
82802c28: posts the ante 18
3bd708cb: posts the ante 18
4cd0385d: posts the ante 18
Hero: posts the ante 18
22cc398a: posts the ante 18
5b10812e: posts the ante 18
22cc398a: posts small blind 60
4cd0385d: posts big blind 120
*** HOLE CARDS ***
Dealt to 4cd0385d 
Dealt to 3bd708cb 
Dealt to 5b10812e 
Dealt to fdf33aa2 
Dealt to 6f03c89e 
Dealt to Hero [5c Jc]
Dealt to 82802c28 
Dealt to 22cc398a 
3bd708cb: raises 120 to 240
5b10812e: folds
fdf33aa2: calls 240
6f03c89e: folds
Hero: folds
82802c28: folds
22cc398a: folds
4cd0385d: calls 120
*** FLOP *** [3h 6h 4h]
4cd0385d: checks
3bd708cb: bets 305
fdf33aa2: folds
4cd0385d: folds
Uncalled bet (305) returned to 3bd708cb
*** SHOWDOWN ***
3bd708cb collected 924 from pot
*** SUMMARY ***
Total pot 924 | Rake 0 | Jackpot 0 | Bingo 0 | Fortune 0 | Tax 0
Board [3h 6h 4h]
Seat 1: 4cd0385d (big blind) folded on the Flop
Seat 2: 3bd708cb won (924)
Seat 3: 5b10812e folded before Flop
Seat 4: fdf33aa2 folded on the Flop
Seat 5: 6f03c89e folded before Flop
Seat 6: Hero folded before Flop
Seat 7: 82802c28 (button) folded before Flop
Seat 8: 22cc398a (small blind) folded before Flop


Poker Hand #TM3552048801: Tournament #156543396, Bounty Hunters Special $1.08 Hold'em No Limit - Level2(60/120) - 2024/08/05 09:44:41
Table '55' 8-max Seat #6 is the button
Seat 1: 4cd0385d (7,062 in chips)
Seat 2: 3bd708cb (2,313 in chips)
Seat 3: 5b10812e (9,901 in chips)
Seat 4: fdf33aa2 (18,496 in chips)
Seat 5: 6f03c89e (12,423 in chips)
Seat 6: Hero (7,959 in chips)
Seat 7: 82802c28 (8,972 in chips)
Seat 8: 22cc398a (10,285 in chips)
6f03c89e: posts the ante 18
fdf33aa2: posts the ante 18
3bd708cb: posts the ante 18
82802c28: posts the ante 18
4cd0385d: posts the ante 18
Hero: posts the ante 18
22cc398a: posts the ante 18
5b10812e: posts the ante 18
82802c28: posts small blind 60
22cc398a: posts big blind 120
*** HOLE CARDS ***
Dealt to 4cd0385d 
Dealt to 3bd708cb 
Dealt to 5b10812e 
Dealt to fdf33aa2 
Dealt to 6f03c89e 
Dealt to Hero [8s 7c]
Dealt to 82802c28 
Dealt to 22cc398a 
4cd0385d: folds
3bd708cb: folds
5b10812e: calls 120
fdf33aa2: raises 240 to 360
6f03c89e: folds
Hero: folds
82802c28: folds
22cc398a: calls 240
5b10812e: calls 240
*** FLOP *** [Jh Kc 4h]
22cc398a: checks
5b10812e: checks
fdf33aa2: bets 424
22cc398a: folds
5b10812e: folds
Uncalled bet (424) returned to fdf33aa2
*** SHOWDOWN ***
fdf33aa2 collected 1,284 from pot
*** SUMMARY ***
Total pot 1,284 | Rake 0 | Jackpot 0 | Bingo 0 | Fortune 0 | Tax 0
Board [Jh Kc 4h]
Seat 1: 4cd0385d folded before Flop
Seat 2: 3bd708cb folded before Flop
Seat 3: 5b10812e folded on the Flop
Seat 4: fdf33aa2 won (1,284)
Seat 5: 6f03c89e folded before Flop
Seat 6: Hero (button) folded before Flop
Seat 7: 82802c28 (small blind) folded before Flop
Seat 8: 22cc398a (big blind) folded on the Flop


Poker Hand #TM3552048769: Tournament #156543396, Bounty Hunters Special $1.08 Hold'em No Limit - Level2(60/120) - 2024/08/05 09:43:36
Table '55' 8-max Seat #5 is the button
Seat 1: 4cd0385d (7,080 in chips)
Seat 2: 3bd708cb (2,331 in chips)
Seat 3: 5b10812e (9,919 in chips)
Seat 4: fdf33aa2 (18,514 in chips)
Seat 5: 6f03c89e (10,813 in chips)
Seat 6: Hero (8,217 in chips)
Seat 7: 82802c28 (10,234 in chips)
Seat 8: 22cc398a (10,303 in chips)
6f03c89e: posts the ante 18
fdf33aa2: posts the ante 18
3bd708cb: posts the ante 18
82802c28: posts the ante 18
4cd0385d: posts the ante 18
22cc398a: posts the ante 18
Hero: posts the ante 18
5b10812e: posts the ante 18
Hero: posts small blind 60
82802c28: posts big blind 120
*** HOLE CARDS ***
Dealt to 4cd0385d 
Dealt to 3bd708cb 
Dealt to 5b10812e 
Dealt to fdf33aa2 
Dealt to 6f03c89e 
Dealt to Hero [5h 4h]
Dealt to 82802c28 
Dealt to 22cc398a 
22cc398a: folds
4cd0385d: folds
3bd708cb: folds
5b10812e: folds
fdf33aa2: folds
6f03c89e: raises 120 to 240
Hero: calls 180
82802c28: calls 120
*** FLOP *** [Jd Qd 9d]
Hero: checks
82802c28: checks
6f03c89e: bets 286
Hero: folds
82802c28: calls 286
*** TURN *** [Jd Qd 9d] [7c]
82802c28: checks
6f03c89e: bets 718
82802c28: calls 718
*** RIVER *** [Jd Qd 9d 7c] [2c]
82802c28: checks
6f03c89e: checks
82802c28: shows [Jc 8c] (Pair of Jacks)
6f03c89e: shows [Tc Qh] (Pair of Queens)
*** SHOWDOWN ***
6f03c89e collected 2,872 from pot
*** SUMMARY ***
Total pot 2,872 | Rake 0 | Jackpot 0 | Bingo 0 | Fortune 0 | Tax 0
Board [Jd Qd 9d 7c 2c]
Seat 1: 4cd0385d folded before Flop
Seat 2: 3bd708cb folded before Flop
Seat 3: 5b10812e folded before Flop
Seat 4: fdf33aa2 folded before Flop
Seat 5: 6f03c89e (button) showed [Tc Qh] and won (2,872) with Pair of Queens
Seat 6: Hero (small blind) folded on the Flop
Seat 7: 82802c28 (big blind) showed [Jc 8c] and lost with Pair of Jacks
Seat 8: 22cc398a folded before Flop


Poker Hand #TM3552048742: Tournament #156543396, Bounty Hunters Special $1.08 Hold'em No Limit - Level2(60/120) - 2024/08/05 09:42:38
Table '55' 8-max Seat #4 is the button
Seat 1: 4cd0385d (7,098 in chips)
Seat 2: 3bd708cb (2,349 in chips)
Seat 3: 5b10812e (10,642 in chips)
Seat 4: fdf33aa2 (18,532 in chips)
Seat 5: 6f03c89e (9,862 in chips)
Seat 6: Hero (8,355 in chips)
Seat 7: 82802c28 (10,252 in chips)
Seat 8: 22cc398a (10,321 in chips)
6f03c89e: posts the ante 18
fdf33aa2: posts the ante 18
3bd708cb: posts the ante 18
82802c28: posts the ante 18
4cd0385d: posts the ante 18
22cc398a: posts the ante 18
Hero: posts the ante 18
5b10812e: posts the ante 18
6f03c89e: posts small blind 60
Hero: posts big blind 120
*** HOLE CARDS ***
Dealt to 4cd0385d 
Dealt to 3bd708cb 
Dealt to 5b10812e 
Dealt to fdf33aa2 
Dealt to 6f03c89e 
Dealt to Hero [9c 6c]
Dealt to 82802c28 
Dealt to 22cc398a 
82802c28: folds
22cc398a: folds
4cd0385d: folds
3bd708cb: folds
5b10812e: calls 120
fdf33aa2: folds
6f03c89e: raises 252 to 372
Hero: folds
5b10812e: calls 252
*** FLOP *** [Kd 9h 5s]
6f03c89e: bets 333
5b10812e: calls 333
*** TURN *** [Kd 9h 5s] [5h]
6f03c89e: bets 837
5b10812e: folds
Uncalled bet (837) returned to 6f03c89e
*** SHOWDOWN ***
6f03c89e collected 1,674 from pot
*** SUMMARY ***
Total pot 1,674 | Rake 0 | Jackpot 0 | Bingo 0 | Fortune 0 | Tax 0
Board [Kd 9h 5s 5h]
Seat 1: 4cd0385d folded before Flop
Seat 2: 3bd708cb folded before Flop
Seat 3: 5b10812e folded on the Turn
Seat 4: fdf33aa2 (button) folded before Flop
Seat 5: 6f03c89e (small blind) won (1,674)
Seat 6: Hero (big blind) folded before Flop
Seat 7: 82802c28 folded before Flop
Seat 8: 22cc398a folded before Flop


Poker Hand #TM3552048684: Tournament #156543396, Bounty Hunters Special $1.08 Hold'em No Limit - Level2(60/120) - 2024/08/05 09:40:54
Table '55' 8-max Seat #3 is the button
Seat 1: 4cd0385d (7,116 in chips)
Seat 2: 3bd708cb (11,501 in chips)
Seat 3: 5b10812e (10,660 in chips)
Seat 4: fdf33aa2 (9,152 in chips)
Seat 5: 6f03c89e (10,000 in chips)
Seat 6: Hero (8,373 in chips)
Seat 7: 82802c28 (10,270 in chips)
Seat 8: 22cc398a (10,339 in chips)
6f03c89e: posts the ante 18
fdf33aa2: posts the ante 18
3bd708cb: posts the ante 18
82802c28: posts the ante 18
4cd0385d: posts the ante 18
22cc398a: posts the ante 18
Hero: posts the ante 18
5b10812e: posts the ante 18
fdf33aa2: posts small blind 60
6f03c89e: posts big blind 120
*** HOLE CARDS ***
Dealt to 4cd0385d 
Dealt to 3bd708cb 
Dealt to 5b10812e 
Dealt to fdf33aa2 
Dealt to 6f03c89e 
Dealt to Hero [7h 4h]
Dealt to 82802c28 
Dealt to 22cc398a 
Hero: folds
82802c28: folds
22cc398a: folds
4cd0385d: folds
3bd708cb: raises 132 to 252
5b10812e: folds
fdf33aa2: raises 768 to 1,020
6f03c89e: folds
3bd708cb: raises 1,500 to 2,520
fdf33aa2: calls 1,500
*** FLOP *** [5h 5c Js]
fdf33aa2: checks
3bd708cb: bets 1,751
fdf33aa2: raises 4,863 to 6,614 and is all-in
3bd708cb: calls 4,863
fdf33aa2: shows [Tc Td] (Pair of Tens and Pair of Fives)
3bd708cb: shows [Kh As] (Pair of Fives)
*** TURN *** [5h 5c Js] [2d]
*** RIVER *** [5h 5c Js 2d] [9d]
*** SHOWDOWN ***
fdf33aa2 collected 18,532 from pot
*** SUMMARY ***
Total pot 18,532 | Rake 0 | Jackpot 0 | Bingo 0 | Fortune 0 | Tax 0
Board [5h 5c Js 2d 9d]
Seat 1: 4cd0385d folded before Flop
Seat 2: 3bd708cb showed [Kh As] and lost with Pair of Fives
Seat 3: 5b10812e (button) folded before Flop
Seat 4: fdf33aa2 (small blind) showed [Tc Td] and won (18,532) with Pair of Tens and Pair of Fives
Seat 5: 6f03c89e (big blind) folded before Flop
Seat 6: Hero folded before Flop
Seat 7: 82802c28 folded before Flop
Seat 8: 22cc398a folded before Flop


Poker Hand #TM3552048671: Tournament #156543396, Bounty Hunters Special $1.08 Hold'em No Limit - Level2(60/120) - 2024/08/05 09:40:17
Table '55' 8-max Seat #2 is the button
Seat 1: 4cd0385d (7,134 in chips)
Seat 2: 3bd708cb (11,195 in chips)
Seat 3: 5b10812e (10,738 in chips)
Seat 4: fdf33aa2 (9,290 in chips)
Seat 5: b51ee002 (23,225 in chips)
Seat 6: Hero (8,391 in chips)
Seat 7: 82802c28 (10,288 in chips)
Seat 8: 22cc398a (10,357 in chips)
b51ee002: posts the ante 18
fdf33aa2: posts the ante 18
3bd708cb: posts the ante 18
82802c28: posts the ante 18
4cd0385d: posts the ante 18
22cc398a: posts the ante 18
Hero: posts the ante 18
5b10812e: posts the ante 18
5b10812e: posts small blind 60
fdf33aa2: posts big blind 120
*** HOLE CARDS ***
Dealt to 4cd0385d 
Dealt to 3bd708cb 
Dealt to 5b10812e 
Dealt to fdf33aa2 
Dealt to b51ee002 
Dealt to Hero [8s Ac]
Dealt to 82802c28 
Dealt to 22cc398a 
b51ee002: folds
Hero: folds
82802c28: folds
22cc398a: folds
4cd0385d: folds
3bd708cb: raises 132 to 252
5b10812e: folds
fdf33aa2: folds
Uncalled bet (132) returned to 3bd708cb
*** SHOWDOWN ***
3bd708cb collected 444 from pot
*** SUMMARY ***
Total pot 444 | Rake 0 | Jackpot 0 | Bingo 0 | Fortune 0 | Tax 0
Seat 1: 4cd0385d folded before Flop
Seat 2: 3bd708cb (button) collected (444)
Seat 3: 5b10812e (small blind) folded before Flop
Seat 4: fdf33aa2 (big blind) folded before Flop
Seat 5: b51ee002 folded before Flop
Seat 6: Hero folded before Flop
Seat 7: 82802c28 folded before Flop
Seat 8: 22cc398a folded before Flop


Poker Hand #TM3552048628: Tournament #156543396, Bounty Hunters Special $1.08 Hold'em No Limit - Level1(50/100) - 2024/08/05 09:39:06
Table '55' 8-max Seat #1 is the button
Seat 1: 4cd0385d (7,149 in chips)
Seat 2: 3bd708cb (11,310 in chips)
Seat 3: 5b10812e (11,063 in chips)
Seat 4: fdf33aa2 (9,305 in chips)
Seat 5: b51ee002 (23,240 in chips)
Seat 6: Hero (8,406 in chips)
Seat 7: 82802c28 (10,303 in chips)
Seat 8: 22cc398a (9,842 in chips)
b51ee002: posts the ante 15
fdf33aa2: posts the ante 15
82802c28: posts the ante 15
3bd708cb: posts the ante 15
4cd0385d: posts the ante 15
22cc398a: posts the ante 15
Hero: posts the ante 15
5b10812e: posts the ante 15
3bd708cb: posts small blind 50
5b10812e: posts big blind 100
*** HOLE CARDS ***
Dealt to 4cd0385d 
Dealt to 3bd708cb 
Dealt to 5b10812e 
Dealt to fdf33aa2 
Dealt to b51ee002 
Dealt to Hero [Js 3c]
Dealt to 82802c28 
Dealt to 22cc398a 
fdf33aa2: folds
b51ee002: folds
Hero: folds
82802c28: folds
22cc398a: calls 100
4cd0385d: folds
3bd708cb: calls 50
5b10812e: checks
*** FLOP *** [4c 6c Tc]
3bd708cb: checks
5b10812e: checks
22cc398a: bets 210
3bd708cb: folds
5b10812e: calls 210
*** TURN *** [4c 6c Tc] [8c]
5b10812e: checks
22cc398a: bets 420
5b10812e: folds
Uncalled bet (420) returned to 22cc398a
*** SHOWDOWN ***
22cc398a collected 840 from pot
*** SUMMARY ***
Total pot 840 | Rake 0 | Jackpot 0 | Bingo 0 | Fortune 0 | Tax 0
Board [4c 6c Tc 8c]
Seat 1: 4cd0385d (button) folded before Flop
Seat 2: 3bd708cb (small blind) folded on the Flop
Seat 3: 5b10812e (big blind) folded on the Turn
Seat 4: fdf33aa2 folded before Flop
Seat 5: b51ee002 folded before Flop
Seat 6: Hero folded before Flop
Seat 7: 82802c28 folded before Flop
Seat 8: 22cc398a won (840)


Poker Hand #TM3552048594: Tournament #156543396, Bounty Hunters Special $1.08 Hold'em No Limit - Level1(50/100) - 2024/08/05 09:38:01
Table '55' 8-max Seat #8 is the button
Seat 1: 4cd0385d (7,214 in chips)
Seat 2: 3bd708cb (10,500 in chips)
Seat 3: 5b10812e (11,078 in chips)
Seat 4: fdf33aa2 (9,775 in chips)
Seat 5: b51ee002 (23,255 in chips)
Seat 6: Hero (8,621 in chips)
Seat 7: 82802c28 (10,318 in chips)
Seat 8: 22cc398a (9,857 in chips)
b51ee002: posts the ante 15
fdf33aa2: posts the ante 15
82802c28: posts the ante 15
3bd708cb: posts the ante 15
4cd0385d: posts the ante 15
22cc398a: posts the ante 15
Hero: posts the ante 15
5b10812e: posts the ante 15
4cd0385d: posts small blind 50
3bd708cb: posts big blind 100
*** HOLE CARDS ***
Dealt to 4cd0385d 
Dealt to 3bd708cb 
Dealt to 5b10812e 
Dealt to fdf33aa2 
Dealt to b51ee002 
Dealt to Hero [5s 5d]
Dealt to 82802c28 
Dealt to 22cc398a 
5b10812e: folds
fdf33aa2: raises 100 to 200
b51ee002: folds
Hero: calls 200
82802c28: folds
22cc398a: folds
4cd0385d: folds
3bd708cb: calls 100
*** FLOP *** [3s Ah Th]
3bd708cb: checks
fdf33aa2: bets 255
Hero: folds
3bd708cb: calls 255
*** TURN *** [3s Ah Th] [5h]
3bd708cb: bets 960
fdf33aa2: folds
Uncalled bet (960) returned to 3bd708cb
*** SHOWDOWN ***
3bd708cb collected 1,280 from pot
*** SUMMARY ***
Total pot 1,280 | Rake 0 | Jackpot 0 | Bingo 0 | Fortune 0 | Tax 0
Board [3s Ah Th 5h]
Seat 1: 4cd0385d (small blind) folded before Flop
Seat 2: 3bd708cb (big blind) won (1,280)
Seat 3: 5b10812e folded before Flop
Seat 4: fdf33aa2 folded on the Turn
Seat 5: b51ee002 folded before Flop
Seat 6: Hero folded on the Flop
Seat 7: 82802c28 folded before Flop
Seat 8: 22cc398a (button) folded before Flop


Poker Hand #TM3552048563: Tournament #156543396, Bounty Hunters Special $1.08 Hold'em No Limit - Level1(50/100) - 2024/08/05 09:36:58
Table '55' 8-max Seat #7 is the button
Seat 1: 4cd0385d (7,572 in chips)
Seat 2: 3bd708cb (10,515 in chips)
Seat 3: 5b10812e (11,093 in chips)
Seat 4: fdf33aa2 (9,790 in chips)
Seat 5: b51ee002 (23,270 in chips)
Seat 6: Hero (8,636 in chips)
Seat 7: 82802c28 (9,820 in chips)
Seat 8: 22cc398a (9,922 in chips)
b51ee002: posts the ante 15
fdf33aa2: posts the ante 15
82802c28: posts the ante 15
3bd708cb: posts the ante 15
4cd0385d: posts the ante 15
Hero: posts the ante 15
22cc398a: posts the ante 15
5b10812e: posts the ante 15
22cc398a: posts small blind 50
4cd0385d: posts big blind 100
*** HOLE CARDS ***
Dealt to 4cd0385d 
Dealt to 3bd708cb 
Dealt to 5b10812e 
Dealt to fdf33aa2 
Dealt to b51ee002 
Dealt to Hero [2c 3s]
Dealt to 82802c28 
Dealt to 22cc398a 
3bd708cb: folds
5b10812e: folds
fdf33aa2: folds
b51ee002: folds
Hero: folds
82802c28: raises 100 to 200
22cc398a: folds
4cd0385d: calls 100
*** FLOP *** [7c 5s 9d]
4cd0385d: checks
82802c28: checks
*** TURN *** [7c 5s 9d] [Kd]
4cd0385d: checks
82802c28: checks
*** RIVER *** [7c 5s 9d Kd] [6h]
4cd0385d: bets 143
82802c28: calls 143
4cd0385d: shows [7s Ah] (Pair of Sevens)
82802c28: shows [Ac 9c] (Pair of Nines)
*** SHOWDOWN ***
82802c28 collected 856 from pot
*** SUMMARY ***
Total pot 856 | Rake 0 | Jackpot 0 | Bingo 0 | Fortune 0 | Tax 0
Board [7c 5s 9d Kd 6h]
Seat 1: 4cd0385d (big blind) showed [7s Ah] and lost with Pair of Sevens
Seat 2: 3bd708cb folded before Flop
Seat 3: 5b10812e folded before Flop
Seat 4: fdf33aa2 folded before Flop
Seat 5: b51ee002 folded before Flop
Seat 6: Hero folded before Flop
Seat 7: 82802c28 (button) showed [Ac 9c] and won (856) with Pair of Nines
Seat 8: 22cc398a (small blind) folded before Flop


Poker Hand #TM3552048503: Tournament #156543396, Bounty Hunters Special $1.08 Hold'em No Limit - Level1(50/100) - 2024/08/05 09:35:11
Table '55' 8-max Seat #6 is the button
Seat 1: 4cd0385d (7,587 in chips)
Seat 2: 3bd708cb (10,530 in chips)
Seat 3: 5b10812e (11,108 in chips)
Seat 4: bd4cf64d (9,985 in chips)
Seat 5: b51ee002 (12,358 in chips)
Seat 6: Hero (9,218 in chips)
Seat 7: 82802c28 (9,885 in chips)
Seat 8: 22cc398a (10,157 in chips)
b51ee002: posts the ante 15
bd4cf64d: posts the ante 15
3bd708cb: posts the ante 15
82802c28: posts the ante 15
4cd0385d: posts the ante 15
Hero: posts the ante 15
22cc398a: posts the ante 15
5b10812e: posts the ante 15
82802c28: posts small blind 50
22cc398a: posts big blind 100
*** HOLE CARDS ***
Dealt to 4cd0385d 
Dealt to 3bd708cb 
Dealt to 5b10812e 
Dealt to bd4cf64d 
Dealt to b51ee002 
Dealt to Hero [Th 9s]
Dealt to 82802c28 
Dealt to 22cc398a 
4cd0385d: folds
3bd708cb: folds
5b10812e: folds
bd4cf64d: raises 120 to 220
b51ee002: calls 220
Hero: calls 220
82802c28: folds
22cc398a: calls 120
*** FLOP *** [8s 7d Ad]
22cc398a: checks
bd4cf64d: checks
b51ee002: bets 347
Hero: calls 347
22cc398a: folds
bd4cf64d: calls 347
*** TURN *** [8s 7d Ad] [4s]
bd4cf64d: checks
b51ee002: bets 1,781
Hero: folds
bd4cf64d: raises 1,869 to 3,650
b51ee002: raises 8,126 to 11,776 and is all-in
bd4cf64d: calls 5,753 and is all-in
Uncalled bet (2,373) returned to b51ee002
b51ee002: shows [4h 4d] (Three Fours)
bd4cf64d: shows [5d Ac] (Pair of Aces)
*** RIVER *** [8s 7d Ad 4s] [5h]
*** SHOWDOWN ***
b51ee002 collected 20,897 from pot
*** SUMMARY ***
Total pot 20,897 | Rake 0 | Jackpot 0 | Bingo 0 | Fortune 0 | Tax 0
Board [8s 7d Ad 4s 5h]
Seat 1: 4cd0385d folded before Flop
Seat 2: 3bd708cb folded before Flop
Seat 3: 5b10812e folded before Flop
Seat 4: bd4cf64d showed [5d Ac] and lost with Pair of Aces and Pair of Fives
Seat 5: b51ee002 showed [4h 4d] and won (20,897) with Three Fours
Seat 6: Hero (button) folded on the Turn
Seat 7: 82802c28 (small blind) folded before Flop
Seat 8: 22cc398a (big blind) folded on the Flop


Poker Hand #TM3552048468: Tournament #156543396, Bounty Hunters Special $1.08 Hold'em No Limit - Level1(50/100) - 2024/08/05 09:34:03
Table '55' 8-max Seat #5 is the button
Seat 1: 4cd0385d (9,675 in chips)
Seat 2: 3bd708cb (10,545 in chips)
Seat 3: 5b10812e (11,123 in chips)
Seat 4: bd4cf64d (10,000 in chips)
Seat 5: b51ee002 (10,030 in chips)
Seat 6: Hero (9,283 in chips)
Seat 7: 82802c28 (10,000 in chips)
Seat 8: 22cc398a (10,172 in chips)
b51ee002: posts the ante 15
bd4cf64d: posts the ante 15
3bd708cb: posts the ante 15
82802c28: posts the ante 15
4cd0385d: posts the ante 15
22cc398a: posts the ante 15
Hero: posts the ante 15
5b10812e: posts the ante 15
Hero: posts small blind 50
82802c28: posts big blind 100
*** HOLE CARDS ***
Dealt to 4cd0385d 
Dealt to 3bd708cb 
Dealt to 5b10812e 
Dealt to bd4cf64d 
Dealt to b51ee002 
Dealt to Hero [8d Ac]
Dealt to 82802c28 
Dealt to 22cc398a 
22cc398a: folds
4cd0385d: raises 110 to 210
3bd708cb: folds
5b10812e: folds
bd4cf64d: folds
b51ee002: raises 410 to 620
Hero: folds
82802c28: folds
4cd0385d: calls 410
*** FLOP *** [Ks 3c 8h]
4cd0385d: checks
b51ee002: bets 499
4cd0385d: calls 499
*** TURN *** [Ks 3c 8h] [6s]
4cd0385d: checks
b51ee002: checks
*** RIVER *** [Ks 3c 8h 6s] [3h]
4cd0385d: bets 954
b51ee002: calls 954
4cd0385d: shows [9s 9c] (Pair of Nines and Pair of Treys)
b51ee002: shows [Jc Jd] (Pair of Jacks and Pair of Treys)
*** SHOWDOWN ***
b51ee002 collected 4,416 from pot
*** SUMMARY ***
Total pot 4,416 | Rake 0 | Jackpot 0 | Bingo 0 | Fortune 0 | Tax 0
Board [Ks 3c 8h 6s 3h]
Seat 1: 4cd0385d showed [9s 9c] and lost with Pair of Nines and Pair of Treys
Seat 2: 3bd708cb folded before Flop
Seat 3: 5b10812e folded before Flop
Seat 4: bd4cf64d folded before Flop
Seat 5: b51ee002 (button) showed [Jc Jd] and won (4,416) with Pair of Jacks and Pair of Treys
Seat 6: Hero (small blind) folded before Flop
Seat 7: 82802c28 (big blind) folded before Flop
Seat 8: 22cc398a folded before Flop


Poker Hand #TM3552048443: Tournament #156543396, Bounty Hunters Special $1.08 Hold'em No Limit - Level1(50/100) - 2024/08/05 09:33:19
Table '55' 8-max Seat #3 is the button
Seat 1: 4cd0385d (9,690 in chips)
Seat 2: 3bd708cb (10,560 in chips)
Seat 3: 5b10812e (11,138 in chips)
Seat 5: b51ee002 (10,095 in chips)
Seat 6: Hero (9,740 in chips)
Seat 7: 2b7a75a1 (9,062 in chips)
Seat 8: 22cc398a (9,490 in chips)
b51ee002: posts the ante 15
3bd708cb: posts the ante 15
4cd0385d: posts the ante 15
22cc398a: posts the ante 15
Hero: posts the ante 15
5b10812e: posts the ante 15
2b7a75a1: posts the ante 15
b51ee002: posts small blind 50
Hero: posts big blind 100
*** HOLE CARDS ***
Dealt to 4cd0385d 
Dealt to 3bd708cb 
Dealt to 5b10812e 
Dealt to b51ee002 
Dealt to Hero [Th Ad]
Dealt to 2b7a75a1 
Dealt to 22cc398a 
2b7a75a1: calls 100
22cc398a: raises 342 to 442
4cd0385d: folds
3bd708cb: folds
5b10812e: folds
b51ee002: folds
Hero: calls 342
2b7a75a1: folds
*** FLOP *** [4d 8d Kd]
Hero: checks
22cc398a: checks
*** TURN *** [4d 8d Kd] [8s]
Hero: checks
22cc398a: bets 570
Hero: folds
Uncalled bet (570) returned to 22cc398a
*** SHOWDOWN ***
22cc398a collected 1,139 from pot
*** SUMMARY ***
Total pot 1,139 | Rake 0 | Jackpot 0 | Bingo 0 | Fortune 0 | Tax 0
Board [4d 8d Kd 8s]
Seat 1: 4cd0385d folded before Flop
Seat 2: 3bd708cb folded before Flop
Seat 3: 5b10812e (button) folded before Flop
Seat 5: b51ee002 (small blind) folded before Flop
Seat 6: Hero (big blind) folded on the Turn
Seat 7: 2b7a75a1 folded before Flop
Seat 8: 22cc398a won (1,139)


Poker Hand #TM3552048424: Tournament #156543396, Bounty Hunters Special $1.08 Hold'em No Limit - Level1(50/100) - 2024/08/05 09:32:45
Table '55' 8-max Seat #2 is the button
Seat 1: 4cd0385d (9,705 in chips)
Seat 2: 3bd708cb (10,575 in chips)
Seat 3: 5b10812e (11,203 in chips)
Seat 5: b51ee002 (9,755 in chips)
Seat 6: Hero (9,755 in chips)
Seat 7: 2b7a75a1 (9,077 in chips)
Seat 8: 22cc398a (9,705 in chips)
b51ee002: posts the ante 15
3bd708cb: posts the ante 15
4cd0385d: posts the ante 15
22cc398a: posts the ante 15
Hero: posts the ante 15
2b7a75a1: posts the ante 15
5b10812e: posts the ante 15
5b10812e: posts small blind 50
b51ee002: posts big blind 100
*** HOLE CARDS ***
Dealt to 4cd0385d 
Dealt to 3bd708cb 
Dealt to 5b10812e 
Dealt to b51ee002 
Dealt to Hero [5s Kd]
Dealt to 2b7a75a1 
Dealt to 22cc398a 
Hero: folds
2b7a75a1: folds
22cc398a: raises 100 to 200
4cd0385d: folds
3bd708cb: folds
5b10812e: folds
b51ee002: raises 600 to 800
22cc398a: folds
Uncalled bet (600) returned to b51ee002
*** SHOWDOWN ***
b51ee002 collected 555 from pot
*** SUMMARY ***
Total pot 555 | Rake 0 | Jackpot 0 | Bingo 0 | Fortune 0 | Tax 0
Seat 1: 4cd0385d folded before Flop
Seat 2: 3bd708cb (button) folded before Flop
Seat 3: 5b10812e (small blind) folded before Flop
Seat 5: b51ee002 (big blind) collected (555)
Seat 6: Hero folded before Flop
Seat 7: 2b7a75a1 folded before Flop
Seat 8: 22cc398a folded before Flop


Poker Hand #TM3552048393: Tournament #156543396, Bounty Hunters Special $1.08 Hold'em No Limit - Level1(50/100) - 2024/08/05 09:31:57
Table '55' 8-max Seat #1 is the button
Seat 1: 4cd0385d (9,720 in chips)
Seat 2: 3bd708cb (10,640 in chips)
Seat 3: 5b10812e (9,970 in chips)
Seat 4: 2c17b1b8 (10,240 in chips)
Seat 5: b51ee002 (9,770 in chips)
Seat 6: Hero (9,770 in chips)
Seat 7: 2b7a75a1 (9,970 in chips)
Seat 8: 22cc398a (9,920 in chips)
b51ee002: posts the ante 15
2c17b1b8: posts the ante 15
3bd708cb: posts the ante 15
4cd0385d: posts the ante 15
22cc398a: posts the ante 15
Hero: posts the ante 15
2b7a75a1: posts the ante 15
5b10812e: posts the ante 15
3bd708cb: posts small blind 50
5b10812e: posts big blind 100
*** HOLE CARDS ***
Dealt to 4cd0385d 
Dealt to 3bd708cb 
Dealt to 5b10812e 
Dealt to 2c17b1b8 
Dealt to b51ee002 
Dealt to Hero [5c Jd]
Dealt to 2b7a75a1 
Dealt to 22cc398a 
2c17b1b8: folds
b51ee002: folds
Hero: folds
2b7a75a1: raises 100 to 200
22cc398a: calls 200
4cd0385d: folds
3bd708cb: folds
5b10812e: calls 100
*** FLOP *** [Kh 4c 3c]
5b10812e: checks
2b7a75a1: checks
22cc398a: checks
*** TURN *** [Kh 4c 3c] [9s]
5b10812e: bets 255
2b7a75a1: calls 255
22cc398a: folds
*** RIVER *** [Kh 4c 3c 9s] [7d]
5b10812e: bets 423
2b7a75a1: calls 423
5b10812e: shows [Kd 6s] (Pair of Kings)
2b7a75a1: shows [9h Ac] (Pair of Nines)
*** SHOWDOWN ***
5b10812e collected 2,126 from pot
*** SUMMARY ***
Total pot 2,126 | Rake 0 | Jackpot 0 | Bingo 0 | Fortune 0 | Tax 0
Board [Kh 4c 3c 9s 7d]
Seat 1: 4cd0385d (button) folded before Flop
Seat 2: 3bd708cb (small blind) folded before Flop
Seat 3: 5b10812e (big blind) showed [Kd 6s] and won (2,126) with Pair of Kings
Seat 4: 2c17b1b8 folded before Flop
Seat 5: b51ee002 folded before Flop
Seat 6: Hero folded before Flop
Seat 7: 2b7a75a1 showed [9h Ac] and lost with Pair of Nines
Seat 8: 22cc398a folded on the Turn


Poker Hand #TM3552048366: Tournament #156543396, Bounty Hunters Special $1.08 Hold'em No Limit - Level1(50/100) - 2024/08/05 09:31:15
Table '55' 8-max Seat #8 is the button
Seat 1: 4cd0385d (9,785 in chips)
Seat 2: 3bd708cb (10,755 in chips)
Seat 3: 5b10812e (9,985 in chips)
Seat 4: 2c17b1b8 (9,985 in chips)
Seat 5: b51ee002 (9,785 in chips)
Seat 6: Hero (9,785 in chips)
Seat 7: 2b7a75a1 (9,985 in chips)
Seat 8: 22cc398a (9,935 in chips)
b51ee002: posts the ante 15
2c17b1b8: posts the ante 15
3bd708cb: posts the ante 15
4cd0385d: posts the ante 15
22cc398a: posts the ante 15
Hero: posts the ante 15
2b7a75a1: posts the ante 15
5b10812e: posts the ante 15
4cd0385d: posts small blind 50
3bd708cb: posts big blind 100
*** HOLE CARDS ***
Dealt to 4cd0385d 
Dealt to 3bd708cb 
Dealt to 5b10812e 
Dealt to 2c17b1b8 
Dealt to b51ee002 
Dealt to Hero [Jc 7s]
Dealt to 2b7a75a1 
Dealt to 22cc398a 
5b10812e: folds
2c17b1b8: raises 370 to 470
b51ee002: folds
Hero: folds
2b7a75a1: folds
22cc398a: folds
4cd0385d: folds
3bd708cb: folds
Uncalled bet (370) returned to 2c17b1b8
*** SHOWDOWN ***
2c17b1b8 collected 370 from pot
*** SUMMARY ***
Total pot 370 | Rake 0 | Jackpot 0 | Bingo 0 | Fortune 0 | Tax 0
Seat 1: 4cd0385d (small blind) folded before Flop
Seat 2: 3bd708cb (big blind) folded before Flop
Seat 3: 5b10812e folded before Flop
Seat 4: 2c17b1b8 collected (370)
Seat 5: b51ee002 folded before Flop
Seat 6: Hero folded before Flop
Seat 7: 2b7a75a1 folded before Flop
Seat 8: 22cc398a (button) folded before Flop


Poker Hand #TM3552048331: Tournament #156543396, Bounty Hunters Special $1.08 Hold'em No Limit - Level1(50/100) - 2024/08/05 09:30:02
Table '55' 8-max Seat #7 is the button
Seat 1: 4cd0385d (10,000 in chips)
Seat 2: 3bd708cb (10,000 in chips)
Seat 3: 5b10812e (10,000 in chips)
Seat 4: 2c17b1b8 (10,000 in chips)
Seat 5: b51ee002 (10,000 in chips)
Seat 6: Hero (10,000 in chips)
Seat 7: 2b7a75a1 (10,000 in chips)
Seat 8: 22cc398a (10,000 in chips)
b51ee002: posts the ante 15
2c17b1b8: posts the ante 15
3bd708cb: posts the ante 15
4cd0385d: posts the ante 15
Hero: posts the ante 15
22cc398a: posts the ante 15
2b7a75a1: posts the ante 15
5b10812e: posts the ante 15
22cc398a: posts small blind 50
4cd0385d: posts big blind 100
*** HOLE CARDS ***
Dealt to 4cd0385d 
Dealt to 3bd708cb 
Dealt to 5b10812e 
Dealt to 2c17b1b8 
Dealt to b51ee002 
Dealt to Hero [Ac 5d]
Dealt to 2b7a75a1 
Dealt to 22cc398a 
3bd708cb: raises 100 to 200
5b10812e: folds
2c17b1b8: folds
b51ee002: calls 200
Hero: calls 200
2b7a75a1: folds
22cc398a: folds
4cd0385d: calls 100
*** FLOP *** [Th 6d 3c]
4cd0385d: checks
3bd708cb: checks
b51ee002: checks
Hero: checks
*** TURN *** [Th 6d 3c] [Kh]
4cd0385d: checks
3bd708cb: bets 485
b51ee002: folds
Hero: folds
4cd0385d: folds
Uncalled bet (485) returned to 3bd708cb
*** SHOWDOWN ***
3bd708cb collected 970 from pot
*** SUMMARY ***
Total pot 970 | Rake 0 | Jackpot 0 | Bingo 0 | Fortune 0 | Tax 0
Board [Th 6d 3c Kh]
Seat 1: 4cd0385d (big blind) folded on the Turn
Seat 2: 3bd708cb won (970)
Seat 3: 5b10812e folded before Flop
Seat 4: 2c17b1b8 folded before Flop
Seat 5: b51ee002 folded on the Turn
Seat 6: Hero folded on the Turn
Seat 7: 2b7a75a1 (button) folded before Flop
Seat 8: 22cc398a (small blind) folded before Flop


