Poker Hand #TM81875695: Tournament #160064971, Short Deck Bounty Hyper $1.08 ShortDeck No Limit - Level7(100) - 2024/08/26 16:30:35
Table '23' 6-max Seat #5 is the button
Seat 1: 6faf64f7 (10,160 in chips)
Seat 2: f1cbf154 (7,707 in chips)
Seat 4: dd10aab5 (31,481 in chips)
Seat 5: b1e9b996 (43,151 in chips)
Seat 6: Hero (8,392 in chips)
b1e9b996: posts the ante 100
dd10aab5: posts the ante 100
6faf64f7: posts the ante 100
f1cbf154: posts the ante 100
Hero: posts the ante 100
b1e9b996: posts button blind 100
*** HOLE CARDS ***
Dealt to 6faf64f7 
Dealt to f1cbf154 
Dealt to dd10aab5 
Dealt to b1e9b996 
Dealt to Hero [Ts 7s]
Hero: raises 100 to 200
6faf64f7: calls 200
f1cbf154: calls 200
dd10aab5: calls 200
b1e9b996: calls 100
*** FLOP *** [Td Tc Ah]
Hero: bets 1,125
6faf64f7: raises 8,735 to 9,860 and is all-in
f1cbf154: folds
dd10aab5: folds
b1e9b996: folds
Hero: calls 6,967 and is all-in
Uncalled bet (1,768) returned to 6faf64f7
6faf64f7: shows [Kh Th] (Three Tens)
Hero: shows [Ts 7s] (Three Tens)
*** TURN *** [Td Tc Ah] [Js]
*** RIVER *** [Td Tc Ah Js] [9d]
*** SHOWDOWN ***
6faf64f7 collected 17,684 from pot
*** SUMMARY ***
Total pot 17,684 | Rake 0 | Jackpot 0 | Bingo 0 | Fortune 0 | Tax 0
Board [Td Tc Ah Js 9d]
Seat 1: 6faf64f7 showed [Kh Th] and won (17,684) with Three Tens
Seat 2: f1cbf154 folded on the Flop
Seat 4: dd10aab5 folded on the Flop
Seat 5: b1e9b996 (button) folded on the Flop
Seat 6: Hero showed [Ts 7s] and lost with Three Tens


Poker Hand #TM81875694: Tournament #160064971, Short Deck Bounty Hyper $1.08 ShortDeck No Limit - Level7(100) - 2024/08/26 16:29:54
Table '23' 6-max Seat #4 is the button
Seat 1: 6faf64f7 (10,260 in chips)
Seat 2: f1cbf154 (8,557 in chips)
Seat 4: dd10aab5 (31,781 in chips)
Seat 5: b1e9b996 (43,251 in chips)
Seat 6: Hero (7,042 in chips)
b1e9b996: posts the ante 100
dd10aab5: posts the ante 100
6faf64f7: posts the ante 100
f1cbf154: posts the ante 100
Hero: posts the ante 100
dd10aab5: posts button blind 100
*** HOLE CARDS ***
Dealt to 6faf64f7 
Dealt to f1cbf154 
Dealt to dd10aab5 
Dealt to b1e9b996 
Dealt to Hero [Ks Js]
b1e9b996: folds
Hero: raises 100 to 200
6faf64f7: folds
f1cbf154: calls 200
dd10aab5: calls 100
*** FLOP *** [Kh Qd 8d]
Hero: bets 550
f1cbf154: calls 550
dd10aab5: folds
*** TURN *** [Kh Qd 8d] [9s]
Hero: checks
f1cbf154: checks
*** RIVER *** [Kh Qd 8d 9s] [Jd]
Hero: checks
f1cbf154: checks
Hero: shows [Ks Js] (Pair of Kings and Pair of Jacks)
f1cbf154: shows [7h 8h] (Pair of Eights)
*** SHOWDOWN ***
Hero collected 2,200 from pot
*** SUMMARY ***
Total pot 2,200 | Rake 0 | Jackpot 0 | Bingo 0 | Fortune 0 | Tax 0
Board [Kh Qd 8d 9s Jd]
Seat 1: 6faf64f7 folded before Flop
Seat 2: f1cbf154 showed [7h 8h] and lost with Pair of Eights
Seat 4: dd10aab5 (button) folded on the Flop
Seat 5: b1e9b996 folded before Flop
Seat 6: Hero showed [Ks Js] and won (2,200) with Pair of Kings and Pair of Jacks


Poker Hand #TM81875691: Tournament #160064971, Short Deck Bounty Hyper $1.08 ShortDeck No Limit - Level7(100) - 2024/08/26 16:28:07
Table '23' 6-max Seat #2 is the button
Seat 1: 6faf64f7 (10,360 in chips)
Seat 2: f1cbf154 (9,820 in chips)
Seat 3: 65dfa024 (10,000 in chips)
Seat 4: dd10aab5 (33,044 in chips)
Seat 5: b1e9b996 (29,362 in chips)
Seat 6: Hero (8,305 in chips)
65dfa024: posts the ante 100
b1e9b996: posts the ante 100
dd10aab5: posts the ante 100
6faf64f7: posts the ante 100
f1cbf154: posts the ante 100
Hero: posts the ante 100
f1cbf154: posts button blind 100
*** HOLE CARDS ***
Dealt to 6faf64f7 
Dealt to f1cbf154 
Dealt to 65dfa024 
Dealt to dd10aab5 
Dealt to b1e9b996 
Dealt to Hero [7c 6s]
65dfa024: raises 264 to 364
dd10aab5: calls 364
b1e9b996: calls 364
Hero: calls 364
6faf64f7: folds
f1cbf154: calls 264
*** FLOP *** [Th 9c Qc]
65dfa024: checks
dd10aab5: bets 799
b1e9b996: calls 799
Hero: calls 799
f1cbf154: calls 799
65dfa024: calls 799
*** TURN *** [Th 9c Qc] [6c]
65dfa024: checks
dd10aab5: checks
b1e9b996: checks
Hero: checks
f1cbf154: checks
*** RIVER *** [Th 9c Qc 6c] [6h]
65dfa024: checks
dd10aab5: checks
b1e9b996: bets 2,117
Hero: folds
f1cbf154: folds
65dfa024: raises 6,620 to 8,737 and is all-in
dd10aab5: folds
b1e9b996: calls 6,620
65dfa024: shows [Ac Kd] (Pair of Sixes)
b1e9b996: shows [9d 9h] (Nines Full over Sixes)
*** SHOWDOWN ***
b1e9b996 collected 23,889 from pot
*** SUMMARY ***
Total pot 23,889 | Rake 0 | Jackpot 0 | Bingo 0 | Fortune 0 | Tax 0
Board [Th 9c Qc 6c 6h]
Seat 1: 6faf64f7 folded before Flop
Seat 2: f1cbf154 (button) folded on the River
Seat 3: 65dfa024 showed [Ac Kd] and lost with Pair of Sixes
Seat 4: dd10aab5 folded on the River
Seat 5: b1e9b996 showed [9d 9h] and won (23,889) with Nines Full over Sixes
Seat 6: Hero folded on the River


Poker Hand #TM81875689: Tournament #160064971, Short Deck Bounty Hyper $1.08 ShortDeck No Limit - Level6(90) - 2024/08/26 16:27:45
Table '23' 6-max Seat #1 is the button
Seat 1: 6faf64f7 (10,000 in chips)
Seat 2: f1cbf154 (10,000 in chips)
Seat 6: Hero (8,485 in chips)
6faf64f7: posts the ante 90
f1cbf154: posts the ante 90
Hero: posts the ante 90
6faf64f7: posts button blind 90
*** HOLE CARDS ***
Dealt to 6faf64f7 
Dealt to f1cbf154 
Dealt to Hero [7h 9h]
f1cbf154: calls 90
Hero: calls 90
6faf64f7: raises 9,820 to 9,910 and is all-in
f1cbf154: folds
Hero: folds
Uncalled bet (9,820) returned to 6faf64f7
*** SHOWDOWN ***
6faf64f7 collected 540 from pot
*** SUMMARY ***
Total pot 540 | Rake 0 | Jackpot 0 | Bingo 0 | Fortune 0 | Tax 0
Seat 1: 6faf64f7 (button) collected (540)
Seat 2: f1cbf154 folded before Flop
Seat 6: Hero folded before Flop


Poker Hand #TM81957205: Tournament #160064971, Short Deck Bounty Hyper $1.08 ShortDeck No Limit - Level6(90) - 2024/08/26 16:26:59
Table '1' 6-max Seat #6 is the button
Seat 1: 38ee39eb (17,464 in chips)
Seat 2: e0d1c3eb (7,781 in chips)
Seat 3: 3e34b227 (11,297 in chips)
Seat 4: Hero (8,665 in chips)
Seat 5: 51fb90e0 (28,467 in chips)
Seat 6: c24e0f6 (17,647 in chips)
51fb90e0: posts the ante 90
c24e0f6: posts the ante 90
3e34b227: posts the ante 90
38ee39eb: posts the ante 90
Hero: posts the ante 90
e0d1c3eb: posts the ante 90
c24e0f6: posts button blind 90
*** HOLE CARDS ***
Dealt to 38ee39eb 
Dealt to e0d1c3eb 
Dealt to 3e34b227 
Dealt to Hero [9h 6s]
Dealt to 51fb90e0 
Dealt to c24e0f6 
38ee39eb: folds
e0d1c3eb: folds
3e34b227: calls 90
Hero: calls 90
51fb90e0: folds
c24e0f6: checks
*** FLOP *** [Kc Th Ts]
3e34b227: checks
Hero: checks
c24e0f6: bets 543
3e34b227: calls 543
Hero: folds
*** TURN *** [Kc Th Ts] [9s]
3e34b227: checks
c24e0f6: bets 948
3e34b227: raises 1,896 to 2,844
c24e0f6: folds
Uncalled bet (1,896) returned to 3e34b227
*** SHOWDOWN ***
3e34b227 collected 3,792 from pot
*** SUMMARY ***
Total pot 3,792 | Rake 0 | Jackpot 0 | Bingo 0 | Fortune 0 | Tax 0
Board [Kc Th Ts 9s]
Seat 1: 38ee39eb folded before Flop
Seat 2: e0d1c3eb folded before Flop
Seat 3: 3e34b227 won (3,792)
Seat 4: Hero folded on the Flop
Seat 5: 51fb90e0 folded before Flop
Seat 6: c24e0f6 (button) folded on the Turn


Poker Hand #TM81957204: Tournament #160064971, Short Deck Bounty Hyper $1.08 ShortDeck No Limit - Level6(90) - 2024/08/26 16:25:31
Table '1' 6-max Seat #5 is the button
Seat 1: 38ee39eb (17,554 in chips)
Seat 2: e0d1c3eb (7,871 in chips)
Seat 3: 3e34b227 (13,277 in chips)
Seat 4: Hero (9,295 in chips)
Seat 5: 51fb90e0 (30,447 in chips)
Seat 6: c24e0f6 (12,877 in chips)
51fb90e0: posts the ante 90
c24e0f6: posts the ante 90
3e34b227: posts the ante 90
38ee39eb: posts the ante 90
Hero: posts the ante 90
e0d1c3eb: posts the ante 90
51fb90e0: posts button blind 90
*** HOLE CARDS ***
Dealt to 38ee39eb 
Dealt to e0d1c3eb 
Dealt to 3e34b227 
Dealt to Hero [Ts Qs]
Dealt to 51fb90e0 
Dealt to c24e0f6 
c24e0f6: calls 90
38ee39eb: folds
e0d1c3eb: folds
3e34b227: calls 90
Hero: calls 90
51fb90e0: checks
*** FLOP *** [Jh Th 6s]
c24e0f6: checks
3e34b227: bets 450
Hero: calls 450
51fb90e0: calls 450
c24e0f6: calls 450
*** TURN *** [Jh Th 6s] [7c]
c24e0f6: checks
3e34b227: bets 1,350
Hero: folds
51fb90e0: calls 1,350
c24e0f6: calls 1,350
*** RIVER *** [Jh Th 6s 7c] [7s]
c24e0f6: bets 3,375
3e34b227: folds
51fb90e0: folds
Uncalled bet (3,375) returned to c24e0f6
*** SHOWDOWN ***
c24e0f6 collected 6,750 from pot
*** SUMMARY ***
Total pot 6,750 | Rake 0 | Jackpot 0 | Bingo 0 | Fortune 0 | Tax 0
Board [Jh Th 6s 7c 7s]
Seat 1: 38ee39eb folded before Flop
Seat 2: e0d1c3eb folded before Flop
Seat 3: 3e34b227 folded on the River
Seat 4: Hero folded on the Turn
Seat 5: 51fb90e0 (button) folded on the River
Seat 6: c24e0f6 won (6,750)


Poker Hand #TM81957203: Tournament #160064971, Short Deck Bounty Hyper $1.08 ShortDeck No Limit - Level5(80) - 2024/08/26 16:24:23
Table '1' 6-max Seat #4 is the button
Seat 1: 38ee39eb (18,314 in chips)
Seat 2: e0d1c3eb (8,631 in chips)
Seat 3: 3e34b227 (10,077 in chips)
Seat 4: Hero (10,055 in chips)
Seat 5: 51fb90e0 (30,607 in chips)
Seat 6: c24e0f6 (13,637 in chips)
51fb90e0: posts the ante 80
c24e0f6: posts the ante 80
3e34b227: posts the ante 80
38ee39eb: posts the ante 80
Hero: posts the ante 80
e0d1c3eb: posts the ante 80
Hero: posts button blind 80
*** HOLE CARDS ***
Dealt to 38ee39eb 
Dealt to e0d1c3eb 
Dealt to 3e34b227 
Dealt to Hero [8s Ah]
Dealt to 51fb90e0 
Dealt to c24e0f6 
51fb90e0: calls 80
c24e0f6: calls 80
38ee39eb: raises 600 to 680
e0d1c3eb: calls 680
3e34b227: calls 680
Hero: calls 600
51fb90e0: folds
c24e0f6: calls 600
*** FLOP *** [9s 6h 8d]
c24e0f6: checks
38ee39eb: checks
e0d1c3eb: checks
3e34b227: bets 1,980
Hero: folds
c24e0f6: folds
38ee39eb: folds
e0d1c3eb: folds
Uncalled bet (1,980) returned to 3e34b227
*** SHOWDOWN ***
3e34b227 collected 3,960 from pot
*** SUMMARY ***
Total pot 3,960 | Rake 0 | Jackpot 0 | Bingo 0 | Fortune 0 | Tax 0
Board [9s 6h 8d]
Seat 1: 38ee39eb folded on the Flop
Seat 2: e0d1c3eb folded on the Flop
Seat 3: 3e34b227 won (3,960)
Seat 4: Hero (button) folded on the Flop
Seat 5: 51fb90e0 folded before Flop
Seat 6: c24e0f6 folded on the Flop


Poker Hand #TM81957202: Tournament #160064971, Short Deck Bounty Hyper $1.08 ShortDeck No Limit - Level5(80) - 2024/08/26 16:23:21
Table '1' 6-max Seat #3 is the button
Seat 1: 38ee39eb (19,428 in chips)
Seat 2: e0d1c3eb (8,711 in chips)
Seat 3: 3e34b227 (13,360 in chips)
Seat 4: Hero (10,135 in chips)
Seat 5: 51fb90e0 (25,970 in chips)
Seat 6: c24e0f6 (13,717 in chips)
51fb90e0: posts the ante 80
c24e0f6: posts the ante 80
3e34b227: posts the ante 80
38ee39eb: posts the ante 80
Hero: posts the ante 80
e0d1c3eb: posts the ante 80
3e34b227: posts button blind 80
*** HOLE CARDS ***
Dealt to 38ee39eb 
Dealt to e0d1c3eb 
Dealt to 3e34b227 
Dealt to Hero [Qs 6h]
Dealt to 51fb90e0 
Dealt to c24e0f6 
Hero: folds
51fb90e0: calls 80
c24e0f6: folds
38ee39eb: raises 360 to 440
e0d1c3eb: folds
3e34b227: calls 360
51fb90e0: calls 360
*** FLOP *** [Qc 7h Js]
51fb90e0: checks
38ee39eb: bets 594
3e34b227: calls 594
51fb90e0: raises 594 to 1,188
38ee39eb: folds
3e34b227: calls 594
*** TURN *** [Qc 7h Js] [9c]
51fb90e0: bets 1,575
3e34b227: calls 1,575
*** RIVER *** [Qc 7h Js 9c] [7s]
51fb90e0: checks
3e34b227: checks
51fb90e0: shows [Qd As] (Pair of Queens and Pair of Sevens)
3e34b227: shows [Ts 9s] (Pair of Nines and Pair of Sevens)
*** SHOWDOWN ***
51fb90e0 collected 7,920 from pot
*** SUMMARY ***
Total pot 7,920 | Rake 0 | Jackpot 0 | Bingo 0 | Fortune 0 | Tax 0
Board [Qc 7h Js 9c 7s]
Seat 1: 38ee39eb folded on the Flop
Seat 2: e0d1c3eb folded before Flop
Seat 3: 3e34b227 (button) showed [Ts 9s] and lost with Pair of Nines and Pair of Sevens
Seat 4: Hero folded before Flop
Seat 5: 51fb90e0 showed [Qd As] and won (7,920) with Pair of Queens and Pair of Sevens
Seat 6: c24e0f6 folded before Flop


Poker Hand #TM81957201: Tournament #160064971, Short Deck Bounty Hyper $1.08 ShortDeck No Limit - Level5(80) - 2024/08/26 16:22:31
Table '1' 6-max Seat #2 is the button
Seat 1: 38ee39eb (20,028 in chips)
Seat 2: e0d1c3eb (9,311 in chips)
Seat 3: 3e34b227 (10,000 in chips)
Seat 4: Hero (12,055 in chips)
Seat 5: 51fb90e0 (26,050 in chips)
Seat 6: c24e0f6 (13,877 in chips)
51fb90e0: posts the ante 80
c24e0f6: posts the ante 80
38ee39eb: posts the ante 80
3e34b227: posts the ante 80
Hero: posts the ante 80
e0d1c3eb: posts the ante 80
e0d1c3eb: posts button blind 80
*** HOLE CARDS ***
Dealt to 38ee39eb 
Dealt to e0d1c3eb 
Dealt to 3e34b227 
Dealt to Hero [Qs Ts]
Dealt to 51fb90e0 
Dealt to c24e0f6 
3e34b227: calls 80
Hero: calls 80
51fb90e0: folds
c24e0f6: calls 80
38ee39eb: raises 440 to 520
e0d1c3eb: calls 440
3e34b227: calls 440
Hero: calls 440
c24e0f6: folds
*** FLOP *** [8c 9d Qh]
3e34b227: bets 1,320
Hero: calls 1,320
38ee39eb: folds
e0d1c3eb: folds
*** TURN *** [8c 9d Qh] [Ah]
3e34b227: bets 1,743
Hero: folds
Uncalled bet (1,743) returned to 3e34b227
*** SHOWDOWN ***
3e34b227 collected 5,280 from pot
*** SUMMARY ***
Total pot 5,280 | Rake 0 | Jackpot 0 | Bingo 0 | Fortune 0 | Tax 0
Board [8c 9d Qh Ah]
Seat 1: 38ee39eb folded on the Flop
Seat 2: e0d1c3eb (button) folded on the Flop
Seat 3: 3e34b227 won (5,280)
Seat 4: Hero folded on the Turn
Seat 5: 51fb90e0 folded before Flop
Seat 6: c24e0f6 folded before Flop


Poker Hand #TM81957200: Tournament #160064971, Short Deck Bounty Hyper $1.08 ShortDeck No Limit - Level4(70) - 2024/08/26 16:21:41
Table '1' 6-max Seat #1 is the button
Seat 1: 38ee39eb (17,858 in chips)
Seat 2: e0d1c3eb (9,381 in chips)
Seat 4: Hero (14,085 in chips)
Seat 5: 51fb90e0 (26,120 in chips)
51fb90e0: posts the ante 70
38ee39eb: posts the ante 70
Hero: posts the ante 70
e0d1c3eb: posts the ante 70
38ee39eb: posts button blind 70
*** HOLE CARDS ***
Dealt to 38ee39eb 
Dealt to e0d1c3eb 
Dealt to Hero [7s 9c]
Dealt to 51fb90e0 
e0d1c3eb: folds
Hero: raises 70 to 140
51fb90e0: folds
38ee39eb: calls 70
*** FLOP *** [Qh 9s 7d]
Hero: bets 420
38ee39eb: calls 420
*** TURN *** [Qh 9s 7d] [Jh]
Hero: bets 1,400
38ee39eb: calls 1,400
*** RIVER *** [Qh 9s 7d Jh] [Td]
Hero: checks
38ee39eb: bets 2,100
Hero: folds
Uncalled bet (2,100) returned to 38ee39eb
*** SHOWDOWN ***
38ee39eb collected 4,200 from pot
*** SUMMARY ***
Total pot 4,200 | Rake 0 | Jackpot 0 | Bingo 0 | Fortune 0 | Tax 0
Board [Qh 9s 7d Jh Td]
Seat 1: 38ee39eb (button) won (4,200)
Seat 2: e0d1c3eb folded before Flop
Seat 4: Hero folded on the River
Seat 5: 51fb90e0 folded before Flop


Poker Hand #TM81957199: Tournament #160064971, Short Deck Bounty Hyper $1.08 ShortDeck No Limit - Level4(70) - 2024/08/26 16:20:35
Table '1' 6-max Seat #5 is the button
Seat 1: 38ee39eb (17,928 in chips)
Seat 2: e0d1c3eb (9,451 in chips)
Seat 4: Hero (14,470 in chips)
Seat 5: 51fb90e0 (18,011 in chips)
Seat 6: 97d6f37d (7,584 in chips)
97d6f37d: posts the ante 70
51fb90e0: posts the ante 70
38ee39eb: posts the ante 70
Hero: posts the ante 70
e0d1c3eb: posts the ante 70
51fb90e0: posts button blind 70
*** HOLE CARDS ***
Dealt to 38ee39eb 
Dealt to e0d1c3eb 
Dealt to Hero [Ks As]
Dealt to 51fb90e0 
Dealt to 97d6f37d 
97d6f37d: raises 245 to 315
38ee39eb: folds
e0d1c3eb: folds
Hero: calls 315
51fb90e0: calls 245
*** FLOP *** [9d Qd Qh]
97d6f37d: bets 428
Hero: folds
51fb90e0: calls 428
*** TURN *** [9d Qd Qh] [Jh]
97d6f37d: bets 710
51fb90e0: raises 8,950 to 9,660
97d6f37d: calls 6,061 and is all-in
Uncalled bet (2,889) returned to 51fb90e0
51fb90e0: shows [Jd Jc] (Jacks Full over Queens)
97d6f37d: shows [9s Kc] (Pair of Queens and Pair of Nines)
*** RIVER *** [9d Qd Qh Jh] [Qs]
*** SHOWDOWN ***
51fb90e0 collected 15,693 from pot
*** SUMMARY ***
Total pot 15,693 | Rake 0 | Jackpot 0 | Bingo 0 | Fortune 0 | Tax 0
Board [9d Qd Qh Jh Qs]
Seat 1: 38ee39eb folded before Flop
Seat 2: e0d1c3eb folded before Flop
Seat 4: Hero folded on the Flop
Seat 5: 51fb90e0 (button) showed [Jd Jc] and won (15,693) with Queens Full over Jacks
Seat 6: 97d6f37d showed [9s Kc] and lost with Queens Full over Nines


Poker Hand #TM81957198: Tournament #160064971, Short Deck Bounty Hyper $1.08 ShortDeck No Limit - Level4(70) - 2024/08/26 16:19:19
Table '1' 6-max Seat #4 is the button
Seat 1: 38ee39eb (17,998 in chips)
Seat 2: e0d1c3eb (9,521 in chips)
Seat 3: 3cc9b800 (23,674 in chips)
Seat 4: Hero (12,009 in chips)
Seat 5: 51fb90e0 (18,624 in chips)
Seat 6: 97d6f37d (7,654 in chips)
97d6f37d: posts the ante 70
51fb90e0: posts the ante 70
3cc9b800: posts the ante 70
38ee39eb: posts the ante 70
Hero: posts the ante 70
e0d1c3eb: posts the ante 70
Hero: posts button blind 70
*** HOLE CARDS ***
Dealt to 38ee39eb 
Dealt to e0d1c3eb 
Dealt to 3cc9b800 
Dealt to Hero [Qd 6d]
Dealt to 51fb90e0 
Dealt to 97d6f37d 
51fb90e0: calls 70
97d6f37d: folds
38ee39eb: folds
e0d1c3eb: folds
3cc9b800: calls 70
Hero: checks
*** FLOP *** [Jd Kc 8d]
51fb90e0: checks
3cc9b800: bets 473
Hero: calls 473
51fb90e0: calls 473
*** TURN *** [Jd Kc 8d] [Ac]
51fb90e0: checks
3cc9b800: checks
Hero: checks
*** RIVER *** [Jd Kc 8d Ac] [Ad]
51fb90e0: checks
3cc9b800: checks
Hero: bets 1,025
51fb90e0: folds
3cc9b800: calls 1,025
Hero: shows [Qd 6d] (Ace High Flush)
3cc9b800: shows [9s Kd] (Pair of Aces and Pair of Kings)
*** SHOWDOWN ***
Hero collected 4,099 from pot
*** SUMMARY ***
Total pot 4,099 | Rake 0 | Jackpot 0 | Bingo 0 | Fortune 0 | Tax 0
Board [Jd Kc 8d Ac Ad]
Seat 1: 38ee39eb folded before Flop
Seat 2: e0d1c3eb folded before Flop
Seat 3: 3cc9b800 showed [9s Kd] and lost with Pair of Aces and Pair of Kings
Seat 4: Hero (button) showed [Qd 6d] and won (4,099) with Ace High Flush
Seat 5: 51fb90e0 folded on the River
Seat 6: 97d6f37d folded before Flop


Poker Hand #TM81957197: Tournament #160064971, Short Deck Bounty Hyper $1.08 ShortDeck No Limit - Level3(60) - 2024/08/26 16:18:10
Table '1' 6-max Seat #3 is the button
Seat 1: 38ee39eb (27,807 in chips)
Seat 2: e0d1c3eb (9,581 in chips)
Seat 3: 3cc9b800 (9,809 in chips)
Seat 4: Hero (12,864 in chips)
Seat 5: 51fb90e0 (19,479 in chips)
Seat 6: 97d6f37d (9,940 in chips)
97d6f37d: posts the ante 60
51fb90e0: posts the ante 60
3cc9b800: posts the ante 60
38ee39eb: posts the ante 60
Hero: posts the ante 60
e0d1c3eb: posts the ante 60
3cc9b800: posts button blind 60
*** HOLE CARDS ***
Dealt to 38ee39eb 
Dealt to e0d1c3eb 
Dealt to 3cc9b800 
Dealt to Hero [Jh 8h]
Dealt to 51fb90e0 
Dealt to 97d6f37d 
Hero: raises 60 to 120
51fb90e0: calls 120
97d6f37d: calls 120
38ee39eb: raises 675 to 795
e0d1c3eb: folds
3cc9b800: calls 735
Hero: calls 675
51fb90e0: calls 675
97d6f37d: calls 675
*** FLOP *** [7s Qs Kc]
Hero: checks
51fb90e0: checks
97d6f37d: checks
38ee39eb: checks
3cc9b800: checks
*** TURN *** [7s Qs Kc] [Ks]
Hero: checks
51fb90e0: checks
97d6f37d: bets 1,431
38ee39eb: calls 1,431
3cc9b800: raises 7,523 to 8,954 and is all-in
Hero: folds
51fb90e0: folds
97d6f37d: folds
38ee39eb: calls 7,523
3cc9b800: shows [Jc Kd] (Three Kings)
38ee39eb: shows [Qd As] (Pair of Kings and Pair of Queens)
*** RIVER *** [7s Qs Kc Ks] [Td]
*** SHOWDOWN ***
3cc9b800 collected 23,674 from pot
*** SUMMARY ***
Total pot 23,674 | Rake 0 | Jackpot 0 | Bingo 0 | Fortune 0 | Tax 0
Board [7s Qs Kc Ks Td]
Seat 1: 38ee39eb showed [Qd As] and lost with Pair of Kings and Pair of Queens
Seat 2: e0d1c3eb folded before Flop
Seat 3: 3cc9b800 (button) showed [Jc Kd] and won (23,674) with Three Kings
Seat 4: Hero folded on the Turn
Seat 5: 51fb90e0 folded on the Turn
Seat 6: 97d6f37d folded on the Turn


Poker Hand #TM81957196: Tournament #160064971, Short Deck Bounty Hyper $1.08 ShortDeck No Limit - Level3(60) - 2024/08/26 16:16:59
Table '1' 6-max Seat #2 is the button
Seat 1: 38ee39eb (28,106 in chips)
Seat 2: e0d1c3eb (9,880 in chips)
Seat 3: 3cc9b800 (12,442 in chips)
Seat 4: Hero (9,274 in chips)
Seat 5: 51fb90e0 (19,778 in chips)
Seat 6: 97d6f37d (10,000 in chips)
97d6f37d: posts the ante 60
51fb90e0: posts the ante 60
3cc9b800: posts the ante 60
38ee39eb: posts the ante 60
Hero: posts the ante 60
e0d1c3eb: posts the ante 60
e0d1c3eb: posts button blind 60
*** HOLE CARDS ***
Dealt to 38ee39eb 
Dealt to e0d1c3eb 
Dealt to 3cc9b800 
Dealt to Hero [Jd Js]
Dealt to 51fb90e0 
Dealt to 97d6f37d 
3cc9b800: calls 60
Hero: raises 179 to 239
51fb90e0: calls 239
97d6f37d: folds
38ee39eb: calls 239
e0d1c3eb: calls 179
3cc9b800: calls 179
*** FLOP *** [Qh Jc 7d]
3cc9b800: bets 778
Hero: calls 778
51fb90e0: folds
38ee39eb: folds
e0d1c3eb: folds
*** TURN *** [Qh Jc 7d] [Qs]
3cc9b800: checks
Hero: bets 1,556
3cc9b800: calls 1,556
*** RIVER *** [Qh Jc 7d Qs] [6s]
3cc9b800: checks
Hero: bets 2,054
3cc9b800: folds
Uncalled bet (2,054) returned to Hero
3cc9b800: shows [Tc 9h] (Pair of Queens)
*** SHOWDOWN ***
Hero collected 6,223 from pot
*** SUMMARY ***
Total pot 6,223 | Rake 0 | Jackpot 0 | Bingo 0 | Fortune 0 | Tax 0
Board [Qh Jc 7d Qs 6s]
Seat 1: 38ee39eb folded on the Flop
Seat 2: e0d1c3eb (button) folded on the Flop
Seat 3: 3cc9b800 folded on the River
Seat 4: Hero won (6,223)
Seat 5: 51fb90e0 folded on the Flop
Seat 6: 97d6f37d folded before Flop


Poker Hand #TM81957195: Tournament #160064971, Short Deck Bounty Hyper $1.08 ShortDeck No Limit - Level3(60) - 2024/08/26 16:16:37
Table '1' 6-max Seat #1 is the button
Seat 1: 38ee39eb (28,226 in chips)
Seat 2: e0d1c3eb (10,000 in chips)
Seat 3: 3cc9b800 (12,082 in chips)
Seat 4: Hero (9,334 in chips)
Seat 5: 51fb90e0 (19,838 in chips)
51fb90e0: posts the ante 60
3cc9b800: posts the ante 60
38ee39eb: posts the ante 60
Hero: posts the ante 60
e0d1c3eb: posts the ante 60
38ee39eb: posts button blind 60
*** HOLE CARDS ***
Dealt to 38ee39eb 
Dealt to e0d1c3eb 
Dealt to 3cc9b800 
Dealt to Hero [Kd Qd]
Dealt to 51fb90e0 
e0d1c3eb: calls 60
3cc9b800: raises 11,962 to 12,022 and is all-in
Hero: folds
51fb90e0: folds
38ee39eb: folds
e0d1c3eb: folds
Uncalled bet (11,962) returned to 3cc9b800
Hero: shows [Kd Qd]
*** SHOWDOWN ***
3cc9b800 collected 480 from pot
*** SUMMARY ***
Total pot 480 | Rake 0 | Jackpot 0 | Bingo 0 | Fortune 0 | Tax 0
Seat 1: 38ee39eb (button) folded before Flop
Seat 2: e0d1c3eb folded before Flop
Seat 3: 3cc9b800 collected (480)
Seat 4: Hero folded before Flop
Seat 5: 51fb90e0 folded before Flop


Poker Hand #TM81957194: Tournament #160064971, Short Deck Bounty Hyper $1.08 ShortDeck No Limit - Level2(50) - 2024/08/26 16:15:41
Table '1' 6-max Seat #6 is the button
Seat 1: 38ee39eb (15,962 in chips)
Seat 2: b97c6fb1 (2,094 in chips)
Seat 3: 3cc9b800 (12,132 in chips)
Seat 4: Hero (9,384 in chips)
Seat 5: 51fb90e0 (19,888 in chips)
Seat 6: 3da12f6e (10,020 in chips)
51fb90e0: posts the ante 50
3cc9b800: posts the ante 50
38ee39eb: posts the ante 50
Hero: posts the ante 50
3da12f6e: posts the ante 50
b97c6fb1: posts the ante 50
3da12f6e: posts button blind 50
*** HOLE CARDS ***
Dealt to 38ee39eb 
Dealt to b97c6fb1 
Dealt to 3cc9b800 
Dealt to Hero [8s 6h]
Dealt to 51fb90e0 
Dealt to 3da12f6e 
38ee39eb: raises 300 to 350
b97c6fb1: raises 1,694 to 2,044 and is all-in
3cc9b800: folds
Hero: folds
51fb90e0: folds
3da12f6e: calls 1,994
38ee39eb: raises 13,868 to 15,912 and is all-in
3da12f6e: calls 7,926 and is all-in
Uncalled bet (5,942) returned to 38ee39eb
38ee39eb: shows [As Ac]
b97c6fb1: shows [Ad 8h]
3da12f6e: shows [Jd Qc]
*** FLOP *** [9h 6s 6c]
*** TURN *** [9h 6s 6c] [9c]
*** RIVER *** [9h 6s 6c 9c] [6d]
Hero: shows [6h] (Four Sixes)
*** SHOWDOWN ***
38ee39eb collected 6,432 from pot
38ee39eb collected 15,852 from pot
*** SUMMARY ***
Total pot 22,284 | Rake 0 | Jackpot 0 | Bingo 0 | Fortune 0 | Tax 0
Board [9h 6s 6c 9c 6d]
Seat 1: 38ee39eb showed [As Ac] and won (22,284) with Sixes Full over Aces
Seat 2: b97c6fb1 showed [Ad 8h] and lost with Sixes Full over Nines
Seat 3: 3cc9b800 folded before Flop
Seat 4: Hero folded before Flop
Seat 5: 51fb90e0 folded before Flop
Seat 6: 3da12f6e (button) showed [Jd Qc] and lost with Sixes Full over Nines


Poker Hand #TM81957193: Tournament #160064971, Short Deck Bounty Hyper $1.08 ShortDeck No Limit - Level2(50) - 2024/08/26 16:14:45
Table '1' 6-max Seat #5 is the button
Seat 1: 38ee39eb (7,856 in chips)
Seat 2: b97c6fb1 (9,950 in chips)
Seat 3: 3cc9b800 (12,182 in chips)
Seat 4: Hero (9,434 in chips)
Seat 5: 51fb90e0 (19,988 in chips)
Seat 6: 3da12f6e (10,070 in chips)
51fb90e0: posts the ante 50
3cc9b800: posts the ante 50
38ee39eb: posts the ante 50
Hero: posts the ante 50
b97c6fb1: posts the ante 50
3da12f6e: posts the ante 50
51fb90e0: posts button blind 50
*** HOLE CARDS ***
Dealt to 38ee39eb 
Dealt to b97c6fb1 
Dealt to 3cc9b800 
Dealt to Hero [9s Js]
Dealt to 51fb90e0 
Dealt to 3da12f6e 
3da12f6e: folds
38ee39eb: raises 200 to 250
b97c6fb1: raises 425 to 675
3cc9b800: folds
Hero: folds
51fb90e0: folds
38ee39eb: raises 7,131 to 7,806 and is all-in
b97c6fb1: calls 7,131
38ee39eb: shows [Qc Ad]
b97c6fb1: shows [Ks Qs]
*** FLOP *** [Kc 6c 8d]
*** TURN *** [Kc 6c 8d] [Ac]
*** RIVER *** [Kc 6c 8d Ac] [9c]
*** SHOWDOWN ***
38ee39eb collected 15,962 from pot
*** SUMMARY ***
Total pot 15,962 | Rake 0 | Jackpot 0 | Bingo 0 | Fortune 0 | Tax 0
Board [Kc 6c 8d Ac 9c]
Seat 1: 38ee39eb showed [Qc Ad] and won (15,962) with Ace High Flush
Seat 2: b97c6fb1 showed [Ks Qs] and lost with Pair of Kings
Seat 3: 3cc9b800 folded before Flop
Seat 4: Hero folded before Flop
Seat 5: 51fb90e0 (button) folded before Flop
Seat 6: 3da12f6e folded before Flop


Poker Hand #TM81957192: Tournament #160064971, Short Deck Bounty Hyper $1.08 ShortDeck No Limit - Level2(50) - 2024/08/26 16:13:38
Table '1' 6-max Seat #4 is the button
Seat 1: 38ee39eb (8,816 in chips)
Seat 2: b97c6fb1 (10,000 in chips)
Seat 3: 3cc9b800 (21,596 in chips)
Seat 4: Hero (9,534 in chips)
Seat 5: 51fb90e0 (9,414 in chips)
Seat 6: 3da12f6e (10,120 in chips)
51fb90e0: posts the ante 50
3cc9b800: posts the ante 50
38ee39eb: posts the ante 50
Hero: posts the ante 50
b97c6fb1: posts the ante 50
3da12f6e: posts the ante 50
Hero: posts button blind 50
*** HOLE CARDS ***
Dealt to 38ee39eb 
Dealt to b97c6fb1 
Dealt to 3cc9b800 
Dealt to Hero [Th 8s]
Dealt to 51fb90e0 
Dealt to 3da12f6e 
51fb90e0: calls 50
3da12f6e: folds
38ee39eb: raises 149 to 199
b97c6fb1: folds
3cc9b800: calls 199
Hero: folds
51fb90e0: calls 149
*** FLOP *** [As Ah 6s]
51fb90e0: bets 711
38ee39eb: calls 711
3cc9b800: calls 711
*** TURN *** [As Ah 6s] [Js]
51fb90e0: bets 3,080
38ee39eb: folds
3cc9b800: raises 17,556 to 20,636 and is all-in
51fb90e0: calls 5,374 and is all-in
Uncalled bet (12,182) returned to 3cc9b800
3cc9b800: shows [Jd Jc] (Jacks Full over Aces)
51fb90e0: shows [Ad 9d] (Three Aces)
*** RIVER *** [As Ah 6s Js] [6h]
*** SHOWDOWN ***
51fb90e0 collected 19,988 from pot
*** SUMMARY ***
Total pot 19,988 | Rake 0 | Jackpot 0 | Bingo 0 | Fortune 0 | Tax 0
Board [As Ah 6s Js 6h]
Seat 1: 38ee39eb folded on the Turn
Seat 2: b97c6fb1 folded before Flop
Seat 3: 3cc9b800 showed [Jd Jc] and lost with Jacks Full over Aces
Seat 4: Hero (button) folded before Flop
Seat 5: 51fb90e0 showed [Ad 9d] and won (19,988) with Aces Full over Sixes
Seat 6: 3da12f6e folded before Flop


Poker Hand #TM81957191: Tournament #160064971, Short Deck Bounty Hyper $1.08 ShortDeck No Limit - Level1(40) - 2024/08/26 16:12:57
Table '1' 6-max Seat #3 is the button
Seat 1: 38ee39eb (8,856 in chips)
Seat 3: 3cc9b800 (21,130 in chips)
Seat 4: Hero (9,800 in chips)
Seat 5: 51fb90e0 (9,454 in chips)
Seat 6: 3da12f6e (10,240 in chips)
51fb90e0: posts the ante 40
3cc9b800: posts the ante 40
38ee39eb: posts the ante 40
Hero: posts the ante 40
3da12f6e: posts the ante 40
3cc9b800: posts button blind 40
*** HOLE CARDS ***
Dealt to 38ee39eb 
Dealt to 3cc9b800 
Dealt to Hero [Ah Jd]
Dealt to 51fb90e0 
Dealt to 3da12f6e 
Hero: raises 40 to 80
51fb90e0: folds
3da12f6e: calls 80
38ee39eb: folds
3cc9b800: calls 40
*** FLOP *** [Kh 8s 9d]
Hero: checks
3da12f6e: checks
3cc9b800: checks
*** TURN *** [Kh 8s 9d] [Td]
Hero: bets 146
3da12f6e: folds
3cc9b800: calls 146
*** RIVER *** [Kh 8s 9d Td] [Kc]
Hero: checks
3cc9b800: checks
Hero: shows [Ah Jd] (Pair of Kings)
3cc9b800: shows [Th 7c] (Pair of Kings and Pair of Tens)
*** SHOWDOWN ***
3cc9b800 collected 732 from pot
*** SUMMARY ***
Total pot 732 | Rake 0 | Jackpot 0 | Bingo 0 | Fortune 0 | Tax 0
Board [Kh 8s 9d Td Kc]
Seat 1: 38ee39eb folded before Flop
Seat 3: 3cc9b800 (button) showed [Th 7c] and won (732) with Pair of Kings and Pair of Tens
Seat 4: Hero showed [Ah Jd] and lost with Pair of Kings
Seat 5: 51fb90e0 folded before Flop
Seat 6: 3da12f6e folded on the Turn


Poker Hand #TM81957190: Tournament #160064971, Short Deck Bounty Hyper $1.08 ShortDeck No Limit - Level1(40) - 2024/08/26 16:12:19
Table '1' 6-max Seat #1 is the button
Seat 1: 38ee39eb (9,096 in chips)
Seat 2: d299b5f1 (600 in chips)
Seat 3: 3cc9b800 (21,170 in chips)
Seat 4: Hero (9,840 in chips)
Seat 5: 51fb90e0 (9,494 in chips)
Seat 6: 3da12f6e (9,840 in chips)
51fb90e0: posts the ante 40
3cc9b800: posts the ante 40
d299b5f1: posts the ante 40
38ee39eb: posts the ante 40
Hero: posts the ante 40
3da12f6e: posts the ante 40
38ee39eb: posts button blind 40
*** HOLE CARDS ***
Dealt to 38ee39eb 
Dealt to d299b5f1 
Dealt to 3cc9b800 
Dealt to Hero [7d Qd]
Dealt to 51fb90e0 
Dealt to 3da12f6e 
d299b5f1: folds
3cc9b800: folds
Hero: folds
51fb90e0: folds
3da12f6e: calls 40
38ee39eb: checks
*** FLOP *** [Qh 7c Js]
3da12f6e: checks
38ee39eb: bets 160
3da12f6e: calls 160
*** TURN *** [Qh 7c Js] [Th]
3da12f6e: checks
38ee39eb: checks
*** RIVER *** [Qh 7c Js Th] [Jc]
3da12f6e: checks
38ee39eb: checks
3da12f6e: shows [Kd Jh] (Three Jacks)
38ee39eb: shows [8s Qc] (Pair of Queens and Pair of Jacks)
*** SHOWDOWN ***
3da12f6e collected 640 from pot
*** SUMMARY ***
Total pot 640 | Rake 0 | Jackpot 0 | Bingo 0 | Fortune 0 | Tax 0
Board [Qh 7c Js Th Jc]
Seat 1: 38ee39eb (button) showed [8s Qc] and lost with Pair of Queens and Pair of Jacks
Seat 2: d299b5f1 folded before Flop
Seat 3: 3cc9b800 folded before Flop
Seat 4: Hero folded before Flop
Seat 5: 51fb90e0 folded before Flop
Seat 6: 3da12f6e showed [Kd Jh] and won (640) with Three Jacks


Poker Hand #TM81957189: Tournament #160064971, Short Deck Bounty Hyper $1.08 ShortDeck No Limit - Level1(40) - 2024/08/26 16:11:40
Table '1' 6-max Seat #6 is the button
Seat 1: 38ee39eb (10,000 in chips)
Seat 2: d299b5f1 (640 in chips)
Seat 3: 3cc9b800 (19,920 in chips)
Seat 4: Hero (9,880 in chips)
Seat 5: 51fb90e0 (9,680 in chips)
Seat 6: 3da12f6e (9,920 in chips)
51fb90e0: posts the ante 40
3cc9b800: posts the ante 40
d299b5f1: posts the ante 40
38ee39eb: posts the ante 40
Hero: posts the ante 40
3da12f6e: posts the ante 40
3da12f6e: posts button blind 40
*** HOLE CARDS ***
Dealt to 38ee39eb 
Dealt to d299b5f1 
Dealt to 3cc9b800 
Dealt to Hero [Qh 6d]
Dealt to 51fb90e0 
Dealt to 3da12f6e 
38ee39eb: raises 106 to 146
d299b5f1: folds
3cc9b800: calls 146
Hero: folds
51fb90e0: calls 146
3da12f6e: folds
*** FLOP *** [6h 8h Kc]
38ee39eb: bets 718
3cc9b800: raises 718 to 1,436
51fb90e0: folds
38ee39eb: folds
Uncalled bet (718) returned to 3cc9b800
*** SHOWDOWN ***
3cc9b800 collected 2,154 from pot
*** SUMMARY ***
Total pot 2,154 | Rake 0 | Jackpot 0 | Bingo 0 | Fortune 0 | Tax 0
Board [6h 8h Kc]
Seat 1: 38ee39eb folded on the Flop
Seat 2: d299b5f1 folded before Flop
Seat 3: 3cc9b800 won (2,154)
Seat 4: Hero folded before Flop
Seat 5: 51fb90e0 folded on the Flop
Seat 6: 3da12f6e (button) folded before Flop


Poker Hand #TM81957188: Tournament #160064971, Short Deck Bounty Hyper $1.08 ShortDeck No Limit - Level1(40) - 2024/08/26 16:10:59
Table '1' 6-max Seat #5 is the button
Seat 2: d299b5f1 (10,520 in chips)
Seat 3: 3cc9b800 (9,880 in chips)
Seat 4: Hero (9,920 in chips)
Seat 5: 51fb90e0 (9,760 in chips)
Seat 6: 3da12f6e (9,960 in chips)
51fb90e0: posts the ante 40
3cc9b800: posts the ante 40
d299b5f1: posts the ante 40
Hero: posts the ante 40
3da12f6e: posts the ante 40
51fb90e0: posts button blind 40
*** HOLE CARDS ***
Dealt to d299b5f1 
Dealt to 3cc9b800 
Dealt to Hero [6h Th]
Dealt to 51fb90e0 
Dealt to 3da12f6e 
3da12f6e: folds
d299b5f1: calls 40
3cc9b800: raises 40 to 80
Hero: folds
51fb90e0: folds
d299b5f1: raises 10,400 to 10,480 and is all-in
3cc9b800: calls 9,760 and is all-in
Uncalled bet (640) returned to d299b5f1
d299b5f1: shows [Jh Ah]
3cc9b800: shows [Qc As]
*** FLOP *** [Td 9s Kc]
*** TURN *** [Td 9s Kc] [6c]
*** RIVER *** [Td 9s Kc 6c] [8h]
*** SHOWDOWN ***
3cc9b800 collected 19,920 from pot
*** SUMMARY ***
Total pot 19,920 | Rake 0 | Jackpot 0 | Bingo 0 | Fortune 0 | Tax 0
Board [Td 9s Kc 6c 8h]
Seat 2: d299b5f1 showed [Jh Ah] and lost with Ace-High
Seat 3: 3cc9b800 showed [Qc As] and won (19,920) with Ace-High
Seat 4: Hero folded before Flop
Seat 5: 51fb90e0 (button) folded before Flop
Seat 6: 3da12f6e folded before Flop


Poker Hand #TM81957187: Tournament #160064971, Short Deck Bounty Hyper $1.08 ShortDeck No Limit - Level1(40) - 2024/08/26 16:10:01
Table '1' 6-max Seat #4 is the button
Seat 1: a9e59d35 (10,000 in chips)
Seat 2: d299b5f1 (10,000 in chips)
Seat 3: 3cc9b800 (10,000 in chips)
Seat 4: Hero (10,000 in chips)
Seat 5: 51fb90e0 (10,000 in chips)
Seat 6: 3da12f6e (10,000 in chips)
51fb90e0: posts the ante 40
3cc9b800: posts the ante 40
d299b5f1: posts the ante 40
a9e59d35: posts the ante 40
Hero: posts the ante 40
3da12f6e: posts the ante 40
Hero: posts button blind 40
*** HOLE CARDS ***
Dealt to a9e59d35 
Dealt to d299b5f1 
Dealt to 3cc9b800 
Dealt to Hero [Qs Tc]
Dealt to 51fb90e0 
Dealt to 3da12f6e 
51fb90e0: calls 40
3da12f6e: folds
a9e59d35: folds
d299b5f1: calls 40
3cc9b800: raises 40 to 80
Hero: folds
51fb90e0: calls 40
d299b5f1: calls 40
*** FLOP *** [Qh Kd 9c]
51fb90e0: bets 120
d299b5f1: raises 9,760 to 9,880 and is all-in
3cc9b800: folds
51fb90e0: folds
Uncalled bet (9,760) returned to d299b5f1
*** SHOWDOWN ***
d299b5f1 collected 760 from pot
*** SUMMARY ***
Total pot 760 | Rake 0 | Jackpot 0 | Bingo 0 | Fortune 0 | Tax 0
Board [Qh Kd 9c]
Seat 1: a9e59d35 folded before Flop
Seat 2: d299b5f1 won (760)
Seat 3: 3cc9b800 folded on the Flop
Seat 4: Hero (button) folded before Flop
Seat 5: 51fb90e0 folded on the Flop
Seat 6: 3da12f6e folded before Flop


