Poker Hand #TM3539283807: Tournament #155890608, Bounty Hunters $1.08 Hold'em No Limit - Level2(60/120) - 2024/08/01 10:40:25
Table '20' 8-max Seat #6 is the button
Seat 1: d0c33434 (9,725 in chips)
Seat 2: c4cfbf8d (10,000 in chips)
Seat 3: 680ddf71 (17,254 in chips)
Seat 4: aa5abe0 (20,711 in chips)
Seat 5: de505aa2 (9,729 in chips)
Seat 6: f2f77555 (30,492 in chips)
Seat 7: Hero (477 in chips)
Seat 8: 39db2649 (11,642 in chips)
39db2649: posts the ante 18
de505aa2: posts the ante 18
680ddf71: posts the ante 18
d0c33434: posts the ante 18
f2f77555: posts the ante 18
aa5abe0: posts the ante 18
c4cfbf8d: posts the ante 18
Hero: posts the ante 18
Hero: posts small blind 60
39db2649: posts big blind 120
*** HOLE CARDS ***
Dealt to d0c33434 
Dealt to c4cfbf8d 
Dealt to 680ddf71 
Dealt to aa5abe0 
Dealt to de505aa2 
Dealt to f2f77555 
Dealt to Hero [9s Qh]
Dealt to 39db2649 
d0c33434: folds
c4cfbf8d: folds
680ddf71: folds
aa5abe0: raises 156 to 276
de505aa2: folds
f2f77555: calls 276
Hero: calls 216
39db2649: folds
*** FLOP *** [6d 8c 2s]
Hero: checks
aa5abe0: checks
f2f77555: bets 546
Hero: calls 183 and is all-in
aa5abe0: calls 546
*** TURN *** [6d 8c 2s] [3s]
aa5abe0: checks
f2f77555: bets 1,184
aa5abe0: calls 1,184
*** RIVER *** [6d 8c 2s 3s] [3d]
aa5abe0: checks
f2f77555: checks
Hero: shows [9s Qh] (Pair of Treys)
aa5abe0: shows [9h Js] (Pair of Treys)
f2f77555: shows [7c 8d] (Pair of Eights and Pair of Treys)
*** SHOWDOWN ***
f2f77555 collected 1,641 from pot
f2f77555 collected 3,094 from pot
*** SUMMARY ***
Total pot 4,735 | Rake 0 | Jackpot 0 | Bingo 0 | Fortune 0 | Tax 0
Board [6d 8c 2s 3s 3d]
Seat 1: d0c33434 folded before Flop
Seat 2: c4cfbf8d folded before Flop
Seat 3: 680ddf71 folded before Flop
Seat 4: aa5abe0 showed [9h Js] and lost with Pair of Treys
Seat 5: de505aa2 folded before Flop
Seat 6: f2f77555 (button) showed [7c 8d] and won (4,735) with Pair of Eights and Pair of Treys
Seat 7: Hero (small blind) showed [9s Qh] and lost with Pair of Treys
Seat 8: 39db2649 (big blind) folded before Flop


Poker Hand #TM3539283779: Tournament #155890608, Bounty Hunters $1.08 Hold'em No Limit - Level2(60/120) - 2024/08/01 10:39:27
Table '20' 8-max Seat #5 is the button
Seat 1: d0c33434 (9,697 in chips)
Seat 3: 680ddf71 (17,272 in chips)
Seat 4: aa5abe0 (20,729 in chips)
Seat 5: de505aa2 (9,747 in chips)
Seat 6: f2f77555 (30,570 in chips)
Seat 7: Hero (115 in chips)
Seat 8: 39db2649 (11,900 in chips)
39db2649: posts the ante 18
de505aa2: posts the ante 18
680ddf71: posts the ante 18
d0c33434: posts the ante 18
f2f77555: posts the ante 18
aa5abe0: posts the ante 18
Hero: posts the ante 18
f2f77555: posts small blind 60
Hero: posts big blind 97
*** HOLE CARDS ***
Dealt to d0c33434 
Dealt to 680ddf71 
Dealt to aa5abe0 
Dealt to de505aa2 
Dealt to f2f77555 
Dealt to Hero [Qh Th]
Dealt to 39db2649 
39db2649: raises 120 to 240
d0c33434: raises 9,439 to 9,679 and is all-in
680ddf71: folds
aa5abe0: folds
de505aa2: folds
f2f77555: folds
39db2649: folds
Uncalled bet (9,439) returned to d0c33434
d0c33434: shows [9s 9h]
Hero: shows [Qh Th]
*** FLOP *** [Ad 6c 4s]
*** TURN *** [Ad 6c 4s] [5s]
*** RIVER *** [Ad 6c 4s 5s] [Qd]
*** SHOWDOWN ***
Hero collected 477 from pot
d0c33434 collected 286 from pot
*** SUMMARY ***
Total pot 763 | Rake 0 | Jackpot 0 | Bingo 0 | Fortune 0 | Tax 0
Board [Ad 6c 4s 5s Qd]
Seat 1: d0c33434 showed [9s 9h] and won (286) with Pair of Nines
Seat 3: 680ddf71 folded before Flop
Seat 4: aa5abe0 folded before Flop
Seat 5: de505aa2 (button) folded before Flop
Seat 6: f2f77555 (small blind) folded before Flop
Seat 7: Hero (big blind) showed [Qh Th] and won (477) with Pair of Queens
Seat 8: 39db2649 folded before Flop


Poker Hand #TM3539283746: Tournament #155890608, Bounty Hunters $1.08 Hold'em No Limit - Level2(60/120) - 2024/08/01 10:38:26
Table '20' 8-max Seat #4 is the button
Seat 1: d0c33434 (9,715 in chips)
Seat 2: 5e3c445d (7,580 in chips)
Seat 3: 680ddf71 (17,290 in chips)
Seat 4: aa5abe0 (20,747 in chips)
Seat 5: de505aa2 (9,825 in chips)
Seat 6: f2f77555 (11,420 in chips)
Seat 7: Hero (11,535 in chips)
Seat 8: 39db2649 (11,918 in chips)
39db2649: posts the ante 18
680ddf71: posts the ante 18
de505aa2: posts the ante 18
d0c33434: posts the ante 18
f2f77555: posts the ante 18
aa5abe0: posts the ante 18
5e3c445d: posts the ante 18
Hero: posts the ante 18
de505aa2: posts small blind 60
f2f77555: posts big blind 120
*** HOLE CARDS ***
Dealt to d0c33434 
Dealt to 5e3c445d 
Dealt to 680ddf71 
Dealt to aa5abe0 
Dealt to de505aa2 
Dealt to f2f77555 
Dealt to Hero [Td Tc]
Dealt to 39db2649 
Hero: raises 600 to 720
39db2649: folds
d0c33434: folds
5e3c445d: calls 720
680ddf71: folds
aa5abe0: folds
de505aa2: folds
f2f77555: raises 1,980 to 2,700
Hero: raises 8,817 to 11,517 and is all-in
5e3c445d: calls 6,842 and is all-in
f2f77555: calls 8,702 and is all-in
Uncalled bet (115) returned to Hero
Hero: shows [Td Tc]
5e3c445d: shows [7h 7s]
f2f77555: shows [Ac As]
*** FLOP *** [8s Js 2h]
*** TURN *** [8s Js 2h] [4d]
*** RIVER *** [8s Js 2h 4d] [4h]
*** SHOWDOWN ***
f2f77555 collected 22,890 from pot
f2f77555 collected 7,680 from pot
*** SUMMARY ***
Total pot 30,570 | Rake 0 | Jackpot 0 | Bingo 0 | Fortune 0 | Tax 0
Board [8s Js 2h 4d 4h]
Seat 1: d0c33434 folded before Flop
Seat 2: 5e3c445d showed [7h 7s] and lost with Pair of Sevens and Pair of Fours
Seat 3: 680ddf71 folded before Flop
Seat 4: aa5abe0 (button) folded before Flop
Seat 5: de505aa2 (small blind) folded before Flop
Seat 6: f2f77555 (big blind) showed [Ac As] and won (30,570) with Pair of Aces and Pair of Fours
Seat 7: Hero showed [Td Tc] and lost with Pair of Tens and Pair of Fours
Seat 8: 39db2649 folded before Flop


Poker Hand #TM3539283712: Tournament #155890608, Bounty Hunters $1.08 Hold'em No Limit - Level1(50/100) - 2024/08/01 10:36:53
Table '20' 8-max Seat #3 is the button
Seat 1: d0c33434 (9,730 in chips)
Seat 2: 5e3c445d (7,595 in chips)
Seat 3: 680ddf71 (8,525 in chips)
Seat 4: aa5abe0 (20,812 in chips)
Seat 5: de505aa2 (9,940 in chips)
Seat 6: f2f77555 (11,435 in chips)
Seat 7: Hero (20,060 in chips)
Seat 8: 39db2649 (11,933 in chips)
39db2649: posts the ante 15
680ddf71: posts the ante 15
de505aa2: posts the ante 15
d0c33434: posts the ante 15
f2f77555: posts the ante 15
aa5abe0: posts the ante 15
5e3c445d: posts the ante 15
Hero: posts the ante 15
aa5abe0: posts small blind 50
de505aa2: posts big blind 100
*** HOLE CARDS ***
Dealt to d0c33434 
Dealt to 5e3c445d 
Dealt to 680ddf71 
Dealt to aa5abe0 
Dealt to de505aa2 
Dealt to f2f77555 
Dealt to Hero [6s 3s]
Dealt to 39db2649 
f2f77555: folds
Hero: raises 100 to 200
39db2649: folds
d0c33434: folds
5e3c445d: folds
680ddf71: calls 200
aa5abe0: folds
de505aa2: folds
*** FLOP *** [8s 2s 6d]
Hero: bets 670
680ddf71: calls 670
*** TURN *** [8s 2s 6d] [3h]
Hero: checks
680ddf71: bets 1,005
Hero: calls 1,005
*** RIVER *** [8s 2s 6d 3h] [4s]
Hero: checks
680ddf71: bets 1,800
Hero: raises 16,370 to 18,170 and is all-in
680ddf71: calls 4,835 and is all-in
Uncalled bet (11,535) returned to Hero
Hero: shows [6s 3s] (Eight High Flush)
680ddf71: shows [Qs As] (Ace High Flush)
*** SHOWDOWN ***
680ddf71 collected 17,290 from pot
*** SUMMARY ***
Total pot 17,290 | Rake 0 | Jackpot 0 | Bingo 0 | Fortune 0 | Tax 0
Board [8s 2s 6d 3h 4s]
Seat 1: d0c33434 folded before Flop
Seat 2: 5e3c445d folded before Flop
Seat 3: 680ddf71 (button) showed [Qs As] and won (17,290) with Ace High Flush
Seat 4: aa5abe0 (small blind) folded before Flop
Seat 5: de505aa2 (big blind) folded before Flop
Seat 6: f2f77555 folded before Flop
Seat 7: Hero showed [6s 3s] and lost with Eight High Flush
Seat 8: 39db2649 folded before Flop


Poker Hand #TM3539283686: Tournament #155890608, Bounty Hunters $1.08 Hold'em No Limit - Level1(50/100) - 2024/08/01 10:35:55
Table '20' 8-max Seat #2 is the button
Seat 1: d0c33434 (9,745 in chips)
Seat 2: 5e3c445d (7,810 in chips)
Seat 3: 680ddf71 (8,590 in chips)
Seat 4: aa5abe0 (20,257 in chips)
Seat 5: de505aa2 (9,955 in chips)
Seat 6: f2f77555 (11,450 in chips)
Seat 7: Hero (20,075 in chips)
Seat 8: 39db2649 (12,148 in chips)
39db2649: posts the ante 15
de505aa2: posts the ante 15
680ddf71: posts the ante 15
d0c33434: posts the ante 15
f2f77555: posts the ante 15
aa5abe0: posts the ante 15
5e3c445d: posts the ante 15
Hero: posts the ante 15
680ddf71: posts small blind 50
aa5abe0: posts big blind 100
*** HOLE CARDS ***
Dealt to d0c33434 
Dealt to 5e3c445d 
Dealt to 680ddf71 
Dealt to aa5abe0 
Dealt to de505aa2 
Dealt to f2f77555 
Dealt to Hero [8h Kc]
Dealt to 39db2649 
de505aa2: folds
f2f77555: folds
Hero: folds
39db2649: raises 100 to 200
d0c33434: folds
5e3c445d: calls 200
680ddf71: folds
aa5abe0: calls 100
*** FLOP *** [5s Ks 4s]
aa5abe0: checks
39db2649: checks
5e3c445d: checks
*** TURN *** [5s Ks 4s] [7c]
aa5abe0: bets 578
39db2649: folds
5e3c445d: folds
Uncalled bet (578) returned to aa5abe0
*** SHOWDOWN ***
aa5abe0 collected 770 from pot
*** SUMMARY ***
Total pot 770 | Rake 0 | Jackpot 0 | Bingo 0 | Fortune 0 | Tax 0
Board [5s Ks 4s 7c]
Seat 1: d0c33434 folded before Flop
Seat 2: 5e3c445d (button) folded on the Turn
Seat 3: 680ddf71 (small blind) folded before Flop
Seat 4: aa5abe0 (big blind) won (770)
Seat 5: de505aa2 folded before Flop
Seat 6: f2f77555 folded before Flop
Seat 7: Hero folded before Flop
Seat 8: 39db2649 folded on the Turn


Poker Hand #TM3539283657: Tournament #155890608, Bounty Hunters $1.08 Hold'em No Limit - Level1(50/100) - 2024/08/01 10:34:55
Table '20' 8-max Seat #1 is the button
Seat 1: d0c33434 (9,760 in chips)
Seat 2: 5e3c445d (7,875 in chips)
Seat 3: 680ddf71 (9,660 in chips)
Seat 4: aa5abe0 (20,272 in chips)
Seat 5: de505aa2 (9,970 in chips)
Seat 6: f2f77555 (10,240 in chips)
Seat 7: Hero (20,090 in chips)
Seat 8: 39db2649 (12,163 in chips)
39db2649: posts the ante 15
de505aa2: posts the ante 15
680ddf71: posts the ante 15
d0c33434: posts the ante 15
f2f77555: posts the ante 15
aa5abe0: posts the ante 15
5e3c445d: posts the ante 15
Hero: posts the ante 15
5e3c445d: posts small blind 50
680ddf71: posts big blind 100
*** HOLE CARDS ***
Dealt to d0c33434 
Dealt to 5e3c445d 
Dealt to 680ddf71 
Dealt to aa5abe0 
Dealt to de505aa2 
Dealt to f2f77555 
Dealt to Hero [5c Th]
Dealt to 39db2649 
aa5abe0: folds
de505aa2: folds
f2f77555: raises 100 to 200
Hero: folds
39db2649: folds
d0c33434: folds
5e3c445d: folds
680ddf71: calls 100
*** FLOP *** [Qs As Jc]
680ddf71: checks
f2f77555: bets 285
680ddf71: calls 285
*** TURN *** [Qs As Jc] [3s]
680ddf71: checks
f2f77555: bets 570
680ddf71: calls 570
*** RIVER *** [Qs As Jc 3s] [4d]
680ddf71: checks
f2f77555: checks
680ddf71: shows [9s Tc] (Ace-High)
f2f77555: shows [Ac 2c] (Pair of Aces)
*** SHOWDOWN ***
f2f77555 collected 2,280 from pot
*** SUMMARY ***
Total pot 2,280 | Rake 0 | Jackpot 0 | Bingo 0 | Fortune 0 | Tax 0
Board [Qs As Jc 3s 4d]
Seat 1: d0c33434 (button) folded before Flop
Seat 2: 5e3c445d (small blind) folded before Flop
Seat 3: 680ddf71 (big blind) showed [9s Tc] and lost with Ace-High
Seat 4: aa5abe0 folded before Flop
Seat 5: de505aa2 folded before Flop
Seat 6: f2f77555 showed [Ac 2c] and won (2,280) with Pair of Aces
Seat 7: Hero folded before Flop
Seat 8: 39db2649 folded before Flop


Poker Hand #TM3539283639: Tournament #155890608, Bounty Hunters $1.08 Hold'em No Limit - Level1(50/100) - 2024/08/01 10:34:18
Table '20' 8-max Seat #8 is the button
Seat 1: d0c33434 (9,825 in chips)
Seat 2: 5e3c445d (7,320 in chips)
Seat 3: 680ddf71 (9,675 in chips)
Seat 4: aa5abe0 (20,287 in chips)
Seat 5: de505aa2 (9,985 in chips)
Seat 6: f2f77555 (10,255 in chips)
Seat 7: Hero (20,305 in chips)
Seat 8: 39db2649 (12,378 in chips)
39db2649: posts the ante 15
de505aa2: posts the ante 15
680ddf71: posts the ante 15
d0c33434: posts the ante 15
f2f77555: posts the ante 15
aa5abe0: posts the ante 15
5e3c445d: posts the ante 15
Hero: posts the ante 15
d0c33434: posts small blind 50
5e3c445d: posts big blind 100
*** HOLE CARDS ***
Dealt to d0c33434 
Dealt to 5e3c445d 
Dealt to 680ddf71 
Dealt to aa5abe0 
Dealt to de505aa2 
Dealt to f2f77555 
Dealt to Hero [8s 4s]
Dealt to 39db2649 
680ddf71: folds
aa5abe0: folds
de505aa2: folds
f2f77555: folds
Hero: raises 100 to 200
39db2649: calls 200
d0c33434: folds
5e3c445d: raises 770 to 970
Hero: folds
39db2649: folds
Uncalled bet (770) returned to 5e3c445d
*** SHOWDOWN ***
5e3c445d collected 770 from pot
*** SUMMARY ***
Total pot 770 | Rake 0 | Jackpot 0 | Bingo 0 | Fortune 0 | Tax 0
Seat 1: d0c33434 (small blind) folded before Flop
Seat 2: 5e3c445d (big blind) collected (770)
Seat 3: 680ddf71 folded before Flop
Seat 4: aa5abe0 folded before Flop
Seat 5: de505aa2 folded before Flop
Seat 6: f2f77555 folded before Flop
Seat 7: Hero folded before Flop
Seat 8: 39db2649 (button) folded before Flop


Poker Hand #TM3539283627: Tournament #155890608, Bounty Hunters $1.08 Hold'em No Limit - Level1(50/100) - 2024/08/01 10:33:43
Table '20' 8-max Seat #7 is the button
Seat 1: d0c33434 (9,940 in chips)
Seat 2: 5e3c445d (7,335 in chips)
Seat 3: 680ddf71 (9,690 in chips)
Seat 4: aa5abe0 (20,302 in chips)
Seat 5: de505aa2 (10,000 in chips)
Seat 6: f2f77555 (10,000 in chips)
Seat 7: Hero (20,320 in chips)
Seat 8: 39db2649 (12,443 in chips)
39db2649: posts the ante 15
de505aa2: posts the ante 15
680ddf71: posts the ante 15
d0c33434: posts the ante 15
f2f77555: posts the ante 15
aa5abe0: posts the ante 15
5e3c445d: posts the ante 15
Hero: posts the ante 15
39db2649: posts small blind 50
d0c33434: posts big blind 100
*** HOLE CARDS ***
Dealt to d0c33434 
Dealt to 5e3c445d 
Dealt to 680ddf71 
Dealt to aa5abe0 
Dealt to de505aa2 
Dealt to f2f77555 
Dealt to Hero [9c 6s]
Dealt to 39db2649 
5e3c445d: folds
680ddf71: folds
aa5abe0: folds
de505aa2: folds
f2f77555: calls 100
Hero: folds
39db2649: folds
d0c33434: checks
*** FLOP *** [3h Jc 4h]
d0c33434: checks
f2f77555: bets 185
d0c33434: folds
Uncalled bet (185) returned to f2f77555
*** SHOWDOWN ***
f2f77555 collected 370 from pot
*** SUMMARY ***
Total pot 370 | Rake 0 | Jackpot 0 | Bingo 0 | Fortune 0 | Tax 0
Board [3h Jc 4h]
Seat 1: d0c33434 (big blind) folded on the Flop
Seat 2: 5e3c445d folded before Flop
Seat 3: 680ddf71 folded before Flop
Seat 4: aa5abe0 folded before Flop
Seat 5: de505aa2 folded before Flop
Seat 6: f2f77555 won (370)
Seat 7: Hero (button) folded before Flop
Seat 8: 39db2649 (small blind) folded before Flop


Poker Hand #TM3539283585: Tournament #155890608, Bounty Hunters $1.08 Hold'em No Limit - Level1(50/100) - 2024/08/01 10:32:23
Table '20' 8-max Seat #5 is the button
Seat 1: d0c33434 (9,955 in chips)
Seat 2: 5e3c445d (7,350 in chips)
Seat 3: 680ddf71 (9,705 in chips)
Seat 4: aa5abe0 (20,317 in chips)
Seat 5: d6bb981d (9,655 in chips)
Seat 7: Hero (10,490 in chips)
Seat 8: 39db2649 (12,558 in chips)
39db2649: posts the ante 15
d6bb981d: posts the ante 15
680ddf71: posts the ante 15
d0c33434: posts the ante 15
aa5abe0: posts the ante 15
5e3c445d: posts the ante 15
Hero: posts the ante 15
Hero: posts small blind 50
39db2649: posts big blind 100
*** HOLE CARDS ***
Dealt to d0c33434 
Dealt to 5e3c445d 
Dealt to 680ddf71 
Dealt to aa5abe0 
Dealt to d6bb981d 
Dealt to Hero [7d 8c]
Dealt to 39db2649 
d0c33434: folds
5e3c445d: folds
680ddf71: folds
aa5abe0: folds
d6bb981d: raises 100 to 200
Hero: calls 150
39db2649: folds
*** FLOP *** [6s Kd 5d]
Hero: bets 200
d6bb981d: calls 200
*** TURN *** [6s Kd 5d] [4h]
Hero: checks
d6bb981d: bets 332
Hero: calls 332
*** RIVER *** [6s Kd 5d 4h] [3c]
Hero: checks
d6bb981d: bets 1,050
Hero: raises 8,693 to 9,743 and is all-in
d6bb981d: calls 7,858 and is all-in
Uncalled bet (835) returned to Hero
Hero: shows [7d 8c] (Eights-High Straight)
d6bb981d: shows [3s Ks] (Pair of Kings and Pair of Treys)
*** SHOWDOWN ***
Hero collected 19,485 from pot
*** SUMMARY ***
Total pot 19,485 | Rake 0 | Jackpot 0 | Bingo 0 | Fortune 0 | Tax 0
Board [6s Kd 5d 4h 3c]
Seat 1: d0c33434 folded before Flop
Seat 2: 5e3c445d folded before Flop
Seat 3: 680ddf71 folded before Flop
Seat 4: aa5abe0 folded before Flop
Seat 5: d6bb981d (button) showed [3s Ks] and lost with Pair of Kings and Pair of Treys
Seat 7: Hero (small blind) showed [7d 8c] and won (19,485) with Eights-High Straight
Seat 8: 39db2649 (big blind) folded before Flop


Poker Hand #TM3539283568: Tournament #155890608, Bounty Hunters $1.08 Hold'em No Limit - Level1(50/100) - 2024/08/01 10:31:53
Table '20' 8-max Seat #4 is the button
Seat 1: d0c33434 (9,970 in chips)
Seat 2: 5e3c445d (7,365 in chips)
Seat 3: 680ddf71 (9,920 in chips)
Seat 4: aa5abe0 (20,332 in chips)
Seat 5: d6bb981d (9,870 in chips)
Seat 7: Hero (10,000 in chips)
Seat 8: 39db2649 (12,573 in chips)
39db2649: posts the ante 15
d6bb981d: posts the ante 15
680ddf71: posts the ante 15
d0c33434: posts the ante 15
aa5abe0: posts the ante 15
5e3c445d: posts the ante 15
Hero: posts the ante 15
d6bb981d: posts small blind 50
Hero: posts big blind 100
*** HOLE CARDS ***
Dealt to d0c33434 
Dealt to 5e3c445d 
Dealt to 680ddf71 
Dealt to aa5abe0 
Dealt to d6bb981d 
Dealt to Hero [Qh Ah]
Dealt to 39db2649 
39db2649: folds
d0c33434: folds
5e3c445d: folds
680ddf71: raises 100 to 200
aa5abe0: folds
d6bb981d: calls 150
Hero: raises 9,785 to 9,985 and is all-in
680ddf71: folds
d6bb981d: folds
Uncalled bet (9,785) returned to Hero
*** SHOWDOWN ***
Hero collected 705 from pot
*** SUMMARY ***
Total pot 705 | Rake 0 | Jackpot 0 | Bingo 0 | Fortune 0 | Tax 0
Seat 1: d0c33434 folded before Flop
Seat 2: 5e3c445d folded before Flop
Seat 3: 680ddf71 folded before Flop
Seat 4: aa5abe0 (button) folded before Flop
Seat 5: d6bb981d (small blind) folded before Flop
Seat 7: Hero (big blind) collected (705)
Seat 8: 39db2649 folded before Flop


