Poker Hand #TM3524128012: Tournament #155037137, Bounty Hunters Big One $1.08 Hold'em No Limit - Level6(150/300) - 2024/07/27 18:29:33
Table '201' 8-max Seat #2 is the button
Seat 1: e656985b (7,506 in chips)
Seat 2: b2c9556c (18,543 in chips)
Seat 3: 4922758c (13,288 in chips)
Seat 4: f0f1afa4 (11,726 in chips)
Seat 5: e5815984 (15,658 in chips)
Seat 6: Hero (6,353 in chips)
Seat 7: 2aef8583 (10,395 in chips)
Seat 8: 40bcbf41 (8,787 in chips)
e656985b: posts the ante 45
f0f1afa4: posts the ante 45
4922758c: posts the ante 45
b2c9556c: posts the ante 45
2aef8583: posts the ante 45
e5815984: posts the ante 45
Hero: posts the ante 45
40bcbf41: posts the ante 45
4922758c: posts small blind 150
f0f1afa4: posts big blind 300
*** HOLE CARDS ***
Dealt to e656985b 
Dealt to b2c9556c 
Dealt to 4922758c 
Dealt to f0f1afa4 
Dealt to e5815984 
Dealt to Hero [Ah Jh]
Dealt to 2aef8583 
Dealt to 40bcbf41 
e5815984: raises 300 to 600
Hero: calls 600
2aef8583: folds
40bcbf41: folds
e656985b: folds
b2c9556c: calls 600
4922758c: raises 2,100 to 2,700
f0f1afa4: raises 8,981 to 11,681 and is all-in
e5815984: folds
Hero: calls 5,708 and is all-in
b2c9556c: folds
4922758c: calls 8,981
f0f1afa4: shows [Th Ts]
Hero: shows [Ah Jh]
4922758c: shows [As Ks]
*** FLOP *** [7s Qc Ad]
*** TURN *** [7s Qc Ad] [Kd]
*** RIVER *** [7s Qc Ad Kd] [8s]
b2c9556c: shows [Tc] (Ace-High)
*** SHOWDOWN ***
4922758c collected 20,484 from pot
4922758c collected 10,746 from pot
*** SUMMARY ***
Total pot 31,230 | Rake 0 | Jackpot 0 | Bingo 0 | Fortune 0 | Tax 0
Board [7s Qc Ad Kd 8s]
Seat 1: e656985b folded before Flop
Seat 2: b2c9556c (button) folded before Flop
Seat 3: 4922758c (small blind) showed [As Ks] and won (31,230) with Pair of Aces and Pair of Kings
Seat 4: f0f1afa4 (big blind) showed [Th Ts] and lost with Pair of Tens
Seat 5: e5815984 folded before Flop
Seat 6: Hero showed [Ah Jh] and lost with Pair of Aces
Seat 7: 2aef8583 folded before Flop
Seat 8: 40bcbf41 folded before Flop


Poker Hand #TM3524127929: Tournament #155037137, Bounty Hunters Big One $1.08 Hold'em No Limit - Level6(150/300) - 2024/07/27 18:28:17
Table '201' 8-max Seat #1 is the button
Seat 1: e656985b (7,551 in chips)
Seat 2: b2c9556c (24,752 in chips)
Seat 3: 4922758c (6,209 in chips)
Seat 4: f0f1afa4 (11,771 in chips)
Seat 5: e5815984 (16,303 in chips)
Seat 6: Hero (6,398 in chips)
Seat 7: 2aef8583 (10,440 in chips)
Seat 8: 40bcbf41 (8,832 in chips)
e656985b: posts the ante 45
f0f1afa4: posts the ante 45
4922758c: posts the ante 45
b2c9556c: posts the ante 45
2aef8583: posts the ante 45
e5815984: posts the ante 45
Hero: posts the ante 45
40bcbf41: posts the ante 45
b2c9556c: posts small blind 150
4922758c: posts big blind 300
*** HOLE CARDS ***
Dealt to e656985b 
Dealt to b2c9556c 
Dealt to 4922758c 
Dealt to f0f1afa4 
Dealt to e5815984 
Dealt to Hero [Ks 2s]
Dealt to 2aef8583 
Dealt to 40bcbf41 
f0f1afa4: folds
e5815984: raises 300 to 600
Hero: folds
2aef8583: folds
40bcbf41: folds
e656985b: folds
b2c9556c: calls 450
4922758c: raises 5,564 to 6,164 and is all-in
e5815984: folds
b2c9556c: calls 5,564
4922758c: shows [Qs Ah]
b2c9556c: shows [Ac 2d]
*** FLOP *** [Ts 4h 6d]
*** TURN *** [Ts 4h 6d] [Jd]
*** RIVER *** [Ts 4h 6d Jd] [8h]
Hero: shows [2s] (Jack-High)
*** SHOWDOWN ***
4922758c collected 13,288 from pot
*** SUMMARY ***
Total pot 13,288 | Rake 0 | Jackpot 0 | Bingo 0 | Fortune 0 | Tax 0
Board [Ts 4h 6d Jd 8h]
Seat 1: e656985b (button) folded before Flop
Seat 2: b2c9556c (small blind) showed [Ac 2d] and lost with Ace-High
Seat 3: 4922758c (big blind) showed [Qs Ah] and won (13,288) with Ace-High
Seat 4: f0f1afa4 folded before Flop
Seat 5: e5815984 folded before Flop
Seat 6: Hero folded before Flop
Seat 7: 2aef8583 folded before Flop
Seat 8: 40bcbf41 folded before Flop


Poker Hand #TM3524127875: Tournament #155037137, Bounty Hunters Big One $1.08 Hold'em No Limit - Level6(150/300) - 2024/07/27 18:27:30
Table '201' 8-max Seat #8 is the button
Seat 1: e656985b (7,746 in chips)
Seat 2: b2c9556c (23,087 in chips)
Seat 3: 4922758c (6,254 in chips)
Seat 4: f0f1afa4 (11,816 in chips)
Seat 5: e5815984 (16,948 in chips)
Seat 6: Hero (6,443 in chips)
Seat 7: 2aef8583 (10,485 in chips)
Seat 8: 40bcbf41 (9,477 in chips)
e656985b: posts the ante 45
f0f1afa4: posts the ante 45
4922758c: posts the ante 45
b2c9556c: posts the ante 45
2aef8583: posts the ante 45
e5815984: posts the ante 45
Hero: posts the ante 45
40bcbf41: posts the ante 45
e656985b: posts small blind 150
b2c9556c: posts big blind 300
*** HOLE CARDS ***
Dealt to e656985b 
Dealt to b2c9556c 
Dealt to 4922758c 
Dealt to f0f1afa4 
Dealt to e5815984 
Dealt to Hero [Ah 5d]
Dealt to 2aef8583 
Dealt to 40bcbf41 
4922758c: folds
f0f1afa4: folds
e5815984: raises 300 to 600
Hero: folds
2aef8583: folds
40bcbf41: calls 600
e656985b: folds
b2c9556c: raises 1,918 to 2,518
e5815984: folds
40bcbf41: folds
Uncalled bet (1,918) returned to b2c9556c
*** SHOWDOWN ***
b2c9556c collected 2,310 from pot
*** SUMMARY ***
Total pot 2,310 | Rake 0 | Jackpot 0 | Bingo 0 | Fortune 0 | Tax 0
Seat 1: e656985b (small blind) folded before Flop
Seat 2: b2c9556c (big blind) collected (2,310)
Seat 3: 4922758c folded before Flop
Seat 4: f0f1afa4 folded before Flop
Seat 5: e5815984 folded before Flop
Seat 6: Hero folded before Flop
Seat 7: 2aef8583 folded before Flop
Seat 8: 40bcbf41 (button) folded before Flop


Poker Hand #TM3524127817: Tournament #155037137, Bounty Hunters Big One $1.08 Hold'em No Limit - Level5(125/250) - 2024/07/27 18:26:36
Table '201' 8-max Seat #7 is the button
Seat 1: e656985b (8,745 in chips)
Seat 2: b2c9556c (23,122 in chips)
Seat 3: 4922758c (6,289 in chips)
Seat 4: f0f1afa4 (11,851 in chips)
Seat 5: e5815984 (16,983 in chips)
Seat 6: Hero (6,478 in chips)
Seat 7: 2aef8583 (9,151 in chips)
Seat 8: 40bcbf41 (9,637 in chips)
e656985b: posts the ante 35
f0f1afa4: posts the ante 35
4922758c: posts the ante 35
b2c9556c: posts the ante 35
2aef8583: posts the ante 35
e5815984: posts the ante 35
Hero: posts the ante 35
40bcbf41: posts the ante 35
40bcbf41: posts small blind 125
e656985b: posts big blind 250
*** HOLE CARDS ***
Dealt to e656985b 
Dealt to b2c9556c 
Dealt to 4922758c 
Dealt to f0f1afa4 
Dealt to e5815984 
Dealt to Hero [Ks 7s]
Dealt to 2aef8583 
Dealt to 40bcbf41 
b2c9556c: folds
4922758c: folds
f0f1afa4: folds
e5815984: folds
Hero: folds
2aef8583: raises 250 to 500
40bcbf41: folds
e656985b: calls 250
*** FLOP *** [Ad 7h 4s]
e656985b: checks
2aef8583: bets 464
e656985b: calls 464
*** TURN *** [Ad 7h 4s] [8d]
e656985b: checks
2aef8583: bets 1,167
e656985b: folds
Uncalled bet (1,167) returned to 2aef8583
*** SHOWDOWN ***
2aef8583 collected 2,333 from pot
*** SUMMARY ***
Total pot 2,333 | Rake 0 | Jackpot 0 | Bingo 0 | Fortune 0 | Tax 0
Board [Ad 7h 4s 8d]
Seat 1: e656985b (big blind) folded on the Turn
Seat 2: b2c9556c folded before Flop
Seat 3: 4922758c folded before Flop
Seat 4: f0f1afa4 folded before Flop
Seat 5: e5815984 folded before Flop
Seat 6: Hero folded before Flop
Seat 7: 2aef8583 (button) won (2,333)
Seat 8: 40bcbf41 (small blind) folded before Flop


Poker Hand #TM3524127779: Tournament #155037137, Bounty Hunters Big One $1.08 Hold'em No Limit - Level5(125/250) - 2024/07/27 18:26:07
Table '201' 8-max Seat #6 is the button
Seat 1: e656985b (8,780 in chips)
Seat 2: b2c9556c (23,157 in chips)
Seat 3: 4922758c (6,324 in chips)
Seat 4: f0f1afa4 (11,886 in chips)
Seat 5: e5815984 (17,518 in chips)
Seat 6: Hero (6,513 in chips)
Seat 7: 2aef8583 (8,156 in chips)
Seat 8: 40bcbf41 (9,922 in chips)
e656985b: posts the ante 35
f0f1afa4: posts the ante 35
4922758c: posts the ante 35
b2c9556c: posts the ante 35
2aef8583: posts the ante 35
e5815984: posts the ante 35
Hero: posts the ante 35
40bcbf41: posts the ante 35
2aef8583: posts small blind 125
40bcbf41: posts big blind 250
*** HOLE CARDS ***
Dealt to e656985b 
Dealt to b2c9556c 
Dealt to 4922758c 
Dealt to f0f1afa4 
Dealt to e5815984 
Dealt to Hero [Td 7c]
Dealt to 2aef8583 
Dealt to 40bcbf41 
e656985b: folds
b2c9556c: folds
4922758c: folds
f0f1afa4: folds
e5815984: raises 250 to 500
Hero: folds
2aef8583: raises 750 to 1,250
40bcbf41: folds
e5815984: folds
Uncalled bet (750) returned to 2aef8583
*** SHOWDOWN ***
2aef8583 collected 1,530 from pot
*** SUMMARY ***
Total pot 1,530 | Rake 0 | Jackpot 0 | Bingo 0 | Fortune 0 | Tax 0
Seat 1: e656985b folded before Flop
Seat 2: b2c9556c folded before Flop
Seat 3: 4922758c folded before Flop
Seat 4: f0f1afa4 folded before Flop
Seat 5: e5815984 folded before Flop
Seat 6: Hero (button) folded before Flop
Seat 7: 2aef8583 (small blind) collected (1,530)
Seat 8: 40bcbf41 (big blind) folded before Flop


Poker Hand #TM3524127728: Tournament #155037137, Bounty Hunters Big One $1.08 Hold'em No Limit - Level5(125/250) - 2024/07/27 18:25:18
Table '201' 8-max Seat #5 is the button
Seat 1: e656985b (7,910 in chips)
Seat 2: b2c9556c (23,192 in chips)
Seat 3: 4922758c (6,359 in chips)
Seat 4: f0f1afa4 (11,921 in chips)
Seat 5: e5815984 (17,553 in chips)
Seat 6: Hero (6,673 in chips)
Seat 7: 2aef8583 (8,691 in chips)
Seat 8: 40bcbf41 (9,957 in chips)
e656985b: posts the ante 35
f0f1afa4: posts the ante 35
4922758c: posts the ante 35
b2c9556c: posts the ante 35
2aef8583: posts the ante 35
e5815984: posts the ante 35
Hero: posts the ante 35
40bcbf41: posts the ante 35
Hero: posts small blind 125
2aef8583: posts big blind 250
*** HOLE CARDS ***
Dealt to e656985b 
Dealt to b2c9556c 
Dealt to 4922758c 
Dealt to f0f1afa4 
Dealt to e5815984 
Dealt to Hero [5c Td]
Dealt to 2aef8583 
Dealt to 40bcbf41 
40bcbf41: folds
e656985b: raises 250 to 500
b2c9556c: folds
4922758c: folds
f0f1afa4: folds
e5815984: folds
Hero: folds
2aef8583: calls 250
*** FLOP *** [9s 2h 3d]
2aef8583: checks
e656985b: bets 750
2aef8583: folds
Uncalled bet (750) returned to e656985b
*** SHOWDOWN ***
e656985b collected 1,405 from pot
*** SUMMARY ***
Total pot 1,405 | Rake 0 | Jackpot 0 | Bingo 0 | Fortune 0 | Tax 0
Board [9s 2h 3d]
Seat 1: e656985b won (1,405)
Seat 2: b2c9556c folded before Flop
Seat 3: 4922758c folded before Flop
Seat 4: f0f1afa4 folded before Flop
Seat 5: e5815984 (button) folded before Flop
Seat 6: Hero (small blind) folded before Flop
Seat 7: 2aef8583 (big blind) folded on the Flop
Seat 8: 40bcbf41 folded before Flop


Poker Hand #TM3524127640: Tournament #155037137, Bounty Hunters Big One $1.08 Hold'em No Limit - Level5(125/250) - 2024/07/27 18:24:02
Table '201' 8-max Seat #4 is the button
Seat 1: e656985b (7,945 in chips)
Seat 2: b2c9556c (23,227 in chips)
Seat 3: 4922758c (6,394 in chips)
Seat 4: f0f1afa4 (12,456 in chips)
Seat 5: e5815984 (18,088 in chips)
Seat 6: Hero (4,928 in chips)
Seat 7: 2aef8583 (8,726 in chips)
Seat 8: 40bcbf41 (10,492 in chips)
e656985b: posts the ante 35
f0f1afa4: posts the ante 35
4922758c: posts the ante 35
b2c9556c: posts the ante 35
2aef8583: posts the ante 35
e5815984: posts the ante 35
Hero: posts the ante 35
40bcbf41: posts the ante 35
e5815984: posts small blind 125
Hero: posts big blind 250
*** HOLE CARDS ***
Dealt to e656985b 
Dealt to b2c9556c 
Dealt to 4922758c 
Dealt to f0f1afa4 
Dealt to e5815984 
Dealt to Hero [7c 4d]
Dealt to 2aef8583 
Dealt to 40bcbf41 
2aef8583: folds
40bcbf41: raises 250 to 500
e656985b: folds
b2c9556c: folds
4922758c: folds
f0f1afa4: calls 500
e5815984: calls 375
Hero: calls 250
*** FLOP *** [3c 6h 3d]
e5815984: checks
Hero: bets 1,140
40bcbf41: folds
f0f1afa4: folds
e5815984: folds
Uncalled bet (1,140) returned to Hero
*** SHOWDOWN ***
Hero collected 2,280 from pot
*** SUMMARY ***
Total pot 2,280 | Rake 0 | Jackpot 0 | Bingo 0 | Fortune 0 | Tax 0
Board [3c 6h 3d]
Seat 1: e656985b folded before Flop
Seat 2: b2c9556c folded before Flop
Seat 3: 4922758c folded before Flop
Seat 4: f0f1afa4 (button) folded on the Flop
Seat 5: e5815984 (small blind) folded on the Flop
Seat 6: Hero (big blind) won (2,280)
Seat 7: 2aef8583 folded before Flop
Seat 8: 40bcbf41 folded on the Flop


Poker Hand #TM3524127581: Tournament #155037137, Bounty Hunters Big One $1.08 Hold'em No Limit - Level5(125/250) - 2024/07/27 18:23:12
Table '201' 8-max Seat #3 is the button
Seat 1: e656985b (7,980 in chips)
Seat 2: b2c9556c (23,262 in chips)
Seat 3: 4922758c (6,429 in chips)
Seat 4: f0f1afa4 (12,616 in chips)
Seat 5: e5815984 (18,373 in chips)
Seat 6: Hero (4,963 in chips)
Seat 7: 2aef8583 (8,761 in chips)
Seat 8: 40bcbf41 (9,872 in chips)
e656985b: posts the ante 35
f0f1afa4: posts the ante 35
4922758c: posts the ante 35
b2c9556c: posts the ante 35
2aef8583: posts the ante 35
e5815984: posts the ante 35
Hero: posts the ante 35
40bcbf41: posts the ante 35
f0f1afa4: posts small blind 125
e5815984: posts big blind 250
*** HOLE CARDS ***
Dealt to e656985b 
Dealt to b2c9556c 
Dealt to 4922758c 
Dealt to f0f1afa4 
Dealt to e5815984 
Dealt to Hero [Jh Tc]
Dealt to 2aef8583 
Dealt to 40bcbf41 
Hero: folds
2aef8583: folds
40bcbf41: raises 250 to 500
e656985b: folds
b2c9556c: folds
4922758c: folds
f0f1afa4: folds
e5815984: folds
Uncalled bet (250) returned to 40bcbf41
*** SHOWDOWN ***
40bcbf41 collected 905 from pot
*** SUMMARY ***
Total pot 905 | Rake 0 | Jackpot 0 | Bingo 0 | Fortune 0 | Tax 0
Seat 1: e656985b folded before Flop
Seat 2: b2c9556c folded before Flop
Seat 3: 4922758c (button) folded before Flop
Seat 4: f0f1afa4 (small blind) folded before Flop
Seat 5: e5815984 (big blind) folded before Flop
Seat 6: Hero folded before Flop
Seat 7: 2aef8583 folded before Flop
Seat 8: 40bcbf41 collected (905)


Poker Hand #TM3524127515: Tournament #155037137, Bounty Hunters Big One $1.08 Hold'em No Limit - Level5(125/250) - 2024/07/27 18:22:16
Table '201' 8-max Seat #2 is the button
Seat 1: e656985b (8,015 in chips)
Seat 2: b2c9556c (23,297 in chips)
Seat 3: 4922758c (7,552 in chips)
Seat 4: f0f1afa4 (13,739 in chips)
Seat 5: e5815984 (15,952 in chips)
Seat 6: Hero (4,998 in chips)
Seat 7: 2aef8583 (8,796 in chips)
Seat 8: 40bcbf41 (9,907 in chips)
e656985b: posts the ante 35
f0f1afa4: posts the ante 35
4922758c: posts the ante 35
b2c9556c: posts the ante 35
2aef8583: posts the ante 35
e5815984: posts the ante 35
Hero: posts the ante 35
40bcbf41: posts the ante 35
4922758c: posts small blind 125
f0f1afa4: posts big blind 250
*** HOLE CARDS ***
Dealt to e656985b 
Dealt to b2c9556c 
Dealt to 4922758c 
Dealt to f0f1afa4 
Dealt to e5815984 
Dealt to Hero [Kd 4d]
Dealt to 2aef8583 
Dealt to 40bcbf41 
e5815984: raises 250 to 500
Hero: folds
2aef8583: folds
40bcbf41: folds
e656985b: folds
b2c9556c: folds
4922758c: calls 375
f0f1afa4: calls 250
*** FLOP *** [8h Td 4h]
4922758c: bets 588
f0f1afa4: calls 588
e5815984: raises 1,662 to 2,250
4922758c: folds
f0f1afa4: folds
Uncalled bet (1,662) returned to e5815984
*** SHOWDOWN ***
e5815984 collected 3,544 from pot
*** SUMMARY ***
Total pot 3,544 | Rake 0 | Jackpot 0 | Bingo 0 | Fortune 0 | Tax 0
Board [8h Td 4h]
Seat 1: e656985b folded before Flop
Seat 2: b2c9556c (button) folded before Flop
Seat 3: 4922758c (small blind) folded on the Flop
Seat 4: f0f1afa4 (big blind) folded on the Flop
Seat 5: e5815984 won (3,544)
Seat 6: Hero folded before Flop
Seat 7: 2aef8583 folded before Flop
Seat 8: 40bcbf41 folded before Flop


Poker Hand #TM3524127438: Tournament #155037137, Bounty Hunters Big One $1.08 Hold'em No Limit - Level5(125/250) - 2024/07/27 18:21:09
Table '201' 8-max Seat #1 is the button
Seat 1: e656985b (9,300 in chips)
Seat 2: b2c9556c (21,552 in chips)
Seat 3: 4922758c (7,837 in chips)
Seat 4: f0f1afa4 (13,774 in chips)
Seat 5: e5815984 (15,987 in chips)
Seat 6: Hero (5,033 in chips)
Seat 7: 2aef8583 (8,831 in chips)
Seat 8: 40bcbf41 (9,942 in chips)
e656985b: posts the ante 35
f0f1afa4: posts the ante 35
4922758c: posts the ante 35
b2c9556c: posts the ante 35
2aef8583: posts the ante 35
e5815984: posts the ante 35
Hero: posts the ante 35
40bcbf41: posts the ante 35
b2c9556c: posts small blind 125
4922758c: posts big blind 250
*** HOLE CARDS ***
Dealt to e656985b 
Dealt to b2c9556c 
Dealt to 4922758c 
Dealt to f0f1afa4 
Dealt to e5815984 
Dealt to Hero [6s 7d]
Dealt to 2aef8583 
Dealt to 40bcbf41 
f0f1afa4: folds
e5815984: folds
Hero: folds
2aef8583: folds
40bcbf41: folds
e656985b: raises 250 to 500
b2c9556c: calls 375
4922758c: folds
*** FLOP *** [9s Td Jh]
b2c9556c: checks
e656985b: bets 750
b2c9556c: raises 2,515 to 3,265
e656985b: folds
Uncalled bet (2,515) returned to b2c9556c
*** SHOWDOWN ***
b2c9556c collected 3,030 from pot
*** SUMMARY ***
Total pot 3,030 | Rake 0 | Jackpot 0 | Bingo 0 | Fortune 0 | Tax 0
Board [9s Td Jh]
Seat 1: e656985b (button) folded on the Flop
Seat 2: b2c9556c (small blind) won (3,030)
Seat 3: 4922758c (big blind) folded before Flop
Seat 4: f0f1afa4 folded before Flop
Seat 5: e5815984 folded before Flop
Seat 6: Hero folded before Flop
Seat 7: 2aef8583 folded before Flop
Seat 8: 40bcbf41 folded before Flop


Poker Hand #TM3524127397: Tournament #155037137, Bounty Hunters Big One $1.08 Hold'em No Limit - Level5(125/250) - 2024/07/27 18:20:30
Table '201' 8-max Seat #8 is the button
Seat 1: e656985b (9,460 in chips)
Seat 2: b2c9556c (22,087 in chips)
Seat 3: 4922758c (7,872 in chips)
Seat 4: f0f1afa4 (12,904 in chips)
Seat 5: e5815984 (16,022 in chips)
Seat 6: Hero (5,068 in chips)
Seat 7: 2aef8583 (8,866 in chips)
Seat 8: 40bcbf41 (9,977 in chips)
e656985b: posts the ante 35
f0f1afa4: posts the ante 35
4922758c: posts the ante 35
b2c9556c: posts the ante 35
2aef8583: posts the ante 35
e5815984: posts the ante 35
Hero: posts the ante 35
40bcbf41: posts the ante 35
e656985b: posts small blind 125
b2c9556c: posts big blind 250
*** HOLE CARDS ***
Dealt to e656985b 
Dealt to b2c9556c 
Dealt to 4922758c 
Dealt to f0f1afa4 
Dealt to e5815984 
Dealt to Hero [3s 5d]
Dealt to 2aef8583 
Dealt to 40bcbf41 
4922758c: folds
f0f1afa4: raises 250 to 500
e5815984: folds
Hero: folds
2aef8583: folds
40bcbf41: folds
e656985b: folds
b2c9556c: calls 250
*** FLOP *** [Jd 5h Ad]
b2c9556c: checks
f0f1afa4: bets 1,405
b2c9556c: folds
Uncalled bet (1,405) returned to f0f1afa4
*** SHOWDOWN ***
f0f1afa4 collected 1,405 from pot
*** SUMMARY ***
Total pot 1,405 | Rake 0 | Jackpot 0 | Bingo 0 | Fortune 0 | Tax 0
Board [Jd 5h Ad]
Seat 1: e656985b (small blind) folded before Flop
Seat 2: b2c9556c (big blind) folded on the Flop
Seat 3: 4922758c folded before Flop
Seat 4: f0f1afa4 won (1,405)
Seat 5: e5815984 folded before Flop
Seat 6: Hero folded before Flop
Seat 7: 2aef8583 folded before Flop
Seat 8: 40bcbf41 (button) folded before Flop


Poker Hand #TM3524127334: Tournament #155037137, Bounty Hunters Big One $1.08 Hold'em No Limit - Level5(125/250) - 2024/07/27 18:19:37
Table '201' 8-max Seat #7 is the button
Seat 1: e656985b (8,541 in chips)
Seat 2: b2c9556c (22,671 in chips)
Seat 3: 4922758c (7,907 in chips)
Seat 4: f0f1afa4 (12,939 in chips)
Seat 5: e5815984 (16,057 in chips)
Seat 6: Hero (5,103 in chips)
Seat 7: 2aef8583 (8,901 in chips)
Seat 8: 40bcbf41 (10,137 in chips)
e656985b: posts the ante 35
f0f1afa4: posts the ante 35
4922758c: posts the ante 35
b2c9556c: posts the ante 35
2aef8583: posts the ante 35
e5815984: posts the ante 35
Hero: posts the ante 35
40bcbf41: posts the ante 35
40bcbf41: posts small blind 125
e656985b: posts big blind 250
*** HOLE CARDS ***
Dealt to e656985b 
Dealt to b2c9556c 
Dealt to 4922758c 
Dealt to f0f1afa4 
Dealt to e5815984 
Dealt to Hero [4c 7s]
Dealt to 2aef8583 
Dealt to 40bcbf41 
b2c9556c: calls 250
4922758c: folds
f0f1afa4: folds
e5815984: folds
Hero: folds
2aef8583: folds
40bcbf41: folds
e656985b: checks
*** FLOP *** [Jd Kc 8s]
e656985b: checks
b2c9556c: bets 299
e656985b: calls 299
*** TURN *** [Jd Kc 8s] [Qh]
e656985b: checks
b2c9556c: checks
*** RIVER *** [Jd Kc 8s Qh] [Kd]
e656985b: checks
b2c9556c: checks
e656985b: shows [9s Jc] (Pair of Kings and Pair of Jacks)
b2c9556c: shows [7h Ah] (Pair of Kings)
*** SHOWDOWN ***
e656985b collected 1,503 from pot
*** SUMMARY ***
Total pot 1,503 | Rake 0 | Jackpot 0 | Bingo 0 | Fortune 0 | Tax 0
Board [Jd Kc 8s Qh Kd]
Seat 1: e656985b (big blind) showed [9s Jc] and won (1,503) with Pair of Kings and Pair of Jacks
Seat 2: b2c9556c showed [7h Ah] and lost with Pair of Kings
Seat 3: 4922758c folded before Flop
Seat 4: f0f1afa4 folded before Flop
Seat 5: e5815984 folded before Flop
Seat 6: Hero folded before Flop
Seat 7: 2aef8583 (button) folded before Flop
Seat 8: 40bcbf41 (small blind) folded before Flop


Poker Hand #TM3524127310: Tournament #155037137, Bounty Hunters Big One $1.08 Hold'em No Limit - Level5(125/250) - 2024/07/27 18:19:13
Table '201' 8-max Seat #6 is the button
Seat 1: e656985b (8,576 in chips)
Seat 2: b2c9556c (22,051 in chips)
Seat 3: 4922758c (7,942 in chips)
Seat 4: f0f1afa4 (12,974 in chips)
Seat 5: e5815984 (16,092 in chips)
Seat 6: Hero (5,138 in chips)
Seat 7: 2aef8583 (9,061 in chips)
Seat 8: 40bcbf41 (10,422 in chips)
e656985b: posts the ante 35
f0f1afa4: posts the ante 35
4922758c: posts the ante 35
b2c9556c: posts the ante 35
2aef8583: posts the ante 35
e5815984: posts the ante 35
Hero: posts the ante 35
40bcbf41: posts the ante 35
2aef8583: posts small blind 125
40bcbf41: posts big blind 250
*** HOLE CARDS ***
Dealt to e656985b 
Dealt to b2c9556c 
Dealt to 4922758c 
Dealt to f0f1afa4 
Dealt to e5815984 
Dealt to Hero [3c Kh]
Dealt to 2aef8583 
Dealt to 40bcbf41 
e656985b: folds
b2c9556c: raises 500 to 750
4922758c: folds
f0f1afa4: folds
e5815984: folds
Hero: folds
2aef8583: folds
40bcbf41: folds
Uncalled bet (500) returned to b2c9556c
*** SHOWDOWN ***
b2c9556c collected 905 from pot
*** SUMMARY ***
Total pot 905 | Rake 0 | Jackpot 0 | Bingo 0 | Fortune 0 | Tax 0
Seat 1: e656985b folded before Flop
Seat 2: b2c9556c collected (905)
Seat 3: 4922758c folded before Flop
Seat 4: f0f1afa4 folded before Flop
Seat 5: e5815984 folded before Flop
Seat 6: Hero (button) folded before Flop
Seat 7: 2aef8583 (small blind) folded before Flop
Seat 8: 40bcbf41 (big blind) folded before Flop


Poker Hand #TM3524127243: Tournament #155037137, Bounty Hunters Big One $1.08 Hold'em No Limit - Level5(125/250) - 2024/07/27 18:18:23
Table '201' 8-max Seat #5 is the button
Seat 1: e656985b (9,111 in chips)
Seat 2: b2c9556c (22,086 in chips)
Seat 3: 4922758c (13,339 in chips)
Seat 4: f0f1afa4 (13,009 in chips)
Seat 5: e5815984 (9,610 in chips)
Seat 6: Hero (5,298 in chips)
Seat 7: 2aef8583 (9,346 in chips)
Seat 8: 40bcbf41 (10,457 in chips)
e656985b: posts the ante 35
f0f1afa4: posts the ante 35
4922758c: posts the ante 35
b2c9556c: posts the ante 35
2aef8583: posts the ante 35
e5815984: posts the ante 35
Hero: posts the ante 35
40bcbf41: posts the ante 35
Hero: posts small blind 125
2aef8583: posts big blind 250
*** HOLE CARDS ***
Dealt to e656985b 
Dealt to b2c9556c 
Dealt to 4922758c 
Dealt to f0f1afa4 
Dealt to e5815984 
Dealt to Hero [Td 7h]
Dealt to 2aef8583 
Dealt to 40bcbf41 
40bcbf41: folds
e656985b: raises 250 to 500
b2c9556c: folds
4922758c: raises 1,000 to 1,500
f0f1afa4: folds
e5815984: raises 1,500 to 3,000
Hero: folds
2aef8583: folds
e656985b: folds
4922758c: calls 1,500
*** FLOP *** [2c Qh Qs]
4922758c: bets 2,362
e5815984: calls 2,362
*** TURN *** [2c Qh Qs] [6s]
4922758c: checks
e5815984: bets 4,000
4922758c: folds
Uncalled bet (4,000) returned to e5815984
*** SHOWDOWN ***
e5815984 collected 11,879 from pot
*** SUMMARY ***
Total pot 11,879 | Rake 0 | Jackpot 0 | Bingo 0 | Fortune 0 | Tax 0
Board [2c Qh Qs 6s]
Seat 1: e656985b folded before Flop
Seat 2: b2c9556c folded before Flop
Seat 3: 4922758c folded on the Turn
Seat 4: f0f1afa4 folded before Flop
Seat 5: e5815984 (button) won (11,879)
Seat 6: Hero (small blind) folded before Flop
Seat 7: 2aef8583 (big blind) folded before Flop
Seat 8: 40bcbf41 folded before Flop


Poker Hand #TM3524127149: Tournament #155037137, Bounty Hunters Big One $1.08 Hold'em No Limit - Level5(125/250) - 2024/07/27 18:17:00
Table '201' 8-max Seat #4 is the button
Seat 1: e656985b (9,146 in chips)
Seat 2: b2c9556c (22,121 in chips)
Seat 3: 4922758c (16,085 in chips)
Seat 4: f0f1afa4 (9,428 in chips)
Seat 5: e5815984 (9,770 in chips)
Seat 6: Hero (5,833 in chips)
Seat 7: 2aef8583 (9,381 in chips)
Seat 8: 40bcbf41 (10,492 in chips)
e656985b: posts the ante 35
f0f1afa4: posts the ante 35
4922758c: posts the ante 35
b2c9556c: posts the ante 35
2aef8583: posts the ante 35
e5815984: posts the ante 35
Hero: posts the ante 35
40bcbf41: posts the ante 35
e5815984: posts small blind 125
Hero: posts big blind 250
*** HOLE CARDS ***
Dealt to e656985b 
Dealt to b2c9556c 
Dealt to 4922758c 
Dealt to f0f1afa4 
Dealt to e5815984 
Dealt to Hero [Qd 9d]
Dealt to 2aef8583 
Dealt to 40bcbf41 
2aef8583: folds
40bcbf41: folds
e656985b: folds
b2c9556c: folds
4922758c: raises 250 to 500
f0f1afa4: calls 500
e5815984: folds
Hero: calls 250
*** FLOP *** [Ac 2h 8c]
Hero: checks
4922758c: bets 953
f0f1afa4: calls 953
Hero: folds
*** TURN *** [Ac 2h 8c] [7c]
4922758c: bets 1,258
f0f1afa4: calls 1,258
*** RIVER *** [Ac 2h 8c 7c] [7d]
4922758c: checks
f0f1afa4: bets 6,682 and is all-in
4922758c: folds
Uncalled bet (6,682) returned to f0f1afa4
*** SHOWDOWN ***
f0f1afa4 collected 6,327 from pot
*** SUMMARY ***
Total pot 6,327 | Rake 0 | Jackpot 0 | Bingo 0 | Fortune 0 | Tax 0
Board [Ac 2h 8c 7c 7d]
Seat 1: e656985b folded before Flop
Seat 2: b2c9556c folded before Flop
Seat 3: 4922758c folded on the River
Seat 4: f0f1afa4 (button) won (6,327)
Seat 5: e5815984 (small blind) folded before Flop
Seat 6: Hero (big blind) folded on the Flop
Seat 7: 2aef8583 folded before Flop
Seat 8: 40bcbf41 folded before Flop


Poker Hand #TM3524127074: Tournament #155037137, Bounty Hunters Big One $1.08 Hold'em No Limit - Level4(100/200) - 2024/07/27 18:15:53
Table '201' 8-max Seat #3 is the button
Seat 1: e656985b (9,176 in chips)
Seat 2: b2c9556c (22,151 in chips)
Seat 3: 4922758c (16,115 in chips)
Seat 4: f0f1afa4 (10,058 in chips)
Seat 5: e5815984 (10,000 in chips)
Seat 6: Hero (5,863 in chips)
Seat 7: 2aef8583 (9,411 in chips)
Seat 8: 40bcbf41 (9,482 in chips)
e656985b: posts the ante 30
f0f1afa4: posts the ante 30
4922758c: posts the ante 30
b2c9556c: posts the ante 30
2aef8583: posts the ante 30
e5815984: posts the ante 30
Hero: posts the ante 30
40bcbf41: posts the ante 30
f0f1afa4: posts small blind 100
e5815984: posts big blind 200
*** HOLE CARDS ***
Dealt to e656985b 
Dealt to b2c9556c 
Dealt to 4922758c 
Dealt to f0f1afa4 
Dealt to e5815984 
Dealt to Hero [9c Qd]
Dealt to 2aef8583 
Dealt to 40bcbf41 
Hero: folds
2aef8583: folds
40bcbf41: raises 200 to 400
e656985b: folds
b2c9556c: folds
4922758c: folds
f0f1afa4: raises 200 to 600
e5815984: folds
40bcbf41: raises 8,852 to 9,452 and is all-in
f0f1afa4: folds
Uncalled bet (8,852) returned to 40bcbf41
*** SHOWDOWN ***
40bcbf41 collected 1,640 from pot
*** SUMMARY ***
Total pot 1,640 | Rake 0 | Jackpot 0 | Bingo 0 | Fortune 0 | Tax 0
Seat 1: e656985b folded before Flop
Seat 2: b2c9556c folded before Flop
Seat 3: 4922758c (button) folded before Flop
Seat 4: f0f1afa4 (small blind) folded before Flop
Seat 5: e5815984 (big blind) folded before Flop
Seat 6: Hero folded before Flop
Seat 7: 2aef8583 folded before Flop
Seat 8: 40bcbf41 collected (1,640)


Poker Hand #TM3524127002: Tournament #155037137, Bounty Hunters Big One $1.08 Hold'em No Limit - Level4(100/200) - 2024/07/27 18:14:50
Table '201' 8-max Seat #2 is the button
Seat 1: e656985b (9,206 in chips)
Seat 2: b2c9556c (22,581 in chips)
Seat 3: 4922758c (16,245 in chips)
Seat 4: f0f1afa4 (10,488 in chips)
Seat 6: Hero (7,971 in chips)
Seat 7: 2aef8583 (9,441 in chips)
Seat 8: 40bcbf41 (6,324 in chips)
e656985b: posts the ante 30
f0f1afa4: posts the ante 30
4922758c: posts the ante 30
b2c9556c: posts the ante 30
2aef8583: posts the ante 30
Hero: posts the ante 30
40bcbf41: posts the ante 30
4922758c: posts small blind 100
f0f1afa4: posts big blind 200
*** HOLE CARDS ***
Dealt to e656985b 
Dealt to b2c9556c 
Dealt to 4922758c 
Dealt to f0f1afa4 
Dealt to Hero [Th Ah]
Dealt to 2aef8583 
Dealt to 40bcbf41 
Hero: raises 200 to 400
2aef8583: folds
40bcbf41: calls 400
e656985b: folds
b2c9556c: calls 400
4922758c: folds
f0f1afa4: calls 200
*** FLOP *** [Qs Jh Tc]
f0f1afa4: checks
Hero: checks
40bcbf41: bets 631
b2c9556c: folds
f0f1afa4: folds
Hero: calls 631
*** TURN *** [Qs Jh Tc] [6d]
Hero: checks
40bcbf41: checks
*** RIVER *** [Qs Jh Tc 6d] [2d]
Hero: bets 1,047
40bcbf41: raises 4,216 to 5,263 and is all-in
Hero: folds
Uncalled bet (4,216) returned to 40bcbf41
*** SHOWDOWN ***
40bcbf41 collected 5,266 from pot
*** SUMMARY ***
Total pot 5,266 | Rake 0 | Jackpot 0 | Bingo 0 | Fortune 0 | Tax 0
Board [Qs Jh Tc 6d 2d]
Seat 1: e656985b folded before Flop
Seat 2: b2c9556c (button) folded on the Flop
Seat 3: 4922758c (small blind) folded before Flop
Seat 4: f0f1afa4 (big blind) folded on the Flop
Seat 6: Hero folded on the River
Seat 7: 2aef8583 folded before Flop
Seat 8: 40bcbf41 won (5,266)


Poker Hand #TM3524126917: Tournament #155037137, Bounty Hunters Big One $1.08 Hold'em No Limit - Level4(100/200) - 2024/07/27 18:13:14
Table '201' 8-max Seat #1 is the button
Seat 1: e656985b (11,307 in chips)
Seat 2: b2c9556c (18,440 in chips)
Seat 3: 4922758c (16,475 in chips)
Seat 4: f0f1afa4 (10,518 in chips)
Seat 5: cbb95887 (860 in chips)
Seat 6: Hero (8,831 in chips)
Seat 7: 2aef8583 (9,471 in chips)
Seat 8: 40bcbf41 (6,354 in chips)
e656985b: posts the ante 30
f0f1afa4: posts the ante 30
4922758c: posts the ante 30
b2c9556c: posts the ante 30
cbb95887: posts the ante 30
2aef8583: posts the ante 30
Hero: posts the ante 30
40bcbf41: posts the ante 30
b2c9556c: posts small blind 100
4922758c: posts big blind 200
*** HOLE CARDS ***
Dealt to e656985b 
Dealt to b2c9556c 
Dealt to 4922758c 
Dealt to f0f1afa4 
Dealt to cbb95887 
Dealt to Hero [8c 8d]
Dealt to 2aef8583 
Dealt to 40bcbf41 
f0f1afa4: folds
cbb95887: raises 630 to 830 and is all-in
Hero: calls 830
2aef8583: folds
40bcbf41: folds
e656985b: calls 830
b2c9556c: calls 730
4922758c: folds
*** FLOP *** [6s 4d Th]
b2c9556c: bets 1,241
Hero: folds
e656985b: calls 1,241
*** TURN *** [6s 4d Th] [7c]
b2c9556c: bets 16,339 and is all-in
e656985b: folds
Uncalled bet (16,339) returned to b2c9556c
b2c9556c: shows [3d 4s] (Pair of Fours)
cbb95887: shows [9s Qh] (Queen-High)
*** RIVER *** [6s 4d Th 7c] [Kh]
*** SHOWDOWN ***
b2c9556c collected 3,760 from pot
b2c9556c collected 2,482 from pot
*** SUMMARY ***
Total pot 6,242 | Rake 0 | Jackpot 0 | Bingo 0 | Fortune 0 | Tax 0
Board [6s 4d Th 7c Kh]
Seat 1: e656985b (button) folded on the Turn
Seat 2: b2c9556c (small blind) showed [3d 4s] and won (6,242) with Pair of Fours
Seat 3: 4922758c (big blind) folded before Flop
Seat 4: f0f1afa4 folded before Flop
Seat 5: cbb95887 showed [9s Qh] and lost with King-High
Seat 6: Hero folded on the Flop
Seat 7: 2aef8583 folded before Flop
Seat 8: 40bcbf41 folded before Flop


Poker Hand #TM3524126852: Tournament #155037137, Bounty Hunters Big One $1.08 Hold'em No Limit - Level4(100/200) - 2024/07/27 18:12:00
Table '201' 8-max Seat #8 is the button
Seat 1: e656985b (11,437 in chips)
Seat 2: b2c9556c (9,080 in chips)
Seat 3: 4922758c (16,505 in chips)
Seat 4: f0f1afa4 (10,548 in chips)
Seat 5: cbb95887 (9,940 in chips)
Seat 6: Hero (8,861 in chips)
Seat 7: 2aef8583 (9,501 in chips)
Seat 8: 40bcbf41 (6,384 in chips)
e656985b: posts the ante 30
f0f1afa4: posts the ante 30
4922758c: posts the ante 30
b2c9556c: posts the ante 30
cbb95887: posts the ante 30
2aef8583: posts the ante 30
Hero: posts the ante 30
40bcbf41: posts the ante 30
e656985b: posts small blind 100
b2c9556c: posts big blind 200
*** HOLE CARDS ***
Dealt to e656985b 
Dealt to b2c9556c 
Dealt to 4922758c 
Dealt to f0f1afa4 
Dealt to cbb95887 
Dealt to Hero [As 2h]
Dealt to 2aef8583 
Dealt to 40bcbf41 
4922758c: folds
f0f1afa4: folds
cbb95887: raises 200 to 400
Hero: folds
2aef8583: folds
40bcbf41: folds
e656985b: folds
b2c9556c: calls 200
*** FLOP *** [Qd 6s 7s]
b2c9556c: checks
cbb95887: bets 377
b2c9556c: raises 1,573 to 1,950
cbb95887: raises 1,573 to 3,523
b2c9556c: raises 5,127 to 8,650 and is all-in
cbb95887: calls 5,127
b2c9556c: shows [8s 9s] (Queen-High)
cbb95887: shows [7c 7d] (Three Sevens)
*** TURN *** [Qd 6s 7s] [3d]
*** RIVER *** [Qd 6s 7s 3d] [Ks]
*** SHOWDOWN ***
b2c9556c collected 18,440 from pot
*** SUMMARY ***
Total pot 18,440 | Rake 0 | Jackpot 0 | Bingo 0 | Fortune 0 | Tax 0
Board [Qd 6s 7s 3d Ks]
Seat 1: e656985b (small blind) folded before Flop
Seat 2: b2c9556c (big blind) showed [8s 9s] and won (18,440) with King High Flush
Seat 3: 4922758c folded before Flop
Seat 4: f0f1afa4 folded before Flop
Seat 5: cbb95887 showed [7c 7d] and lost with Three Sevens
Seat 6: Hero folded before Flop
Seat 7: 2aef8583 folded before Flop
Seat 8: 40bcbf41 (button) folded before Flop


Poker Hand #TM3524126775: Tournament #155037137, Bounty Hunters Big One $1.08 Hold'em No Limit - Level4(100/200) - 2024/07/27 18:10:39
Table '201' 8-max Seat #7 is the button
Seat 1: e656985b (11,667 in chips)
Seat 2: b2c9556c (9,510 in chips)
Seat 3: 4922758c (16,535 in chips)
Seat 4: f0f1afa4 (10,578 in chips)
Seat 5: cbb95887 (9,970 in chips)
Seat 6: Hero (7,951 in chips)
Seat 7: 2aef8583 (9,531 in chips)
Seat 8: 40bcbf41 (6,514 in chips)
e656985b: posts the ante 30
f0f1afa4: posts the ante 30
4922758c: posts the ante 30
b2c9556c: posts the ante 30
cbb95887: posts the ante 30
2aef8583: posts the ante 30
Hero: posts the ante 30
40bcbf41: posts the ante 30
40bcbf41: posts small blind 100
e656985b: posts big blind 200
*** HOLE CARDS ***
Dealt to e656985b 
Dealt to b2c9556c 
Dealt to 4922758c 
Dealt to f0f1afa4 
Dealt to cbb95887 
Dealt to Hero [2h 2s]
Dealt to 2aef8583 
Dealt to 40bcbf41 
b2c9556c: raises 200 to 400
4922758c: folds
f0f1afa4: folds
cbb95887: folds
Hero: calls 400
2aef8583: folds
40bcbf41: folds
e656985b: folds
*** FLOP *** [7h 7c 3d]
b2c9556c: checks
Hero: bets 7,521 and is all-in
b2c9556c: folds
Uncalled bet (7,521) returned to Hero
Hero: shows [2h 2s] (Pair of Sevens and Pair of Twos)
*** SHOWDOWN ***
Hero collected 1,340 from pot
*** SUMMARY ***
Total pot 1,340 | Rake 0 | Jackpot 0 | Bingo 0 | Fortune 0 | Tax 0
Board [7h 7c 3d]
Seat 1: e656985b (big blind) folded before Flop
Seat 2: b2c9556c folded on the Flop
Seat 3: 4922758c folded before Flop
Seat 4: f0f1afa4 folded before Flop
Seat 5: cbb95887 folded before Flop
Seat 6: Hero showed [2h 2s] and won (1,340)
Seat 7: 2aef8583 (button) folded before Flop
Seat 8: 40bcbf41 (small blind) folded before Flop


Poker Hand #TM3524126742: Tournament #155037137, Bounty Hunters Big One $1.08 Hold'em No Limit - Level4(100/200) - 2024/07/27 18:09:57
Table '201' 8-max Seat #6 is the button
Seat 1: e656985b (11,697 in chips)
Seat 2: b2c9556c (9,540 in chips)
Seat 3: 4922758c (16,565 in chips)
Seat 4: f0f1afa4 (10,608 in chips)
Seat 5: cbb95887 (10,000 in chips)
Seat 6: Hero (7,981 in chips)
Seat 7: 2aef8583 (8,921 in chips)
Seat 8: 40bcbf41 (6,944 in chips)
e656985b: posts the ante 30
f0f1afa4: posts the ante 30
4922758c: posts the ante 30
b2c9556c: posts the ante 30
cbb95887: posts the ante 30
2aef8583: posts the ante 30
Hero: posts the ante 30
40bcbf41: posts the ante 30
2aef8583: posts small blind 100
40bcbf41: posts big blind 200
*** HOLE CARDS ***
Dealt to e656985b 
Dealt to b2c9556c 
Dealt to 4922758c 
Dealt to f0f1afa4 
Dealt to cbb95887 
Dealt to Hero [3s 2s]
Dealt to 2aef8583 
Dealt to 40bcbf41 
e656985b: folds
b2c9556c: folds
4922758c: folds
f0f1afa4: folds
cbb95887: folds
Hero: folds
2aef8583: raises 200 to 400
40bcbf41: calls 200
*** FLOP *** [2c 6s Jd]
2aef8583: bets 344
40bcbf41: folds
Uncalled bet (344) returned to 2aef8583
*** SHOWDOWN ***
2aef8583 collected 1,040 from pot
*** SUMMARY ***
Total pot 1,040 | Rake 0 | Jackpot 0 | Bingo 0 | Fortune 0 | Tax 0
Board [2c 6s Jd]
Seat 1: e656985b folded before Flop
Seat 2: b2c9556c folded before Flop
Seat 3: 4922758c folded before Flop
Seat 4: f0f1afa4 folded before Flop
Seat 5: cbb95887 folded before Flop
Seat 6: Hero (button) folded before Flop
Seat 7: 2aef8583 (small blind) won (1,040)
Seat 8: 40bcbf41 (big blind) folded on the Flop


Poker Hand #TM3524126688: Tournament #155037137, Bounty Hunters Big One $1.08 Hold'em No Limit - Level4(100/200) - 2024/07/27 18:08:57
Table '201' 8-max Seat #4 is the button
Seat 1: e656985b (8,562 in chips)
Seat 2: b2c9556c (9,570 in chips)
Seat 3: 4922758c (19,250 in chips)
Seat 4: f0f1afa4 (10,638 in chips)
Seat 6: Hero (8,111 in chips)
Seat 7: 2aef8583 (9,151 in chips)
Seat 8: 40bcbf41 (6,974 in chips)
e656985b: posts the ante 30
f0f1afa4: posts the ante 30
4922758c: posts the ante 30
b2c9556c: posts the ante 30
2aef8583: posts the ante 30
Hero: posts the ante 30
40bcbf41: posts the ante 30
Hero: posts small blind 100
2aef8583: posts big blind 200
*** HOLE CARDS ***
Dealt to e656985b 
Dealt to b2c9556c 
Dealt to 4922758c 
Dealt to f0f1afa4 
Dealt to Hero [Qd 6d]
Dealt to 2aef8583 
Dealt to 40bcbf41 
40bcbf41: folds
e656985b: raises 200 to 400
b2c9556c: folds
4922758c: raises 800 to 1,200
f0f1afa4: folds
Hero: folds
2aef8583: folds
e656985b: calls 800
*** FLOP *** [Qs 7c 5s]
e656985b: checks
4922758c: bets 1,455
e656985b: calls 1,455
*** TURN *** [Qs 7c 5s] [Ks]
e656985b: checks
4922758c: checks
*** RIVER *** [Qs 7c 5s Ks] [2h]
e656985b: bets 4,365
4922758c: folds
Uncalled bet (4,365) returned to e656985b
*** SHOWDOWN ***
e656985b collected 5,820 from pot
*** SUMMARY ***
Total pot 5,820 | Rake 0 | Jackpot 0 | Bingo 0 | Fortune 0 | Tax 0
Board [Qs 7c 5s Ks 2h]
Seat 1: e656985b won (5,820)
Seat 2: b2c9556c folded before Flop
Seat 3: 4922758c folded on the River
Seat 4: f0f1afa4 (button) folded before Flop
Seat 6: Hero (small blind) folded before Flop
Seat 7: 2aef8583 (big blind) folded before Flop
Seat 8: 40bcbf41 folded before Flop


Poker Hand #TM3524126632: Tournament #155037137, Bounty Hunters Big One $1.08 Hold'em No Limit - Level4(100/200) - 2024/07/27 18:07:52
Table '201' 8-max Seat #3 is the button
Seat 1: e656985b (9,792 in chips)
Seat 2: b2c9556c (10,000 in chips)
Seat 3: 4922758c (17,170 in chips)
Seat 4: f0f1afa4 (10,768 in chips)
Seat 6: Hero (8,341 in chips)
Seat 7: 2aef8583 (9,181 in chips)
Seat 8: 40bcbf41 (7,004 in chips)
e656985b: posts the ante 30
f0f1afa4: posts the ante 30
4922758c: posts the ante 30
b2c9556c: posts the ante 30
2aef8583: posts the ante 30
Hero: posts the ante 30
40bcbf41: posts the ante 30
f0f1afa4: posts small blind 100
Hero: posts big blind 200
*** HOLE CARDS ***
Dealt to e656985b 
Dealt to b2c9556c 
Dealt to 4922758c 
Dealt to f0f1afa4 
Dealt to Hero [8c As]
Dealt to 2aef8583 
Dealt to 40bcbf41 
2aef8583: folds
40bcbf41: folds
e656985b: raises 200 to 400
b2c9556c: calls 400
4922758c: raises 800 to 1,200
f0f1afa4: folds
Hero: folds
e656985b: calls 800
b2c9556c: folds
*** FLOP *** [3s 2s Jd]
e656985b: checks
4922758c: bets 1,655
e656985b: folds
Uncalled bet (1,655) returned to 4922758c
*** SHOWDOWN ***
4922758c collected 3,310 from pot
*** SUMMARY ***
Total pot 3,310 | Rake 0 | Jackpot 0 | Bingo 0 | Fortune 0 | Tax 0
Board [3s 2s Jd]
Seat 1: e656985b folded on the Flop
Seat 2: b2c9556c folded before Flop
Seat 3: 4922758c (button) won (3,310)
Seat 4: f0f1afa4 (small blind) folded before Flop
Seat 6: Hero (big blind) folded before Flop
Seat 7: 2aef8583 folded before Flop
Seat 8: 40bcbf41 folded before Flop


Poker Hand #TM3524126550: Tournament #155037137, Bounty Hunters Big One $1.08 Hold'em No Limit - Level3(80/160) - 2024/07/27 18:06:20
Table '201' 8-max Seat #1 is the button
Seat 1: e656985b (9,816 in chips)
Seat 3: 4922758c (17,274 in chips)
Seat 4: f0f1afa4 (9,904 in chips)
Seat 5: bdd07a0b (5,964 in chips)
Seat 6: Hero (8,365 in chips)
Seat 7: 2aef8583 (9,525 in chips)
Seat 8: 40bcbf41 (7,028 in chips)
e656985b: posts the ante 24
f0f1afa4: posts the ante 24
4922758c: posts the ante 24
bdd07a0b: posts the ante 24
2aef8583: posts the ante 24
Hero: posts the ante 24
40bcbf41: posts the ante 24
4922758c: posts small blind 80
f0f1afa4: posts big blind 160
*** HOLE CARDS ***
Dealt to e656985b 
Dealt to 4922758c 
Dealt to f0f1afa4 
Dealt to bdd07a0b 
Dealt to Hero [7h 9h]
Dealt to 2aef8583 
Dealt to 40bcbf41 
bdd07a0b: raises 160 to 320
Hero: folds
2aef8583: calls 320
40bcbf41: folds
e656985b: folds
4922758c: folds
f0f1afa4: calls 160
*** FLOP *** [6c 7d 8c]
f0f1afa4: checks
bdd07a0b: checks
2aef8583: checks
*** TURN *** [6c 7d 8c] [Ah]
f0f1afa4: checks
bdd07a0b: checks
2aef8583: checks
*** RIVER *** [6c 7d 8c Ah] [5h]
f0f1afa4: checks
bdd07a0b: checks
2aef8583: checks
f0f1afa4: shows [8d Ts] (Pair of Eights)
bdd07a0b: shows [Qh Js] (Ace-High)
2aef8583: shows [2h 2s] (Pair of Twos)
*** SHOWDOWN ***
f0f1afa4 collected 1,208 from pot
*** SUMMARY ***
Total pot 1,208 | Rake 0 | Jackpot 0 | Bingo 0 | Fortune 0 | Tax 0
Board [6c 7d 8c Ah 5h]
Seat 1: e656985b (button) folded before Flop
Seat 3: 4922758c (small blind) folded before Flop
Seat 4: f0f1afa4 (big blind) showed [8d Ts] and won (1,208) with Pair of Eights
Seat 5: bdd07a0b showed [Qh Js] and lost with Ace-High
Seat 6: Hero folded before Flop
Seat 7: 2aef8583 showed [2h 2s] and lost with Pair of Twos
Seat 8: 40bcbf41 folded before Flop


Poker Hand #TM3524126516: Tournament #155037137, Bounty Hunters Big One $1.08 Hold'em No Limit - Level3(80/160) - 2024/07/27 18:05:38
Table '201' 8-max Seat #8 is the button
Seat 1: e656985b (10,000 in chips)
Seat 3: 4922758c (16,810 in chips)
Seat 4: f0f1afa4 (9,928 in chips)
Seat 5: bdd07a0b (5,988 in chips)
Seat 6: Hero (8,389 in chips)
Seat 7: 2aef8583 (9,549 in chips)
Seat 8: 40bcbf41 (7,212 in chips)
e656985b: posts the ante 24
f0f1afa4: posts the ante 24
4922758c: posts the ante 24
bdd07a0b: posts the ante 24
2aef8583: posts the ante 24
Hero: posts the ante 24
40bcbf41: posts the ante 24
e656985b: posts small blind 80
4922758c: posts big blind 160
*** HOLE CARDS ***
Dealt to e656985b 
Dealt to 4922758c 
Dealt to f0f1afa4 
Dealt to bdd07a0b 
Dealt to Hero [Qd 6h]
Dealt to 2aef8583 
Dealt to 40bcbf41 
f0f1afa4: folds
bdd07a0b: folds
Hero: folds
2aef8583: folds
40bcbf41: calls 160
e656985b: calls 80
4922758c: raises 640 to 800
40bcbf41: folds
e656985b: folds
Uncalled bet (640) returned to 4922758c
*** SHOWDOWN ***
4922758c collected 648 from pot
*** SUMMARY ***
Total pot 648 | Rake 0 | Jackpot 0 | Bingo 0 | Fortune 0 | Tax 0
Seat 1: e656985b (small blind) folded before Flop
Seat 3: 4922758c (big blind) collected (648)
Seat 4: f0f1afa4 folded before Flop
Seat 5: bdd07a0b folded before Flop
Seat 6: Hero folded before Flop
Seat 7: 2aef8583 folded before Flop
Seat 8: 40bcbf41 (button) folded before Flop


Poker Hand #TM3524422063: Tournament #155037137, Bounty Hunters Big One $1.08 Hold'em No Limit - Level3(80/160) - 2024/07/27 18:04:39
Table '162' 8-max Seat #1 is the button
Seat 1: 3bbfd86b (14,446 in chips)
Seat 2: 3704de53 (11,922 in chips)
Seat 3: 55a3d9bc (20,520 in chips)
Seat 4: Hero (8,413 in chips)
Seat 5: 1f55d323 (11,594 in chips)
Seat 6: 30b46f1d (13,910 in chips)
Seat 7: 2f44b23f (13,929 in chips)
Seat 8: 48f88ba5 (3,828 in chips)
3704de53: posts the ante 24
48f88ba5: posts the ante 24
3bbfd86b: posts the ante 24
30b46f1d: posts the ante 24
1f55d323: posts the ante 24
2f44b23f: posts the ante 24
Hero: posts the ante 24
55a3d9bc: posts the ante 24
3704de53: posts small blind 80
55a3d9bc: posts big blind 160
*** HOLE CARDS ***
Dealt to 3bbfd86b 
Dealt to 3704de53 
Dealt to 55a3d9bc 
Dealt to Hero [9h Td]
Dealt to 1f55d323 
Dealt to 30b46f1d 
Dealt to 2f44b23f 
Dealt to 48f88ba5 
Hero: folds
1f55d323: folds
30b46f1d: folds
2f44b23f: raises 160 to 320
48f88ba5: folds
3bbfd86b: calls 320
3704de53: folds
55a3d9bc: folds
*** FLOP *** [6d Js Qd]
2f44b23f: checks
3bbfd86b: checks
*** TURN *** [6d Js Qd] [6h]
2f44b23f: bets 354
3bbfd86b: calls 354
*** RIVER *** [6d Js Qd 6h] [8d]
2f44b23f: checks
3bbfd86b: bets 890
2f44b23f: calls 890
3bbfd86b: shows [3s 6s] (Three Sixes)
2f44b23f: shows [Kh Jh] (Pair of Jacks and Pair of Sixes)
*** SHOWDOWN ***
3bbfd86b collected 3,560 from pot
*** SUMMARY ***
Total pot 3,560 | Rake 0 | Jackpot 0 | Bingo 0 | Fortune 0 | Tax 0
Board [6d Js Qd 6h 8d]
Seat 1: 3bbfd86b (button) showed [3s 6s] and won (3,560) with Three Sixes
Seat 2: 3704de53 (small blind) folded before Flop
Seat 3: 55a3d9bc (big blind) folded before Flop
Seat 4: Hero folded before Flop
Seat 5: 1f55d323 folded before Flop
Seat 6: 30b46f1d folded before Flop
Seat 7: 2f44b23f showed [Kh Jh] and lost with Pair of Jacks and Pair of Sixes
Seat 8: 48f88ba5 folded before Flop


Poker Hand #TM3524422015: Tournament #155037137, Bounty Hunters Big One $1.08 Hold'em No Limit - Level3(80/160) - 2024/07/27 18:03:39
Table '162' 8-max Seat #8 is the button
Seat 1: 3bbfd86b (13,736 in chips)
Seat 2: 3704de53 (12,106 in chips)
Seat 3: 55a3d9bc (20,544 in chips)
Seat 4: Hero (8,819 in chips)
Seat 5: 1f55d323 (11,618 in chips)
Seat 6: 30b46f1d (13,934 in chips)
Seat 7: 2f44b23f (13,953 in chips)
Seat 8: 48f88ba5 (3,852 in chips)
3704de53: posts the ante 24
48f88ba5: posts the ante 24
3bbfd86b: posts the ante 24
30b46f1d: posts the ante 24
1f55d323: posts the ante 24
2f44b23f: posts the ante 24
Hero: posts the ante 24
55a3d9bc: posts the ante 24
3bbfd86b: posts small blind 80
3704de53: posts big blind 160
*** HOLE CARDS ***
Dealt to 3bbfd86b 
Dealt to 3704de53 
Dealt to 55a3d9bc 
Dealt to Hero [Th 8h]
Dealt to 1f55d323 
Dealt to 30b46f1d 
Dealt to 2f44b23f 
Dealt to 48f88ba5 
55a3d9bc: folds
Hero: calls 160
1f55d323: folds
30b46f1d: folds
2f44b23f: folds
48f88ba5: folds
3bbfd86b: calls 80
3704de53: checks
*** FLOP *** [Ah 5h Jd]
3bbfd86b: checks
3704de53: checks
Hero: bets 222
3bbfd86b: calls 222
3704de53: folds
*** TURN *** [Ah 5h Jd] [Kc]
3bbfd86b: checks
Hero: checks
*** RIVER *** [Ah 5h Jd Kc] [9d]
3bbfd86b: bets 558
Hero: folds
Uncalled bet (558) returned to 3bbfd86b
*** SHOWDOWN ***
3bbfd86b collected 1,116 from pot
*** SUMMARY ***
Total pot 1,116 | Rake 0 | Jackpot 0 | Bingo 0 | Fortune 0 | Tax 0
Board [Ah 5h Jd Kc 9d]
Seat 1: 3bbfd86b (small blind) won (1,116)
Seat 2: 3704de53 (big blind) folded on the Flop
Seat 3: 55a3d9bc folded before Flop
Seat 4: Hero folded on the River
Seat 5: 1f55d323 folded before Flop
Seat 6: 30b46f1d folded before Flop
Seat 7: 2f44b23f folded before Flop
Seat 8: 48f88ba5 (button) folded before Flop


Poker Hand #TM3524421943: Tournament #155037137, Bounty Hunters Big One $1.08 Hold'em No Limit - Level3(80/160) - 2024/07/27 18:01:57
Table '162' 8-max Seat #7 is the button
Seat 1: 3bbfd86b (15,138 in chips)
Seat 2: 3704de53 (10,480 in chips)
Seat 3: 55a3d9bc (20,568 in chips)
Seat 4: Hero (8,843 in chips)
Seat 5: 1f55d323 (11,642 in chips)
Seat 6: 30b46f1d (13,958 in chips)
Seat 7: 2f44b23f (13,977 in chips)
Seat 8: 48f88ba5 (3,956 in chips)
3704de53: posts the ante 24
48f88ba5: posts the ante 24
3bbfd86b: posts the ante 24
30b46f1d: posts the ante 24
1f55d323: posts the ante 24
2f44b23f: posts the ante 24
Hero: posts the ante 24
55a3d9bc: posts the ante 24
48f88ba5: posts small blind 80
3bbfd86b: posts big blind 160
*** HOLE CARDS ***
Dealt to 3bbfd86b 
Dealt to 3704de53 
Dealt to 55a3d9bc 
Dealt to Hero [8s 6c]
Dealt to 1f55d323 
Dealt to 30b46f1d 
Dealt to 2f44b23f 
Dealt to 48f88ba5 
3704de53: raises 160 to 320
55a3d9bc: folds
Hero: folds
1f55d323: folds
30b46f1d: folds
2f44b23f: folds
48f88ba5: folds
3bbfd86b: calls 160
*** FLOP *** [3s Kc Ts]
3bbfd86b: bets 456
3704de53: calls 456
*** TURN *** [3s Kc Ts] [Ah]
3bbfd86b: bets 602
3704de53: raises 1,638 to 2,240
3bbfd86b: folds
Uncalled bet (1,638) returned to 3704de53
*** SHOWDOWN ***
3704de53 collected 3,028 from pot
*** SUMMARY ***
Total pot 3,028 | Rake 0 | Jackpot 0 | Bingo 0 | Fortune 0 | Tax 0
Board [3s Kc Ts Ah]
Seat 1: 3bbfd86b (big blind) folded on the Turn
Seat 2: 3704de53 won (3,028)
Seat 3: 55a3d9bc folded before Flop
Seat 4: Hero folded before Flop
Seat 5: 1f55d323 folded before Flop
Seat 6: 30b46f1d folded before Flop
Seat 7: 2f44b23f (button) folded before Flop
Seat 8: 48f88ba5 (small blind) folded before Flop


Poker Hand #TM3524421887: Tournament #155037137, Bounty Hunters Big One $1.08 Hold'em No Limit - Level3(80/160) - 2024/07/27 17:54:53
Table '162' 8-max Seat #6 is the button
Seat 1: 3bbfd86b (15,162 in chips)
Seat 2: 3704de53 (10,504 in chips)
Seat 3: 55a3d9bc (9,772 in chips)
Seat 4: Hero (9,187 in chips)
Seat 5: 1f55d323 (21,414 in chips)
Seat 6: 30b46f1d (14,302 in chips)
Seat 7: 2f44b23f (14,081 in chips)
Seat 8: 48f88ba5 (4,140 in chips)
3704de53: posts the ante 24
48f88ba5: posts the ante 24
3bbfd86b: posts the ante 24
30b46f1d: posts the ante 24
1f55d323: posts the ante 24
2f44b23f: posts the ante 24
Hero: posts the ante 24
55a3d9bc: posts the ante 24
2f44b23f: posts small blind 80
48f88ba5: posts big blind 160
*** HOLE CARDS ***
Dealt to 3bbfd86b 
Dealt to 3704de53 
Dealt to 55a3d9bc 
Dealt to Hero [Jd 8d]
Dealt to 1f55d323 
Dealt to 30b46f1d 
Dealt to 2f44b23f 
Dealt to 48f88ba5 
3bbfd86b: folds
3704de53: folds
55a3d9bc: raises 160 to 320
Hero: calls 320
1f55d323: calls 320
30b46f1d: calls 320
2f44b23f: folds
48f88ba5: folds
*** FLOP *** [Kh 7d 4h]
55a3d9bc: bets 480
Hero: folds
1f55d323: raises 2,004 to 2,484
30b46f1d: folds
55a3d9bc: calls 2,004
*** TURN *** [Kh 7d 4h] [8s]
55a3d9bc: bets 800
1f55d323: raises 8,280 to 9,080
55a3d9bc: calls 6,144 and is all-in
Uncalled bet (2,136) returned to 1f55d323
1f55d323: shows [Kd Qh] (Pair of Kings)
55a3d9bc: shows [5d 6d] (Eights-High Straight)
*** RIVER *** [Kh 7d 4h 8s] [9c]
*** SHOWDOWN ***
55a3d9bc collected 20,568 from pot
*** SUMMARY ***
Total pot 20,568 | Rake 0 | Jackpot 0 | Bingo 0 | Fortune 0 | Tax 0
Board [Kh 7d 4h 8s 9c]
Seat 1: 3bbfd86b folded before Flop
Seat 2: 3704de53 folded before Flop
Seat 3: 55a3d9bc showed [5d 6d] and won (20,568) with Nines-High Straight
Seat 4: Hero folded on the Flop
Seat 5: 1f55d323 showed [Kd Qh] and lost with Pair of Kings
Seat 6: 30b46f1d (button) folded on the Flop
Seat 7: 2f44b23f (small blind) folded before Flop
Seat 8: 48f88ba5 (big blind) folded before Flop


Poker Hand #TM3524421848: Tournament #155037137, Bounty Hunters Big One $1.08 Hold'em No Limit - Level3(80/160) - 2024/07/27 17:53:54
Table '162' 8-max Seat #5 is the button
Seat 1: 3bbfd86b (16,642 in chips)
Seat 2: 3704de53 (10,528 in chips)
Seat 3: 55a3d9bc (9,796 in chips)
Seat 4: Hero (9,211 in chips)
Seat 5: 1f55d323 (21,438 in chips)
Seat 6: 30b46f1d (11,062 in chips)
Seat 7: 2f44b23f (14,265 in chips)
Seat 8: 48f88ba5 (5,620 in chips)
3704de53: posts the ante 24
48f88ba5: posts the ante 24
3bbfd86b: posts the ante 24
30b46f1d: posts the ante 24
1f55d323: posts the ante 24
2f44b23f: posts the ante 24
Hero: posts the ante 24
55a3d9bc: posts the ante 24
30b46f1d: posts small blind 80
2f44b23f: posts big blind 160
*** HOLE CARDS ***
Dealt to 3bbfd86b 
Dealt to 3704de53 
Dealt to 55a3d9bc 
Dealt to Hero [8d 6d]
Dealt to 1f55d323 
Dealt to 30b46f1d 
Dealt to 2f44b23f 
Dealt to 48f88ba5 
48f88ba5: raises 192 to 352
3bbfd86b: calls 352
3704de53: folds
55a3d9bc: folds
Hero: folds
1f55d323: folds
30b46f1d: calls 272
2f44b23f: folds
*** FLOP *** [Jd Ad 9h]
30b46f1d: checks
48f88ba5: checks
3bbfd86b: checks
*** TURN *** [Jd Ad 9h] [Jc]
30b46f1d: bets 160
48f88ba5: calls 160
3bbfd86b: calls 160
*** RIVER *** [Jd Ad 9h Jc] [Ks]
30b46f1d: bets 944
48f88ba5: calls 944
3bbfd86b: calls 944
30b46f1d: shows [Ac Js] (Jacks Full over Aces)
48f88ba5: shows [As 9s] (Pair of Aces and Pair of Jacks)
3bbfd86b: shows [Qh Tc] (Aces-High Straight)
*** SHOWDOWN ***
30b46f1d collected 4,720 from pot
*** SUMMARY ***
Total pot 4,720 | Rake 0 | Jackpot 0 | Bingo 0 | Fortune 0 | Tax 0
Board [Jd Ad 9h Jc Ks]
Seat 1: 3bbfd86b showed [Qh Tc] and lost with Aces-High Straight
Seat 2: 3704de53 folded before Flop
Seat 3: 55a3d9bc folded before Flop
Seat 4: Hero folded before Flop
Seat 5: 1f55d323 (button) folded before Flop
Seat 6: 30b46f1d (small blind) showed [Ac Js] and won (4,720) with Jacks Full over Aces
Seat 7: 2f44b23f (big blind) folded before Flop
Seat 8: 48f88ba5 showed [As 9s] and lost with Pair of Aces and Pair of Jacks


Poker Hand #TM3524421809: Tournament #155037137, Bounty Hunters Big One $1.08 Hold'em No Limit - Level3(80/160) - 2024/07/27 17:52:47
Table '162' 8-max Seat #4 is the button
Seat 1: 3bbfd86b (16,986 in chips)
Seat 2: 3704de53 (11,688 in chips)
Seat 3: 55a3d9bc (9,820 in chips)
Seat 4: Hero (9,235 in chips)
Seat 5: 1f55d323 (19,334 in chips)
Seat 6: 30b46f1d (11,246 in chips)
Seat 7: 2f44b23f (14,289 in chips)
Seat 8: 48f88ba5 (5,964 in chips)
3704de53: posts the ante 24
48f88ba5: posts the ante 24
3bbfd86b: posts the ante 24
30b46f1d: posts the ante 24
1f55d323: posts the ante 24
2f44b23f: posts the ante 24
Hero: posts the ante 24
55a3d9bc: posts the ante 24
1f55d323: posts small blind 80
30b46f1d: posts big blind 160
*** HOLE CARDS ***
Dealt to 3bbfd86b 
Dealt to 3704de53 
Dealt to 55a3d9bc 
Dealt to Hero [8h 2d]
Dealt to 1f55d323 
Dealt to 30b46f1d 
Dealt to 2f44b23f 
Dealt to 48f88ba5 
2f44b23f: folds
48f88ba5: calls 160
3bbfd86b: raises 160 to 320
3704de53: calls 320
55a3d9bc: folds
Hero: folds
1f55d323: calls 240
30b46f1d: folds
48f88ba5: calls 160
*** FLOP *** [Jh 7s 5c]
1f55d323: checks
48f88ba5: checks
3bbfd86b: checks
3704de53: checks
*** TURN *** [Jh 7s 5c] [Jc]
1f55d323: checks
48f88ba5: checks
3bbfd86b: checks
3704de53: checks
*** RIVER *** [Jh 7s 5c Jc] [8s]
1f55d323: bets 816
48f88ba5: folds
3bbfd86b: folds
3704de53: calls 816
1f55d323: shows [6d 4s] (Eights-High Straight)
3704de53: shows [6c 6s] (Pair of Jacks and Pair of Sixes)
*** SHOWDOWN ***
1f55d323 collected 3,264 from pot
*** SUMMARY ***
Total pot 3,264 | Rake 0 | Jackpot 0 | Bingo 0 | Fortune 0 | Tax 0
Board [Jh 7s 5c Jc 8s]
Seat 1: 3bbfd86b folded on the River
Seat 2: 3704de53 showed [6c 6s] and lost with Pair of Jacks and Pair of Sixes
Seat 3: 55a3d9bc folded before Flop
Seat 4: Hero (button) folded before Flop
Seat 5: 1f55d323 (small blind) showed [6d 4s] and won (3,264) with Eights-High Straight
Seat 6: 30b46f1d (big blind) folded before Flop
Seat 7: 2f44b23f folded before Flop
Seat 8: 48f88ba5 folded on the River


Poker Hand #TM3524421774: Tournament #155037137, Bounty Hunters Big One $1.08 Hold'em No Limit - Level3(80/160) - 2024/07/27 17:51:53
Table '162' 8-max Seat #3 is the button
Seat 1: 3bbfd86b (17,330 in chips)
Seat 2: 3704de53 (10,000 in chips)
Seat 3: 55a3d9bc (9,844 in chips)
Seat 4: Hero (9,339 in chips)
Seat 5: 1f55d323 (20,478 in chips)
Seat 6: 947a1fef (6,696 in chips)
Seat 7: 2f44b23f (14,313 in chips)
Seat 8: 48f88ba5 (5,988 in chips)
3704de53: posts the ante 24
947a1fef: posts the ante 24
48f88ba5: posts the ante 24
3bbfd86b: posts the ante 24
1f55d323: posts the ante 24
2f44b23f: posts the ante 24
Hero: posts the ante 24
55a3d9bc: posts the ante 24
Hero: posts small blind 80
1f55d323: posts big blind 160
*** HOLE CARDS ***
Dealt to 3bbfd86b 
Dealt to 3704de53 
Dealt to 55a3d9bc 
Dealt to Hero [4c Ts]
Dealt to 1f55d323 
Dealt to 947a1fef 
Dealt to 2f44b23f 
Dealt to 48f88ba5 
947a1fef: folds
2f44b23f: folds
48f88ba5: folds
3bbfd86b: raises 160 to 320
3704de53: raises 800 to 1,120
55a3d9bc: folds
Hero: folds
1f55d323: calls 960
3bbfd86b: folds
*** FLOP *** [2s Kc Td]
1f55d323: checks
3704de53: bets 935
1f55d323: folds
Uncalled bet (935) returned to 3704de53
*** SHOWDOWN ***
3704de53 collected 2,832 from pot
*** SUMMARY ***
Total pot 2,832 | Rake 0 | Jackpot 0 | Bingo 0 | Fortune 0 | Tax 0
Board [2s Kc Td]
Seat 1: 3bbfd86b folded before Flop
Seat 2: 3704de53 won (2,832)
Seat 3: 55a3d9bc (button) folded before Flop
Seat 4: Hero (small blind) folded before Flop
Seat 5: 1f55d323 (big blind) folded on the Flop
Seat 6: 947a1fef folded before Flop
Seat 7: 2f44b23f folded before Flop
Seat 8: 48f88ba5 folded before Flop


Poker Hand #TM3524421732: Tournament #155037137, Bounty Hunters Big One $1.08 Hold'em No Limit - Level3(80/160) - 2024/07/27 17:50:47
Table '162' 8-max Seat #1 is the button
Seat 1: 3bbfd86b (17,354 in chips)
Seat 3: 55a3d9bc (9,948 in chips)
Seat 4: Hero (9,683 in chips)
Seat 5: 1f55d323 (20,822 in chips)
Seat 6: 947a1fef (9,270 in chips)
Seat 7: 2f44b23f (14,337 in chips)
Seat 8: 48f88ba5 (2,574 in chips)
947a1fef: posts the ante 24
48f88ba5: posts the ante 24
3bbfd86b: posts the ante 24
1f55d323: posts the ante 24
2f44b23f: posts the ante 24
Hero: posts the ante 24
55a3d9bc: posts the ante 24
55a3d9bc: posts small blind 80
Hero: posts big blind 160
*** HOLE CARDS ***
Dealt to 3bbfd86b 
Dealt to 55a3d9bc 
Dealt to Hero [3h Qd]
Dealt to 1f55d323 
Dealt to 947a1fef 
Dealt to 2f44b23f 
Dealt to 48f88ba5 
1f55d323: raises 160 to 320
947a1fef: calls 320
2f44b23f: folds
48f88ba5: calls 320
3bbfd86b: folds
55a3d9bc: folds
Hero: calls 160
*** FLOP *** [6h 5s As]
Hero: checks
1f55d323: checks
947a1fef: checks
48f88ba5: checks
*** TURN *** [6h 5s As] [8h]
Hero: checks
1f55d323: checks
947a1fef: bets 413
48f88ba5: raises 1,817 to 2,230 and is all-in
Hero: folds
1f55d323: folds
947a1fef: calls 1,817
48f88ba5: shows [8c 5h] (Pair of Eights and Pair of Fives)
947a1fef: shows [Ad Tc] (Pair of Aces)
*** RIVER *** [6h 5s As 8h] [3s]
*** SHOWDOWN ***
48f88ba5 collected 5,988 from pot
*** SUMMARY ***
Total pot 5,988 | Rake 0 | Jackpot 0 | Bingo 0 | Fortune 0 | Tax 0
Board [6h 5s As 8h 3s]
Seat 1: 3bbfd86b (button) folded before Flop
Seat 3: 55a3d9bc (small blind) folded before Flop
Seat 4: Hero (big blind) folded on the Turn
Seat 5: 1f55d323 folded on the Turn
Seat 6: 947a1fef showed [Ad Tc] and lost with Pair of Aces
Seat 7: 2f44b23f folded before Flop
Seat 8: 48f88ba5 showed [8c 5h] and won (5,988) with Pair of Eights and Pair of Fives


Poker Hand #TM3524421722: Tournament #155037137, Bounty Hunters Big One $1.08 Hold'em No Limit - Level3(80/160) - 2024/07/27 17:50:32
Table '162' 8-max Seat #8 is the button
Seat 1: 3bbfd86b (17,458 in chips)
Seat 3: 55a3d9bc (9,724 in chips)
Seat 4: Hero (9,707 in chips)
Seat 5: 1f55d323 (20,846 in chips)
Seat 6: 947a1fef (9,294 in chips)
Seat 7: 2f44b23f (14,361 in chips)
Seat 8: 48f88ba5 (2,598 in chips)
947a1fef: posts the ante 24
48f88ba5: posts the ante 24
3bbfd86b: posts the ante 24
1f55d323: posts the ante 24
2f44b23f: posts the ante 24
Hero: posts the ante 24
55a3d9bc: posts the ante 24
3bbfd86b: posts small blind 80
55a3d9bc: posts big blind 160
*** HOLE CARDS ***
Dealt to 3bbfd86b 
Dealt to 55a3d9bc 
Dealt to Hero [As 8h]
Dealt to 1f55d323 
Dealt to 947a1fef 
Dealt to 2f44b23f 
Dealt to 48f88ba5 
Hero: folds
1f55d323: folds
947a1fef: folds
2f44b23f: folds
48f88ba5: folds
3bbfd86b: folds
Uncalled bet (80) returned to 55a3d9bc
*** SHOWDOWN ***
55a3d9bc collected 328 from pot
*** SUMMARY ***
Total pot 328 | Rake 0 | Jackpot 0 | Bingo 0 | Fortune 0 | Tax 0
Seat 1: 3bbfd86b (small blind) folded before Flop
Seat 3: 55a3d9bc (big blind) collected (328)
Seat 4: Hero folded before Flop
Seat 5: 1f55d323 folded before Flop
Seat 6: 947a1fef folded before Flop
Seat 7: 2f44b23f folded before Flop
Seat 8: 48f88ba5 (button) folded before Flop


Poker Hand #TM3524421680: Tournament #155037137, Bounty Hunters Big One $1.08 Hold'em No Limit - Level2(60/120) - 2024/07/27 17:49:35
Table '162' 8-max Seat #7 is the button
Seat 1: 3bbfd86b (8,302 in chips)
Seat 2: 4cb8e8fd (9,964 in chips)
Seat 3: 55a3d9bc (9,982 in chips)
Seat 4: Hero (10,231 in chips)
Seat 5: 1f55d323 (20,864 in chips)
Seat 6: 947a1fef (9,312 in chips)
Seat 7: 2f44b23f (14,379 in chips)
Seat 8: 48f88ba5 (10,900 in chips)
947a1fef: posts the ante 18
48f88ba5: posts the ante 18
3bbfd86b: posts the ante 18
1f55d323: posts the ante 18
2f44b23f: posts the ante 18
4cb8e8fd: posts the ante 18
Hero: posts the ante 18
55a3d9bc: posts the ante 18
48f88ba5: posts small blind 60
3bbfd86b: posts big blind 120
*** HOLE CARDS ***
Dealt to 3bbfd86b 
Dealt to 4cb8e8fd 
Dealt to 55a3d9bc 
Dealt to Hero [Jc Ac]
Dealt to 1f55d323 
Dealt to 947a1fef 
Dealt to 2f44b23f 
Dealt to 48f88ba5 
4cb8e8fd: folds
55a3d9bc: raises 120 to 240
Hero: raises 266 to 506
1f55d323: folds
947a1fef: folds
2f44b23f: folds
48f88ba5: raises 1,294 to 1,800
3bbfd86b: raises 6,484 to 8,284 and is all-in
55a3d9bc: folds
Hero: folds
48f88ba5: calls 6,484
3bbfd86b: shows [Td Ts]
48f88ba5: shows [Jd Jh]
*** FLOP *** [Tc 4h 6s]
*** TURN *** [Tc 4h 6s] [3d]
*** RIVER *** [Tc 4h 6s 3d] [2d]
Hero: shows [Jc Ac] (Ace-High)
*** SHOWDOWN ***
3bbfd86b collected 17,458 from pot
*** SUMMARY ***
Total pot 17,458 | Rake 0 | Jackpot 0 | Bingo 0 | Fortune 0 | Tax 0
Board [Tc 4h 6s 3d 2d]
Seat 1: 3bbfd86b (big blind) showed [Td Ts] and won (17,458) with Three Tens
Seat 2: 4cb8e8fd folded before Flop
Seat 3: 55a3d9bc folded before Flop
Seat 4: Hero folded before Flop
Seat 5: 1f55d323 folded before Flop
Seat 6: 947a1fef folded before Flop
Seat 7: 2f44b23f (button) folded before Flop
Seat 8: 48f88ba5 (small blind) showed [Jd Jh] and lost with Pair of Jacks


Poker Hand #TM3524421636: Tournament #155037137, Bounty Hunters Big One $1.08 Hold'em No Limit - Level2(60/120) - 2024/07/27 17:48:30
Table '162' 8-max Seat #6 is the button
Seat 1: 3bbfd86b (9,982 in chips)
Seat 2: 4cb8e8fd (9,982 in chips)
Seat 3: 55a3d9bc (10,000 in chips)
Seat 4: Hero (10,249 in chips)
Seat 5: 1f55d323 (20,882 in chips)
Seat 6: 947a1fef (9,330 in chips)
Seat 7: 2f44b23f (14,457 in chips)
Seat 8: 48f88ba5 (9,052 in chips)
947a1fef: posts the ante 18
48f88ba5: posts the ante 18
3bbfd86b: posts the ante 18
1f55d323: posts the ante 18
4cb8e8fd: posts the ante 18
2f44b23f: posts the ante 18
Hero: posts the ante 18
55a3d9bc: posts the ante 18
2f44b23f: posts small blind 60
48f88ba5: posts big blind 120
*** HOLE CARDS ***
Dealt to 3bbfd86b 
Dealt to 4cb8e8fd 
Dealt to 55a3d9bc 
Dealt to Hero [8d 3c]
Dealt to 1f55d323 
Dealt to 947a1fef 
Dealt to 2f44b23f 
Dealt to 48f88ba5 
3bbfd86b: calls 120
4cb8e8fd: folds
55a3d9bc: folds
Hero: folds
1f55d323: folds
947a1fef: folds
2f44b23f: folds
48f88ba5: raises 240 to 360
3bbfd86b: calls 240
*** FLOP *** [9d Jh 8h]
48f88ba5: bets 300
3bbfd86b: calls 300
*** TURN *** [9d Jh 8h] [4c]
48f88ba5: bets 120
3bbfd86b: raises 882 to 1,002
48f88ba5: calls 882
*** RIVER *** [9d Jh 8h 4c] [Qh]
48f88ba5: bets 1,200
3bbfd86b: folds
Uncalled bet (1,200) returned to 48f88ba5
*** SHOWDOWN ***
48f88ba5 collected 3,528 from pot
*** SUMMARY ***
Total pot 3,528 | Rake 0 | Jackpot 0 | Bingo 0 | Fortune 0 | Tax 0
Board [9d Jh 8h 4c Qh]
Seat 1: 3bbfd86b folded on the River
Seat 2: 4cb8e8fd folded before Flop
Seat 3: 55a3d9bc folded before Flop
Seat 4: Hero folded before Flop
Seat 5: 1f55d323 folded before Flop
Seat 6: 947a1fef (button) folded before Flop
Seat 7: 2f44b23f (small blind) folded before Flop
Seat 8: 48f88ba5 (big blind) won (3,528)


Poker Hand #TM3524312961: Tournament #155037137, Bounty Hunters Big One $1.08 Hold'em No Limit - Level2(60/120) - 2024/07/27 17:46:33
Table '16' 8-max Seat #3 is the button
Seat 1: 36fddff7 (11,280 in chips)
Seat 2: 66939f17 (15,792 in chips)
Seat 3: 52fbc93d (8,765 in chips)
Seat 4: ac68c783 (8,719 in chips)
Seat 5: d9bef9a (10,989 in chips)
Seat 6: c724a38e (7,952 in chips)
Seat 7: ed2c2257 (17,453 in chips)
Seat 8: Hero (8,700 in chips)
d9bef9a: posts the ante 18
52fbc93d: posts the ante 18
66939f17: posts the ante 18
36fddff7: posts the ante 18
ed2c2257: posts the ante 18
c724a38e: posts the ante 18
Hero: posts the ante 18
ac68c783: posts the ante 18
ac68c783: posts small blind 60
d9bef9a: posts big blind 120
*** HOLE CARDS ***
Dealt to 36fddff7 
Dealt to 66939f17 
Dealt to 52fbc93d 
Dealt to ac68c783 
Dealt to d9bef9a 
Dealt to c724a38e 
Dealt to ed2c2257 
Dealt to Hero [Jd Ad]
c724a38e: folds
ed2c2257: folds
Hero: raises 180 to 300
36fddff7: folds
66939f17: folds
52fbc93d: folds
ac68c783: calls 240
d9bef9a: folds
*** FLOP *** [As 4s 2d]
ac68c783: bets 432
Hero: calls 432
*** TURN *** [As 4s 2d] [6s]
ac68c783: checks
Hero: bets 571
ac68c783: calls 571
*** RIVER *** [As 4s 2d 6s] [4d]
ac68c783: checks
Hero: checks
ac68c783: shows [Ah Td] (Pair of Aces and Pair of Fours)
Hero: shows [Jd Ad] (Pair of Aces and Pair of Fours)
*** SHOWDOWN ***
Hero collected 2,870 from pot
*** SUMMARY ***
Total pot 2,870 | Rake 0 | Jackpot 0 | Bingo 0 | Fortune 0 | Tax 0
Board [As 4s 2d 6s 4d]
Seat 1: 36fddff7 folded before Flop
Seat 2: 66939f17 folded before Flop
Seat 3: 52fbc93d (button) folded before Flop
Seat 4: ac68c783 (small blind) showed [Ah Td] and lost with Pair of Aces and Pair of Fours
Seat 5: d9bef9a (big blind) folded before Flop
Seat 6: c724a38e folded before Flop
Seat 7: ed2c2257 folded before Flop
Seat 8: Hero showed [Jd Ad] and won (2,870) with Pair of Aces and Pair of Fours


Poker Hand #TM3524312925: Tournament #155037137, Bounty Hunters Big One $1.08 Hold'em No Limit - Level2(60/120) - 2024/07/27 17:45:34
Table '16' 8-max Seat #2 is the button
Seat 1: 36fddff7 (11,298 in chips)
Seat 2: 66939f17 (15,810 in chips)
Seat 3: 52fbc93d (8,843 in chips)
Seat 4: ac68c783 (8,857 in chips)
Seat 5: d9bef9a (11,007 in chips)
Seat 6: c724a38e (11,407 in chips)
Seat 7: ed2c2257 (13,710 in chips)
Seat 8: Hero (8,718 in chips)
d9bef9a: posts the ante 18
52fbc93d: posts the ante 18
66939f17: posts the ante 18
36fddff7: posts the ante 18
ed2c2257: posts the ante 18
c724a38e: posts the ante 18
Hero: posts the ante 18
ac68c783: posts the ante 18
52fbc93d: posts small blind 60
ac68c783: posts big blind 120
*** HOLE CARDS ***
Dealt to 36fddff7 
Dealt to 66939f17 
Dealt to 52fbc93d 
Dealt to ac68c783 
Dealt to d9bef9a 
Dealt to c724a38e 
Dealt to ed2c2257 
Dealt to Hero [Kd 2c]
d9bef9a: folds
c724a38e: raises 240 to 360
ed2c2257: calls 360
Hero: folds
36fddff7: folds
66939f17: folds
52fbc93d: folds
ac68c783: folds
*** FLOP *** [4h Js 3h]
c724a38e: bets 345
ed2c2257: calls 345
*** TURN *** [4h Js 3h] [9d]
c724a38e: bets 1,301
ed2c2257: raises 1,431 to 2,732
c724a38e: calls 1,431
*** RIVER *** [4h Js 3h 9d] [2s]
c724a38e: checks
ed2c2257: bets 2,376
c724a38e: folds
Uncalled bet (2,376) returned to ed2c2257
ed2c2257: shows [8d Ad] (Ace-High)
*** SHOWDOWN ***
ed2c2257 collected 7,198 from pot
*** SUMMARY ***
Total pot 7,198 | Rake 0 | Jackpot 0 | Bingo 0 | Fortune 0 | Tax 0
Board [4h Js 3h 9d 2s]
Seat 1: 36fddff7 folded before Flop
Seat 2: 66939f17 (button) folded before Flop
Seat 3: 52fbc93d (small blind) folded before Flop
Seat 4: ac68c783 (big blind) folded before Flop
Seat 5: d9bef9a folded before Flop
Seat 6: c724a38e folded on the River
Seat 7: ed2c2257 showed [8d Ad] and won (7,198)
Seat 8: Hero folded before Flop


Poker Hand #TM3524312896: Tournament #155037137, Bounty Hunters Big One $1.08 Hold'em No Limit - Level2(60/120) - 2024/07/27 17:44:50
Table '16' 8-max Seat #1 is the button
Seat 1: 36fddff7 (11,316 in chips)
Seat 2: 66939f17 (15,888 in chips)
Seat 3: 52fbc93d (8,981 in chips)
Seat 4: ac68c783 (8,875 in chips)
Seat 5: d9bef9a (11,025 in chips)
Seat 6: c724a38e (11,101 in chips)
Seat 7: ed2c2257 (13,728 in chips)
Seat 8: Hero (8,736 in chips)
d9bef9a: posts the ante 18
52fbc93d: posts the ante 18
66939f17: posts the ante 18
36fddff7: posts the ante 18
ed2c2257: posts the ante 18
c724a38e: posts the ante 18
Hero: posts the ante 18
ac68c783: posts the ante 18
66939f17: posts small blind 60
52fbc93d: posts big blind 120
*** HOLE CARDS ***
Dealt to 36fddff7 
Dealt to 66939f17 
Dealt to 52fbc93d 
Dealt to ac68c783 
Dealt to d9bef9a 
Dealt to c724a38e 
Dealt to ed2c2257 
Dealt to Hero [8s Kc]
ac68c783: folds
d9bef9a: folds
c724a38e: raises 240 to 360
ed2c2257: folds
Hero: folds
36fddff7: folds
66939f17: folds
52fbc93d: folds
Uncalled bet (240) returned to c724a38e
*** SHOWDOWN ***
c724a38e collected 444 from pot
*** SUMMARY ***
Total pot 444 | Rake 0 | Jackpot 0 | Bingo 0 | Fortune 0 | Tax 0
Seat 1: 36fddff7 (button) folded before Flop
Seat 2: 66939f17 (small blind) folded before Flop
Seat 3: 52fbc93d (big blind) folded before Flop
Seat 4: ac68c783 folded before Flop
Seat 5: d9bef9a folded before Flop
Seat 6: c724a38e collected (444)
Seat 7: ed2c2257 folded before Flop
Seat 8: Hero folded before Flop


Poker Hand #TM3524312870: Tournament #155037137, Bounty Hunters Big One $1.08 Hold'em No Limit - Level2(60/120) - 2024/07/27 17:44:08
Table '16' 8-max Seat #8 is the button
Seat 1: 36fddff7 (11,394 in chips)
Seat 2: 66939f17 (16,026 in chips)
Seat 3: 52fbc93d (8,999 in chips)
Seat 4: ac68c783 (8,893 in chips)
Seat 5: d9bef9a (11,043 in chips)
Seat 6: c724a38e (11,119 in chips)
Seat 7: ed2c2257 (13,422 in chips)
Seat 8: Hero (8,754 in chips)
d9bef9a: posts the ante 18
52fbc93d: posts the ante 18
66939f17: posts the ante 18
ed2c2257: posts the ante 18
36fddff7: posts the ante 18
c724a38e: posts the ante 18
Hero: posts the ante 18
ac68c783: posts the ante 18
36fddff7: posts small blind 60
66939f17: posts big blind 120
*** HOLE CARDS ***
Dealt to 36fddff7 
Dealt to 66939f17 
Dealt to 52fbc93d 
Dealt to ac68c783 
Dealt to d9bef9a 
Dealt to c724a38e 
Dealt to ed2c2257 
Dealt to Hero [6d Qh]
52fbc93d: folds
ac68c783: folds
d9bef9a: folds
c724a38e: folds
ed2c2257: raises 120 to 240
Hero: folds
36fddff7: folds
66939f17: folds
Uncalled bet (120) returned to ed2c2257
*** SHOWDOWN ***
ed2c2257 collected 444 from pot
*** SUMMARY ***
Total pot 444 | Rake 0 | Jackpot 0 | Bingo 0 | Fortune 0 | Tax 0
Seat 1: 36fddff7 (small blind) folded before Flop
Seat 2: 66939f17 (big blind) folded before Flop
Seat 3: 52fbc93d folded before Flop
Seat 4: ac68c783 folded before Flop
Seat 5: d9bef9a folded before Flop
Seat 6: c724a38e folded before Flop
Seat 7: ed2c2257 collected (444)
Seat 8: Hero (button) folded before Flop


Poker Hand #TM3524312820: Tournament #155037137, Bounty Hunters Big One $1.08 Hold'em No Limit - Level2(60/120) - 2024/07/27 17:42:45
Table '16' 8-max Seat #7 is the button
Seat 1: 36fddff7 (11,532 in chips)
Seat 2: 66939f17 (16,044 in chips)
Seat 3: 52fbc93d (9,017 in chips)
Seat 4: ac68c783 (8,167 in chips)
Seat 5: d9bef9a (11,061 in chips)
Seat 6: c724a38e (11,137 in chips)
Seat 7: ed2c2257 (13,680 in chips)
Seat 8: Hero (9,012 in chips)
d9bef9a: posts the ante 18
52fbc93d: posts the ante 18
66939f17: posts the ante 18
ed2c2257: posts the ante 18
36fddff7: posts the ante 18
c724a38e: posts the ante 18
ac68c783: posts the ante 18
Hero: posts the ante 18
Hero: posts small blind 60
36fddff7: posts big blind 120
*** HOLE CARDS ***
Dealt to 36fddff7 
Dealt to 66939f17 
Dealt to 52fbc93d 
Dealt to ac68c783 
Dealt to d9bef9a 
Dealt to c724a38e 
Dealt to ed2c2257 
Dealt to Hero [Jc Qc]
66939f17: folds
52fbc93d: folds
ac68c783: raises 120 to 240
d9bef9a: folds
c724a38e: folds
ed2c2257: calls 240
Hero: calls 180
36fddff7: folds
*** FLOP *** [4d 4c 6d]
Hero: checks
ac68c783: bets 492
ed2c2257: folds
Hero: folds
Uncalled bet (492) returned to ac68c783
ac68c783: shows [7d 5d] (Pair of Fours)
*** SHOWDOWN ***
ac68c783 collected 984 from pot
*** SUMMARY ***
Total pot 984 | Rake 0 | Jackpot 0 | Bingo 0 | Fortune 0 | Tax 0
Board [4d 4c 6d]
Seat 1: 36fddff7 (big blind) folded before Flop
Seat 2: 66939f17 folded before Flop
Seat 3: 52fbc93d folded before Flop
Seat 4: ac68c783 showed [7d 5d] and won (984)
Seat 5: d9bef9a folded before Flop
Seat 6: c724a38e folded before Flop
Seat 7: ed2c2257 (button) folded on the Flop
Seat 8: Hero (small blind) folded on the Flop


Poker Hand #TM3524312769: Tournament #155037137, Bounty Hunters Big One $1.08 Hold'em No Limit - Level2(60/120) - 2024/07/27 17:41:16
Table '16' 8-max Seat #6 is the button
Seat 1: 36fddff7 (11,790 in chips)
Seat 2: 66939f17 (16,302 in chips)
Seat 3: 52fbc93d (9,035 in chips)
Seat 4: ac68c783 (8,185 in chips)
Seat 5: d9bef9a (9,975 in chips)
Seat 6: c724a38e (11,155 in chips)
Seat 7: ed2c2257 (13,938 in chips)
Seat 8: Hero (9,270 in chips)
d9bef9a: posts the ante 18
52fbc93d: posts the ante 18
66939f17: posts the ante 18
36fddff7: posts the ante 18
ed2c2257: posts the ante 18
c724a38e: posts the ante 18
ac68c783: posts the ante 18
Hero: posts the ante 18
ed2c2257: posts small blind 60
Hero: posts big blind 120
*** HOLE CARDS ***
Dealt to 36fddff7 
Dealt to 66939f17 
Dealt to 52fbc93d 
Dealt to ac68c783 
Dealt to d9bef9a 
Dealt to c724a38e 
Dealt to ed2c2257 
Dealt to Hero [6c 4c]
36fddff7: raises 120 to 240
66939f17: calls 240
52fbc93d: folds
ac68c783: folds
d9bef9a: calls 240
c724a38e: folds
ed2c2257: calls 180
Hero: calls 120
*** FLOP *** [Js Qd 7h]
ed2c2257: checks
Hero: checks
36fddff7: checks
66939f17: checks
d9bef9a: bets 444
ed2c2257: folds
Hero: folds
36fddff7: folds
66939f17: folds
Uncalled bet (444) returned to d9bef9a
*** SHOWDOWN ***
d9bef9a collected 1,344 from pot
*** SUMMARY ***
Total pot 1,344 | Rake 0 | Jackpot 0 | Bingo 0 | Fortune 0 | Tax 0
Board [Js Qd 7h]
Seat 1: 36fddff7 folded on the Flop
Seat 2: 66939f17 folded on the Flop
Seat 3: 52fbc93d folded before Flop
Seat 4: ac68c783 folded before Flop
Seat 5: d9bef9a won (1,344)
Seat 6: c724a38e (button) folded before Flop
Seat 7: ed2c2257 (small blind) folded on the Flop
Seat 8: Hero (big blind) folded on the Flop


Poker Hand #TM3524312704: Tournament #155037137, Bounty Hunters Big One $1.08 Hold'em No Limit - Level1(50/100) - 2024/07/27 17:39:36
Table '16' 8-max Seat #5 is the button
Seat 1: 36fddff7 (9,635 in chips)
Seat 2: 66939f17 (16,317 in chips)
Seat 3: 52fbc93d (9,050 in chips)
Seat 4: ac68c783 (10,000 in chips)
Seat 5: d9bef9a (9,990 in chips)
Seat 6: c724a38e (11,220 in chips)
Seat 7: ed2c2257 (14,153 in chips)
Seat 8: Hero (9,285 in chips)
d9bef9a: posts the ante 15
52fbc93d: posts the ante 15
66939f17: posts the ante 15
36fddff7: posts the ante 15
ed2c2257: posts the ante 15
c724a38e: posts the ante 15
ac68c783: posts the ante 15
Hero: posts the ante 15
c724a38e: posts small blind 50
ed2c2257: posts big blind 100
*** HOLE CARDS ***
Dealt to 36fddff7 
Dealt to 66939f17 
Dealt to 52fbc93d 
Dealt to ac68c783 
Dealt to d9bef9a 
Dealt to c724a38e 
Dealt to ed2c2257 
Dealt to Hero [Qs 2s]
Hero: folds
36fddff7: raises 100 to 200
66939f17: folds
52fbc93d: folds
ac68c783: calls 200
d9bef9a: folds
c724a38e: folds
ed2c2257: calls 100
*** FLOP *** [8d Ts 8s]
ed2c2257: checks
36fddff7: checks
ac68c783: checks
*** TURN *** [8d Ts 8s] [Ad]
ed2c2257: checks
36fddff7: bets 400
ac68c783: calls 400
ed2c2257: folds
*** RIVER *** [8d Ts 8s Ad] [Td]
36fddff7: bets 1,200
ac68c783: calls 1,200
36fddff7: shows [Qc Ac] (Pair of Aces and Pair of Tens)
ac68c783: shows [3h As] (Pair of Aces and Pair of Tens)
*** SHOWDOWN ***
36fddff7 collected 3,970 from pot
*** SUMMARY ***
Total pot 3,970 | Rake 0 | Jackpot 0 | Bingo 0 | Fortune 0 | Tax 0
Board [8d Ts 8s Ad Td]
Seat 1: 36fddff7 showed [Qc Ac] and won (3,970) with Pair of Aces and Pair of Tens
Seat 2: 66939f17 folded before Flop
Seat 3: 52fbc93d folded before Flop
Seat 4: ac68c783 showed [3h As] and lost with Pair of Aces and Pair of Tens
Seat 5: d9bef9a (button) folded before Flop
Seat 6: c724a38e (small blind) folded before Flop
Seat 7: ed2c2257 (big blind) folded on the Turn
Seat 8: Hero folded before Flop


Poker Hand #TM3524312655: Tournament #155037137, Bounty Hunters Big One $1.08 Hold'em No Limit - Level1(50/100) - 2024/07/27 17:38:18
Table '16' 8-max Seat #3 is the button
Seat 1: 36fddff7 (9,650 in chips)
Seat 2: 66939f17 (9,805 in chips)
Seat 3: 52fbc93d (9,065 in chips)
Seat 4: 7b9aba8a (6,222 in chips)
Seat 5: d9bef9a (10,205 in chips)
Seat 6: c724a38e (11,235 in chips)
Seat 7: ed2c2257 (14,168 in chips)
Seat 8: Hero (9,300 in chips)
d9bef9a: posts the ante 15
52fbc93d: posts the ante 15
7b9aba8a: posts the ante 15
66939f17: posts the ante 15
36fddff7: posts the ante 15
ed2c2257: posts the ante 15
c724a38e: posts the ante 15
Hero: posts the ante 15
7b9aba8a: posts small blind 50
d9bef9a: posts big blind 100
*** HOLE CARDS ***
Dealt to 36fddff7 
Dealt to 66939f17 
Dealt to 52fbc93d 
Dealt to 7b9aba8a 
Dealt to d9bef9a 
Dealt to c724a38e 
Dealt to ed2c2257 
Dealt to Hero [Jd 3c]
c724a38e: folds
ed2c2257: folds
Hero: folds
36fddff7: folds
66939f17: raises 100 to 200
52fbc93d: folds
7b9aba8a: calls 150
d9bef9a: calls 100
*** FLOP *** [8s 6d 7c]
7b9aba8a: bets 720
d9bef9a: folds
66939f17: raises 1,080 to 1,800
7b9aba8a: calls 1,080
*** TURN *** [8s 6d 7c] [Qc]
7b9aba8a: checks
66939f17: bets 1,426
7b9aba8a: calls 1,426
*** RIVER *** [8s 6d 7c Qc] [3s]
7b9aba8a: bets 2,781 and is all-in
66939f17: calls 2,781
7b9aba8a: shows [Ac 8h] (Pair of Eights)
66939f17: shows [Qd 8c] (Pair of Queens and Pair of Eights)
*** SHOWDOWN ***
66939f17 collected 12,734 from pot
*** SUMMARY ***
Total pot 12,734 | Rake 0 | Jackpot 0 | Bingo 0 | Fortune 0 | Tax 0
Board [8s 6d 7c Qc 3s]
Seat 1: 36fddff7 folded before Flop
Seat 2: 66939f17 showed [Qd 8c] and won (12,734) with Pair of Queens and Pair of Eights
Seat 3: 52fbc93d (button) folded before Flop
Seat 4: 7b9aba8a (small blind) showed [Ac 8h] and lost with Pair of Eights
Seat 5: d9bef9a (big blind) folded on the Flop
Seat 6: c724a38e folded before Flop
Seat 7: ed2c2257 folded before Flop
Seat 8: Hero folded before Flop


Poker Hand #TM3524312626: Tournament #155037137, Bounty Hunters Big One $1.08 Hold'em No Limit - Level1(50/100) - 2024/07/27 17:37:24
Table '16' 8-max Seat #2 is the button
Seat 1: 36fddff7 (9,665 in chips)
Seat 2: 66939f17 (9,820 in chips)
Seat 3: 52fbc93d (9,380 in chips)
Seat 4: 7b9aba8a (6,337 in chips)
Seat 5: d9bef9a (10,220 in chips)
Seat 6: c724a38e (10,730 in chips)
Seat 7: ed2c2257 (14,183 in chips)
Seat 8: Hero (9,315 in chips)
d9bef9a: posts the ante 15
52fbc93d: posts the ante 15
7b9aba8a: posts the ante 15
66939f17: posts the ante 15
36fddff7: posts the ante 15
ed2c2257: posts the ante 15
c724a38e: posts the ante 15
Hero: posts the ante 15
52fbc93d: posts small blind 50
7b9aba8a: posts big blind 100
*** HOLE CARDS ***
Dealt to 36fddff7 
Dealt to 66939f17 
Dealt to 52fbc93d 
Dealt to 7b9aba8a 
Dealt to d9bef9a 
Dealt to c724a38e 
Dealt to ed2c2257 
Dealt to Hero [3d 8c]
d9bef9a: folds
c724a38e: raises 200 to 300
ed2c2257: folds
Hero: folds
36fddff7: folds
66939f17: folds
52fbc93d: calls 250
7b9aba8a: folds
*** FLOP *** [2h Kd Qs]
52fbc93d: checks
c724a38e: bets 271
52fbc93d: folds
Uncalled bet (271) returned to c724a38e
*** SHOWDOWN ***
c724a38e collected 820 from pot
*** SUMMARY ***
Total pot 820 | Rake 0 | Jackpot 0 | Bingo 0 | Fortune 0 | Tax 0
Board [2h Kd Qs]
Seat 1: 36fddff7 folded before Flop
Seat 2: 66939f17 (button) folded before Flop
Seat 3: 52fbc93d (small blind) folded on the Flop
Seat 4: 7b9aba8a (big blind) folded before Flop
Seat 5: d9bef9a folded before Flop
Seat 6: c724a38e won (820)
Seat 7: ed2c2257 folded before Flop
Seat 8: Hero folded before Flop


Poker Hand #TM3524312586: Tournament #155037137, Bounty Hunters Big One $1.08 Hold'em No Limit - Level1(50/100) - 2024/07/27 17:36:21
Table '16' 8-max Seat #1 is the button
Seat 1: 36fddff7 (9,680 in chips)
Seat 2: 66939f17 (9,885 in chips)
Seat 3: 52fbc93d (9,495 in chips)
Seat 4: 7b9aba8a (6,552 in chips)
Seat 5: d9bef9a (10,235 in chips)
Seat 6: c724a38e (10,745 in chips)
Seat 7: ed2c2257 (13,528 in chips)
Seat 8: Hero (9,530 in chips)
d9bef9a: posts the ante 15
52fbc93d: posts the ante 15
7b9aba8a: posts the ante 15
66939f17: posts the ante 15
36fddff7: posts the ante 15
ed2c2257: posts the ante 15
c724a38e: posts the ante 15
Hero: posts the ante 15
66939f17: posts small blind 50
52fbc93d: posts big blind 100
*** HOLE CARDS ***
Dealt to 36fddff7 
Dealt to 66939f17 
Dealt to 52fbc93d 
Dealt to 7b9aba8a 
Dealt to d9bef9a 
Dealt to c724a38e 
Dealt to ed2c2257 
Dealt to Hero [Ts Js]
7b9aba8a: calls 100
d9bef9a: folds
c724a38e: folds
ed2c2257: raises 100 to 200
Hero: calls 200
36fddff7: folds
66939f17: folds
52fbc93d: folds
7b9aba8a: calls 100
*** FLOP *** [9c 3h 4h]
7b9aba8a: checks
ed2c2257: bets 288
Hero: folds
7b9aba8a: folds
Uncalled bet (288) returned to ed2c2257
*** SHOWDOWN ***
ed2c2257 collected 870 from pot
*** SUMMARY ***
Total pot 870 | Rake 0 | Jackpot 0 | Bingo 0 | Fortune 0 | Tax 0
Board [9c 3h 4h]
Seat 1: 36fddff7 (button) folded before Flop
Seat 2: 66939f17 (small blind) folded before Flop
Seat 3: 52fbc93d (big blind) folded before Flop
Seat 4: 7b9aba8a folded on the Flop
Seat 5: d9bef9a folded before Flop
Seat 6: c724a38e folded before Flop
Seat 7: ed2c2257 won (870)
Seat 8: Hero folded on the Flop


Poker Hand #TM3524312543: Tournament #155037137, Bounty Hunters Big One $1.08 Hold'em No Limit - Level1(50/100) - 2024/07/27 17:35:15
Table '16' 8-max Seat #8 is the button
Seat 1: 36fddff7 (9,745 in chips)
Seat 2: 66939f17 (10,000 in chips)
Seat 3: 52fbc93d (9,510 in chips)
Seat 4: 7b9aba8a (10,035 in chips)
Seat 5: d9bef9a (10,250 in chips)
Seat 6: c724a38e (10,760 in chips)
Seat 7: ed2c2257 (9,805 in chips)
Seat 8: Hero (9,545 in chips)
d9bef9a: posts the ante 15
52fbc93d: posts the ante 15
7b9aba8a: posts the ante 15
66939f17: posts the ante 15
ed2c2257: posts the ante 15
36fddff7: posts the ante 15
c724a38e: posts the ante 15
Hero: posts the ante 15
36fddff7: posts small blind 50
66939f17: posts big blind 100
*** HOLE CARDS ***
Dealt to 36fddff7 
Dealt to 66939f17 
Dealt to 52fbc93d 
Dealt to 7b9aba8a 
Dealt to d9bef9a 
Dealt to c724a38e 
Dealt to ed2c2257 
Dealt to Hero [4s 7c]
52fbc93d: folds
7b9aba8a: calls 100
d9bef9a: folds
c724a38e: folds
ed2c2257: raises 200 to 300
Hero: folds
36fddff7: folds
66939f17: folds
7b9aba8a: calls 200
*** FLOP *** [As 6c 5d]
7b9aba8a: checks
ed2c2257: bets 288
7b9aba8a: calls 288
*** TURN *** [As 6c 5d] [Ac]
7b9aba8a: checks
ed2c2257: bets 478
7b9aba8a: calls 478
*** RIVER *** [As 6c 5d Ac] [5h]
7b9aba8a: bets 2,402
ed2c2257: calls 2,402
7b9aba8a: shows [6d 8s] (Pair of Aces and Pair of Sixes)
ed2c2257: shows [Tc Td] (Pair of Aces and Pair of Tens)
*** SHOWDOWN ***
ed2c2257 collected 7,206 from pot
*** SUMMARY ***
Total pot 7,206 | Rake 0 | Jackpot 0 | Bingo 0 | Fortune 0 | Tax 0
Board [As 6c 5d Ac 5h]
Seat 1: 36fddff7 (small blind) folded before Flop
Seat 2: 66939f17 (big blind) folded before Flop
Seat 3: 52fbc93d folded before Flop
Seat 4: 7b9aba8a showed [6d 8s] and lost with Pair of Aces and Pair of Sixes
Seat 5: d9bef9a folded before Flop
Seat 6: c724a38e folded before Flop
Seat 7: ed2c2257 showed [Tc Td] and won (7,206) with Pair of Aces and Pair of Tens
Seat 8: Hero (button) folded before Flop


Poker Hand #TM3524312510: Tournament #155037137, Bounty Hunters Big One $1.08 Hold'em No Limit - Level1(50/100) - 2024/07/27 17:34:18
Table '16' 8-max Seat #7 is the button
Seat 1: 36fddff7 (9,860 in chips)
Seat 2: e4eee4c9 (10,515 in chips)
Seat 3: 52fbc93d (10,125 in chips)
Seat 4: 7b9aba8a (10,150 in chips)
Seat 5: d9bef9a (10,265 in chips)
Seat 6: c724a38e (9,805 in chips)
Seat 7: ed2c2257 (9,820 in chips)
Seat 8: Hero (9,610 in chips)
d9bef9a: posts the ante 15
52fbc93d: posts the ante 15
7b9aba8a: posts the ante 15
ed2c2257: posts the ante 15
36fddff7: posts the ante 15
c724a38e: posts the ante 15
e4eee4c9: posts the ante 15
Hero: posts the ante 15
Hero: posts small blind 50
36fddff7: posts big blind 100
*** HOLE CARDS ***
Dealt to 36fddff7 
Dealt to e4eee4c9 
Dealt to 52fbc93d 
Dealt to 7b9aba8a 
Dealt to d9bef9a 
Dealt to c724a38e 
Dealt to ed2c2257 
Dealt to Hero [Qh 8d]
e4eee4c9: folds
52fbc93d: calls 100
7b9aba8a: calls 100
d9bef9a: folds
c724a38e: raises 500 to 600
ed2c2257: folds
Hero: folds
36fddff7: folds
52fbc93d: calls 500
7b9aba8a: folds
*** FLOP *** [5h Ac Tc]
52fbc93d: checks
c724a38e: bets 519
52fbc93d: folds
Uncalled bet (519) returned to c724a38e
*** SHOWDOWN ***
c724a38e collected 1,570 from pot
*** SUMMARY ***
Total pot 1,570 | Rake 0 | Jackpot 0 | Bingo 0 | Fortune 0 | Tax 0
Board [5h Ac Tc]
Seat 1: 36fddff7 (big blind) folded before Flop
Seat 2: e4eee4c9 folded before Flop
Seat 3: 52fbc93d folded on the Flop
Seat 4: 7b9aba8a folded before Flop
Seat 5: d9bef9a folded before Flop
Seat 6: c724a38e won (1,570)
Seat 7: ed2c2257 (button) folded before Flop
Seat 8: Hero (small blind) folded before Flop


Poker Hand #TM3524312480: Tournament #155037137, Bounty Hunters Big One $1.08 Hold'em No Limit - Level1(50/100) - 2024/07/27 17:33:22
Table '16' 8-max Seat #6 is the button
Seat 1: 36fddff7 (9,875 in chips)
Seat 2: e4eee4c9 (10,530 in chips)
Seat 3: 52fbc93d (10,440 in chips)
Seat 4: 7b9aba8a (9,595 in chips)
Seat 5: d9bef9a (10,280 in chips)
Seat 6: c724a38e (9,820 in chips)
Seat 7: ed2c2257 (9,885 in chips)
Seat 8: Hero (9,725 in chips)
d9bef9a: posts the ante 15
52fbc93d: posts the ante 15
7b9aba8a: posts the ante 15
36fddff7: posts the ante 15
ed2c2257: posts the ante 15
c724a38e: posts the ante 15
e4eee4c9: posts the ante 15
Hero: posts the ante 15
ed2c2257: posts small blind 50
Hero: posts big blind 100
*** HOLE CARDS ***
Dealt to 36fddff7 
Dealt to e4eee4c9 
Dealt to 52fbc93d 
Dealt to 7b9aba8a 
Dealt to d9bef9a 
Dealt to c724a38e 
Dealt to ed2c2257 
Dealt to Hero [Jd 3s]
36fddff7: folds
e4eee4c9: folds
52fbc93d: calls 100
7b9aba8a: raises 200 to 300
d9bef9a: folds
c724a38e: folds
ed2c2257: folds
Hero: folds
52fbc93d: calls 200
*** FLOP *** [6h 6d Ks]
52fbc93d: checks
7b9aba8a: checks
*** TURN *** [6h 6d Ks] [Kd]
52fbc93d: checks
7b9aba8a: checks
*** RIVER *** [6h 6d Ks Kd] [3d]
52fbc93d: checks
7b9aba8a: checks
52fbc93d: shows [Ts 8s] (Pair of Kings and Pair of Sixes)
7b9aba8a: shows [Ac Qh] (Pair of Kings and Pair of Sixes)
*** SHOWDOWN ***
7b9aba8a collected 870 from pot
*** SUMMARY ***
Total pot 870 | Rake 0 | Jackpot 0 | Bingo 0 | Fortune 0 | Tax 0
Board [6h 6d Ks Kd 3d]
Seat 1: 36fddff7 folded before Flop
Seat 2: e4eee4c9 folded before Flop
Seat 3: 52fbc93d showed [Ts 8s] and lost with Pair of Kings and Pair of Sixes
Seat 4: 7b9aba8a showed [Ac Qh] and won (870) with Pair of Kings and Pair of Sixes
Seat 5: d9bef9a folded before Flop
Seat 6: c724a38e (button) folded before Flop
Seat 7: ed2c2257 (small blind) folded before Flop
Seat 8: Hero (big blind) folded before Flop


Poker Hand #TM3524312447: Tournament #155037137, Bounty Hunters Big One $1.08 Hold'em No Limit - Level1(50/100) - 2024/07/27 17:32:32
Table '16' 8-max Seat #5 is the button
Seat 1: 36fddff7 (9,890 in chips)
Seat 2: e4eee4c9 (10,545 in chips)
Seat 3: 52fbc93d (9,985 in chips)
Seat 4: 7b9aba8a (9,610 in chips)
Seat 5: d9bef9a (10,295 in chips)
Seat 6: c724a38e (9,885 in chips)
Seat 7: ed2c2257 (10,000 in chips)
Seat 8: Hero (9,940 in chips)
d9bef9a: posts the ante 15
52fbc93d: posts the ante 15
7b9aba8a: posts the ante 15
36fddff7: posts the ante 15
ed2c2257: posts the ante 15
c724a38e: posts the ante 15
e4eee4c9: posts the ante 15
Hero: posts the ante 15
c724a38e: posts small blind 50
ed2c2257: posts big blind 100
*** HOLE CARDS ***
Dealt to 36fddff7 
Dealt to e4eee4c9 
Dealt to 52fbc93d 
Dealt to 7b9aba8a 
Dealt to d9bef9a 
Dealt to c724a38e 
Dealt to ed2c2257 
Dealt to Hero [Tc Qh]
Hero: raises 100 to 200
36fddff7: folds
e4eee4c9: folds
52fbc93d: raises 9,770 to 9,970 and is all-in
7b9aba8a: folds
d9bef9a: folds
c724a38e: folds
ed2c2257: folds
Hero: folds
Uncalled bet (9,770) returned to 52fbc93d
*** SHOWDOWN ***
52fbc93d collected 670 from pot
*** SUMMARY ***
Total pot 670 | Rake 0 | Jackpot 0 | Bingo 0 | Fortune 0 | Tax 0
Seat 1: 36fddff7 folded before Flop
Seat 2: e4eee4c9 folded before Flop
Seat 3: 52fbc93d collected (670)
Seat 4: 7b9aba8a folded before Flop
Seat 5: d9bef9a (button) folded before Flop
Seat 6: c724a38e (small blind) folded before Flop
Seat 7: ed2c2257 (big blind) folded before Flop
Seat 8: Hero folded before Flop


Poker Hand #TM3524312433: Tournament #155037137, Bounty Hunters Big One $1.08 Hold'em No Limit - Level1(50/100) - 2024/07/27 17:32:06
Table '16' 8-max Seat #4 is the button
Seat 1: 36fddff7 (9,905 in chips)
Seat 2: e4eee4c9 (10,560 in chips)
Seat 3: 52fbc93d (10,000 in chips)
Seat 4: 7b9aba8a (9,355 in chips)
Seat 5: d9bef9a (10,360 in chips)
Seat 6: c724a38e (10,000 in chips)
Seat 7: 76e948a8 (10,125 in chips)
Seat 8: Hero (9,955 in chips)
d9bef9a: posts the ante 15
52fbc93d: posts the ante 15
7b9aba8a: posts the ante 15
36fddff7: posts the ante 15
c724a38e: posts the ante 15
e4eee4c9: posts the ante 15
Hero: posts the ante 15
76e948a8: posts the ante 15
d9bef9a: posts small blind 50
c724a38e: posts big blind 100
*** HOLE CARDS ***
Dealt to 36fddff7 
Dealt to e4eee4c9 
Dealt to 52fbc93d 
Dealt to 7b9aba8a 
Dealt to d9bef9a 
Dealt to c724a38e 
Dealt to 76e948a8 
Dealt to Hero [4c 8d]
76e948a8: folds
Hero: folds
36fddff7: folds
e4eee4c9: folds
52fbc93d: folds
7b9aba8a: raises 200 to 300
d9bef9a: folds
c724a38e: folds
Uncalled bet (200) returned to 7b9aba8a
*** SHOWDOWN ***
7b9aba8a collected 370 from pot
*** SUMMARY ***
Total pot 370 | Rake 0 | Jackpot 0 | Bingo 0 | Fortune 0 | Tax 0
Seat 1: 36fddff7 folded before Flop
Seat 2: e4eee4c9 folded before Flop
Seat 3: 52fbc93d folded before Flop
Seat 4: 7b9aba8a (button) collected (370)
Seat 5: d9bef9a (small blind) folded before Flop
Seat 6: c724a38e (big blind) folded before Flop
Seat 7: 76e948a8 folded before Flop
Seat 8: Hero folded before Flop


Poker Hand #TM3524312415: Tournament #155037137, Bounty Hunters Big One $1.08 Hold'em No Limit - Level1(50/100) - 2024/07/27 17:31:38
Table '16' 8-max Seat #2 is the button
Seat 1: 36fddff7 (9,920 in chips)
Seat 2: e4eee4c9 (10,575 in chips)
Seat 4: 7b9aba8a (9,670 in chips)
Seat 5: d9bef9a (9,970 in chips)
Seat 6: 6c1dd8a0 (9,770 in chips)
Seat 7: 76e948a8 (10,140 in chips)
Seat 8: Hero (9,970 in chips)
6c1dd8a0: posts the ante 15
d9bef9a: posts the ante 15
7b9aba8a: posts the ante 15
36fddff7: posts the ante 15
e4eee4c9: posts the ante 15
Hero: posts the ante 15
76e948a8: posts the ante 15
7b9aba8a: posts small blind 50
d9bef9a: posts big blind 100
*** HOLE CARDS ***
Dealt to 36fddff7 
Dealt to e4eee4c9 
Dealt to 7b9aba8a 
Dealt to d9bef9a 
Dealt to 6c1dd8a0 
Dealt to 76e948a8 
Dealt to Hero [Ks 8h]
6c1dd8a0: folds
76e948a8: folds
Hero: folds
36fddff7: folds
e4eee4c9: folds
7b9aba8a: raises 200 to 300
d9bef9a: raises 900 to 1,200
7b9aba8a: folds
Uncalled bet (900) returned to d9bef9a
*** SHOWDOWN ***
d9bef9a collected 705 from pot
*** SUMMARY ***
Total pot 705 | Rake 0 | Jackpot 0 | Bingo 0 | Fortune 0 | Tax 0
Seat 1: 36fddff7 folded before Flop
Seat 2: e4eee4c9 (button) folded before Flop
Seat 4: 7b9aba8a (small blind) folded before Flop
Seat 5: d9bef9a (big blind) collected (705)
Seat 6: 6c1dd8a0 folded before Flop
Seat 7: 76e948a8 folded before Flop
Seat 8: Hero folded before Flop


Poker Hand #TM3524312391: Tournament #155037137, Bounty Hunters Big One $1.08 Hold'em No Limit - Level1(50/100) - 2024/07/27 17:30:54
Table '16' 8-max Seat #1 is the button
Seat 1: 36fddff7 (9,935 in chips)
Seat 2: e4eee4c9 (9,885 in chips)
Seat 4: 7b9aba8a (9,885 in chips)
Seat 5: d9bef9a (9,985 in chips)
Seat 6: 6c1dd8a0 (9,985 in chips)
Seat 7: 76e948a8 (10,355 in chips)
Seat 8: Hero (9,985 in chips)
6c1dd8a0: posts the ante 15
d9bef9a: posts the ante 15
7b9aba8a: posts the ante 15
36fddff7: posts the ante 15
e4eee4c9: posts the ante 15
Hero: posts the ante 15
76e948a8: posts the ante 15
e4eee4c9: posts small blind 50
7b9aba8a: posts big blind 100
*** HOLE CARDS ***
Dealt to 36fddff7 
Dealt to e4eee4c9 
Dealt to 7b9aba8a 
Dealt to d9bef9a 
Dealt to 6c1dd8a0 
Dealt to 76e948a8 
Dealt to Hero [4s Qs]
d9bef9a: folds
6c1dd8a0: raises 100 to 200
76e948a8: calls 200
Hero: folds
36fddff7: folds
e4eee4c9: calls 150
7b9aba8a: calls 100
*** FLOP *** [6d Qc Td]
e4eee4c9: checks
7b9aba8a: checks
6c1dd8a0: checks
76e948a8: checks
*** TURN *** [6d Qc Td] [2s]
e4eee4c9: bets 263
7b9aba8a: folds
6c1dd8a0: folds
76e948a8: folds
Uncalled bet (263) returned to e4eee4c9
*** SHOWDOWN ***
e4eee4c9 collected 905 from pot
*** SUMMARY ***
Total pot 905 | Rake 0 | Jackpot 0 | Bingo 0 | Fortune 0 | Tax 0
Board [6d Qc Td 2s]
Seat 1: 36fddff7 (button) folded before Flop
Seat 2: e4eee4c9 (small blind) won (905)
Seat 4: 7b9aba8a (big blind) folded on the Turn
Seat 5: d9bef9a folded before Flop
Seat 6: 6c1dd8a0 folded on the Turn
Seat 7: 76e948a8 folded on the Turn
Seat 8: Hero folded before Flop


Poker Hand #TM3524312357: Tournament #155037137, Bounty Hunters Big One $1.08 Hold'em No Limit - Level1(50/100) - 2024/07/27 17:30:02
Table '16' 8-max Seat #8 is the button
Seat 1: 36fddff7 (10,000 in chips)
Seat 2: e4eee4c9 (10,000 in chips)
Seat 3: 7bbc8ad9 (10,000 in chips)
Seat 4: 7b9aba8a (10,000 in chips)
Seat 5: d9bef9a (10,000 in chips)
Seat 6: 6c1dd8a0 (10,000 in chips)
Seat 7: 76e948a8 (10,000 in chips)
Seat 8: Hero (10,000 in chips)
6c1dd8a0: posts the ante 15
d9bef9a: posts the ante 15
7b9aba8a: posts the ante 15
36fddff7: posts the ante 15
7bbc8ad9: posts the ante 15
e4eee4c9: posts the ante 15
Hero: posts the ante 15
76e948a8: posts the ante 15
36fddff7: posts small blind 50
e4eee4c9: posts big blind 100
*** HOLE CARDS ***
Dealt to 36fddff7 
Dealt to e4eee4c9 
Dealt to 7bbc8ad9 
Dealt to 7b9aba8a 
Dealt to d9bef9a 
Dealt to 6c1dd8a0 
Dealt to 76e948a8 
Dealt to Hero [2d 3d]
7bbc8ad9: folds
7b9aba8a: calls 100
d9bef9a: folds
6c1dd8a0: folds
76e948a8: raises 500 to 600
Hero: folds
36fddff7: folds
e4eee4c9: folds
7b9aba8a: folds
Uncalled bet (500) returned to 76e948a8
*** SHOWDOWN ***
76e948a8 collected 470 from pot
*** SUMMARY ***
Total pot 470 | Rake 0 | Jackpot 0 | Bingo 0 | Fortune 0 | Tax 0
Seat 1: 36fddff7 (small blind) folded before Flop
Seat 2: e4eee4c9 (big blind) folded before Flop
Seat 3: 7bbc8ad9 folded before Flop
Seat 4: 7b9aba8a folded before Flop
Seat 5: d9bef9a folded before Flop
Seat 6: 6c1dd8a0 folded before Flop
Seat 7: 76e948a8 collected (470)
Seat 8: Hero (button) folded before Flop


