Poker Hand #TM3567547671: Tournament #157476213, Bounty Hunters Special $1.08 Hold'em No Limit - Level8(200/400) - 2024/08/10 21:52:46
Table '47' 8-max Seat #8 is the button
Seat 1: df6cc5a3 (29,787 in chips)
Seat 2: 3ed1bbd3 (33,710 in chips)
Seat 3: Hero (14,749 in chips)
Seat 4: 45852cb2 (31,060 in chips)
Seat 5: 9e8e0b15 (10,000 in chips)
Seat 6: 3308b4a8 (6,024 in chips)
Seat 7: 1f8c2cc3 (33,509 in chips)
Seat 8: a6200c8b (14,249 in chips)
a6200c8b: posts the ante 60
3308b4a8: posts the ante 60
3ed1bbd3: posts the ante 60
9e8e0b15: posts the ante 60
df6cc5a3: posts the ante 60
45852cb2: posts the ante 60
1f8c2cc3: posts the ante 60
Hero: posts the ante 60
df6cc5a3: posts small blind 200
3ed1bbd3: posts big blind 400
*** HOLE CARDS ***
Dealt to df6cc5a3 
Dealt to 3ed1bbd3 
Dealt to Hero [Tc Th]
Dealt to 45852cb2 
Dealt to 9e8e0b15 
Dealt to 3308b4a8 
Dealt to 1f8c2cc3 
Dealt to a6200c8b 
Hero: calls 400
45852cb2: folds
9e8e0b15: folds
3308b4a8: raises 5,564 to 5,964 and is all-in
1f8c2cc3: folds
a6200c8b: folds
df6cc5a3: folds
3ed1bbd3: calls 5,564
Hero: calls 5,564
*** FLOP *** [3d Kc 2d]
3ed1bbd3: checks
Hero: bets 8,725 and is all-in
3ed1bbd3: calls 8,725
Hero: shows [Tc Th] (Pair of Tens)
3308b4a8: shows [Js Ks] (Pair of Kings)
3ed1bbd3: shows [Ac 5d] (Ace-High)
*** TURN *** [3d Kc 2d] [4s]
*** RIVER *** [3d Kc 2d 4s] [Qh]
*** SHOWDOWN ***
3ed1bbd3 collected 18,572 from pot
3ed1bbd3 collected 17,450 from pot
*** SUMMARY ***
Total pot 36,022 | Rake 0 | Jackpot 0 | Bingo 0 | Fortune 0 | Tax 0
Board [3d Kc 2d 4s Qh]
Seat 1: df6cc5a3 (small blind) folded before Flop
Seat 2: 3ed1bbd3 (big blind) showed [Ac 5d] and won (36,022) with Fives-High Straight
Seat 3: Hero showed [Tc Th] and lost with Pair of Tens
Seat 4: 45852cb2 folded before Flop
Seat 5: 9e8e0b15 folded before Flop
Seat 6: 3308b4a8 showed [Js Ks] and lost with Pair of Kings
Seat 7: 1f8c2cc3 folded before Flop
Seat 8: a6200c8b (button) folded before Flop


Poker Hand #TM3567547633: Tournament #157476213, Bounty Hunters Special $1.08 Hold'em No Limit - Level8(200/400) - 2024/08/10 21:51:27
Table '47' 8-max Seat #7 is the button
Seat 1: df6cc5a3 (30,247 in chips)
Seat 2: 3ed1bbd3 (33,770 in chips)
Seat 3: Hero (14,809 in chips)
Seat 4: 45852cb2 (27,419 in chips)
Seat 5: d4334d47 (2,681 in chips)
Seat 6: 3308b4a8 (6,084 in chips)
Seat 7: 1f8c2cc3 (33,569 in chips)
Seat 8: a6200c8b (14,509 in chips)
a6200c8b: posts the ante 60
3308b4a8: posts the ante 60
d4334d47: posts the ante 60
3ed1bbd3: posts the ante 60
df6cc5a3: posts the ante 60
45852cb2: posts the ante 60
1f8c2cc3: posts the ante 60
Hero: posts the ante 60
a6200c8b: posts small blind 200
df6cc5a3: posts big blind 400
*** HOLE CARDS ***
Dealt to df6cc5a3 
Dealt to 3ed1bbd3 
Dealt to Hero [9d 4h]
Dealt to 45852cb2 
Dealt to d4334d47 
Dealt to 3308b4a8 
Dealt to 1f8c2cc3 
Dealt to a6200c8b 
3ed1bbd3: folds
Hero: folds
45852cb2: raises 400 to 800
d4334d47: raises 1,821 to 2,621 and is all-in
3308b4a8: folds
1f8c2cc3: folds
a6200c8b: folds
df6cc5a3: folds
45852cb2: calls 1,821
d4334d47: shows [Ac 6s]
45852cb2: shows [8h 7d]
*** FLOP *** [6h Th 9s]
*** TURN *** [6h Th 9s] [Kc]
*** RIVER *** [6h Th 9s Kc] [Ts]
*** SHOWDOWN ***
45852cb2 collected 6,322 from pot
*** SUMMARY ***
Total pot 6,322 | Rake 0 | Jackpot 0 | Bingo 0 | Fortune 0 | Tax 0
Board [6h Th 9s Kc Ts]
Seat 1: df6cc5a3 (big blind) folded before Flop
Seat 2: 3ed1bbd3 folded before Flop
Seat 3: Hero folded before Flop
Seat 4: 45852cb2 showed [8h 7d] and won (6,322) with Tens-High Straight
Seat 5: d4334d47 showed [Ac 6s] and lost with Pair of Tens and Pair of Sixes
Seat 6: 3308b4a8 folded before Flop
Seat 7: 1f8c2cc3 (button) folded before Flop
Seat 8: a6200c8b (small blind) folded before Flop


Poker Hand #TM3567547596: Tournament #157476213, Bounty Hunters Special $1.08 Hold'em No Limit - Level8(200/400) - 2024/08/10 21:50:18
Table '47' 8-max Seat #6 is the button
Seat 1: df6cc5a3 (30,307 in chips)
Seat 2: 3ed1bbd3 (16,005 in chips)
Seat 3: Hero (15,669 in chips)
Seat 4: 45852cb2 (27,479 in chips)
Seat 5: d4334d47 (18,686 in chips)
Seat 6: 3308b4a8 (6,144 in chips)
Seat 7: 1f8c2cc3 (33,829 in chips)
Seat 8: a6200c8b (14,969 in chips)
a6200c8b: posts the ante 60
3308b4a8: posts the ante 60
d4334d47: posts the ante 60
3ed1bbd3: posts the ante 60
df6cc5a3: posts the ante 60
45852cb2: posts the ante 60
1f8c2cc3: posts the ante 60
Hero: posts the ante 60
1f8c2cc3: posts small blind 200
a6200c8b: posts big blind 400
*** HOLE CARDS ***
Dealt to df6cc5a3 
Dealt to 3ed1bbd3 
Dealt to Hero [Ts Qs]
Dealt to 45852cb2 
Dealt to d4334d47 
Dealt to 3308b4a8 
Dealt to 1f8c2cc3 
Dealt to a6200c8b 
df6cc5a3: folds
3ed1bbd3: raises 400 to 800
Hero: calls 800
45852cb2: folds
d4334d47: raises 3,480 to 4,280
3308b4a8: folds
1f8c2cc3: folds
a6200c8b: folds
3ed1bbd3: calls 3,480
Hero: folds
*** FLOP *** [Jc 9d 8h]
3ed1bbd3: bets 11,665 and is all-in
d4334d47: calls 11,665
3ed1bbd3: shows [9s 9c] (Three Nines)
d4334d47: shows [Kd Ah] (Ace-High)
*** TURN *** [Jc 9d 8h] [7c]
*** RIVER *** [Jc 9d 8h 7c] [Jh]
*** SHOWDOWN ***
3ed1bbd3 collected 33,770 from pot
*** SUMMARY ***
Total pot 33,770 | Rake 0 | Jackpot 0 | Bingo 0 | Fortune 0 | Tax 0
Board [Jc 9d 8h 7c Jh]
Seat 1: df6cc5a3 folded before Flop
Seat 2: 3ed1bbd3 showed [9s 9c] and won (33,770) with Nines Full over Jacks
Seat 3: Hero folded before Flop
Seat 4: 45852cb2 folded before Flop
Seat 5: d4334d47 showed [Kd Ah] and lost with Pair of Jacks
Seat 6: 3308b4a8 (button) folded before Flop
Seat 7: 1f8c2cc3 (small blind) folded before Flop
Seat 8: a6200c8b (big blind) folded before Flop


Poker Hand #TM3567547564: Tournament #157476213, Bounty Hunters Special $1.08 Hold'em No Limit - Level8(200/400) - 2024/08/10 21:49:12
Table '47' 8-max Seat #5 is the button
Seat 1: df6cc5a3 (30,367 in chips)
Seat 2: 3ed1bbd3 (19,570 in chips)
Seat 3: Hero (15,729 in chips)
Seat 4: 45852cb2 (22,554 in chips)
Seat 5: d4334d47 (18,746 in chips)
Seat 6: 3308b4a8 (6,404 in chips)
Seat 7: 1f8c2cc3 (34,689 in chips)
Seat 8: a6200c8b (15,029 in chips)
a6200c8b: posts the ante 60
d4334d47: posts the ante 60
3308b4a8: posts the ante 60
3ed1bbd3: posts the ante 60
df6cc5a3: posts the ante 60
45852cb2: posts the ante 60
1f8c2cc3: posts the ante 60
Hero: posts the ante 60
3308b4a8: posts small blind 200
1f8c2cc3: posts big blind 400
*** HOLE CARDS ***
Dealt to df6cc5a3 
Dealt to 3ed1bbd3 
Dealt to Hero [3c Jh]
Dealt to 45852cb2 
Dealt to d4334d47 
Dealt to 3308b4a8 
Dealt to 1f8c2cc3 
Dealt to a6200c8b 
a6200c8b: folds
df6cc5a3: folds
3ed1bbd3: raises 400 to 800
Hero: folds
45852cb2: calls 800
d4334d47: folds
3308b4a8: folds
1f8c2cc3: calls 400
*** FLOP *** [Kc 9s 3d]
1f8c2cc3: checks
3ed1bbd3: bets 1,017
45852cb2: calls 1,017
1f8c2cc3: folds
*** TURN *** [Kc 9s 3d] [Ts]
3ed1bbd3: bets 1,688
45852cb2: raises 4,245 to 5,933
3ed1bbd3: folds
Uncalled bet (4,245) returned to 45852cb2
*** SHOWDOWN ***
45852cb2 collected 8,490 from pot
*** SUMMARY ***
Total pot 8,490 | Rake 0 | Jackpot 0 | Bingo 0 | Fortune 0 | Tax 0
Board [Kc 9s 3d Ts]
Seat 1: df6cc5a3 folded before Flop
Seat 2: 3ed1bbd3 folded on the Turn
Seat 3: Hero folded before Flop
Seat 4: 45852cb2 won (8,490)
Seat 5: d4334d47 (button) folded before Flop
Seat 6: 3308b4a8 (small blind) folded before Flop
Seat 7: 1f8c2cc3 (big blind) folded on the Flop
Seat 8: a6200c8b folded before Flop


Poker Hand #TM3567547548: Tournament #157476213, Bounty Hunters Special $1.08 Hold'em No Limit - Level8(200/400) - 2024/08/10 21:48:37
Table '47' 8-max Seat #4 is the button
Seat 1: df6cc5a3 (30,427 in chips)
Seat 2: 3ed1bbd3 (19,630 in chips)
Seat 3: Hero (15,789 in chips)
Seat 4: 45852cb2 (22,614 in chips)
Seat 5: d4334d47 (19,006 in chips)
Seat 6: 3308b4a8 (6,864 in chips)
Seat 7: 1f8c2cc3 (34,749 in chips)
Seat 8: a6200c8b (14,009 in chips)
a6200c8b: posts the ante 60
3308b4a8: posts the ante 60
d4334d47: posts the ante 60
3ed1bbd3: posts the ante 60
df6cc5a3: posts the ante 60
45852cb2: posts the ante 60
1f8c2cc3: posts the ante 60
Hero: posts the ante 60
d4334d47: posts small blind 200
3308b4a8: posts big blind 400
*** HOLE CARDS ***
Dealt to df6cc5a3 
Dealt to 3ed1bbd3 
Dealt to Hero [3d 5s]
Dealt to 45852cb2 
Dealt to d4334d47 
Dealt to 3308b4a8 
Dealt to 1f8c2cc3 
Dealt to a6200c8b 
1f8c2cc3: folds
a6200c8b: raises 13,549 to 13,949 and is all-in
df6cc5a3: folds
3ed1bbd3: folds
Hero: folds
45852cb2: folds
d4334d47: folds
3308b4a8: folds
Uncalled bet (13,549) returned to a6200c8b
*** SHOWDOWN ***
a6200c8b collected 1,480 from pot
*** SUMMARY ***
Total pot 1,480 | Rake 0 | Jackpot 0 | Bingo 0 | Fortune 0 | Tax 0
Seat 1: df6cc5a3 folded before Flop
Seat 2: 3ed1bbd3 folded before Flop
Seat 3: Hero folded before Flop
Seat 4: 45852cb2 (button) folded before Flop
Seat 5: d4334d47 (small blind) folded before Flop
Seat 6: 3308b4a8 (big blind) folded before Flop
Seat 7: 1f8c2cc3 folded before Flop
Seat 8: a6200c8b collected (1,480)


Poker Hand #TM3567547524: Tournament #157476213, Bounty Hunters Special $1.08 Hold'em No Limit - Level8(200/400) - 2024/08/10 21:47:47
Table '47' 8-max Seat #3 is the button
Seat 1: df6cc5a3 (30,487 in chips)
Seat 2: 3ed1bbd3 (19,690 in chips)
Seat 3: Hero (15,849 in chips)
Seat 4: 45852cb2 (20,994 in chips)
Seat 5: d4334d47 (20,266 in chips)
Seat 6: 3308b4a8 (6,924 in chips)
Seat 7: 1f8c2cc3 (34,809 in chips)
Seat 8: a6200c8b (14,069 in chips)
a6200c8b: posts the ante 60
3308b4a8: posts the ante 60
d4334d47: posts the ante 60
3ed1bbd3: posts the ante 60
df6cc5a3: posts the ante 60
45852cb2: posts the ante 60
1f8c2cc3: posts the ante 60
Hero: posts the ante 60
45852cb2: posts small blind 200
d4334d47: posts big blind 400
*** HOLE CARDS ***
Dealt to df6cc5a3 
Dealt to 3ed1bbd3 
Dealt to Hero [Qd 3h]
Dealt to 45852cb2 
Dealt to d4334d47 
Dealt to 3308b4a8 
Dealt to 1f8c2cc3 
Dealt to a6200c8b 
3308b4a8: folds
1f8c2cc3: folds
a6200c8b: folds
df6cc5a3: folds
3ed1bbd3: folds
Hero: folds
45852cb2: raises 800 to 1,200
d4334d47: calls 800
*** FLOP *** [9s Qh 5c]
45852cb2: bets 1,000
d4334d47: folds
Uncalled bet (1,000) returned to 45852cb2
*** SHOWDOWN ***
45852cb2 collected 2,880 from pot
*** SUMMARY ***
Total pot 2,880 | Rake 0 | Jackpot 0 | Bingo 0 | Fortune 0 | Tax 0
Board [9s Qh 5c]
Seat 1: df6cc5a3 folded before Flop
Seat 2: 3ed1bbd3 folded before Flop
Seat 3: Hero (button) folded before Flop
Seat 4: 45852cb2 (small blind) won (2,880)
Seat 5: d4334d47 (big blind) folded on the Flop
Seat 6: 3308b4a8 folded before Flop
Seat 7: 1f8c2cc3 folded before Flop
Seat 8: a6200c8b folded before Flop


Poker Hand #TM3567547486: Tournament #157476213, Bounty Hunters Special $1.08 Hold'em No Limit - Level7(175/350) - 2024/08/10 21:46:27
Table '47' 8-max Seat #2 is the button
Seat 1: df6cc5a3 (30,537 in chips)
Seat 2: 3ed1bbd3 (19,740 in chips)
Seat 3: Hero (16,074 in chips)
Seat 4: 45852cb2 (19,069 in chips)
Seat 5: d4334d47 (20,316 in chips)
Seat 6: 3308b4a8 (6,974 in chips)
Seat 7: 1f8c2cc3 (36,259 in chips)
Seat 8: a6200c8b (14,119 in chips)
a6200c8b: posts the ante 50
3308b4a8: posts the ante 50
d4334d47: posts the ante 50
3ed1bbd3: posts the ante 50
df6cc5a3: posts the ante 50
45852cb2: posts the ante 50
1f8c2cc3: posts the ante 50
Hero: posts the ante 50
Hero: posts small blind 175
45852cb2: posts big blind 350
*** HOLE CARDS ***
Dealt to df6cc5a3 
Dealt to 3ed1bbd3 
Dealt to Hero [3c 4s]
Dealt to 45852cb2 
Dealt to d4334d47 
Dealt to 3308b4a8 
Dealt to 1f8c2cc3 
Dealt to a6200c8b 
d4334d47: folds
3308b4a8: folds
1f8c2cc3: raises 350 to 700
a6200c8b: folds
df6cc5a3: folds
3ed1bbd3: folds
Hero: folds
45852cb2: calls 350
*** FLOP *** [9c Jc 6c]
45852cb2: checks
1f8c2cc3: checks
*** TURN *** [9c Jc 6c] [6h]
45852cb2: bets 700
1f8c2cc3: calls 700
*** RIVER *** [9c Jc 6c 6h] [7d]
45852cb2: bets 1,400
1f8c2cc3: folds
Uncalled bet (1,400) returned to 45852cb2
*** SHOWDOWN ***
45852cb2 collected 3,375 from pot
*** SUMMARY ***
Total pot 3,375 | Rake 0 | Jackpot 0 | Bingo 0 | Fortune 0 | Tax 0
Board [9c Jc 6c 6h 7d]
Seat 1: df6cc5a3 folded before Flop
Seat 2: 3ed1bbd3 (button) folded before Flop
Seat 3: Hero (small blind) folded before Flop
Seat 4: 45852cb2 (big blind) won (3,375)
Seat 5: d4334d47 folded before Flop
Seat 6: 3308b4a8 folded before Flop
Seat 7: 1f8c2cc3 folded on the River
Seat 8: a6200c8b folded before Flop


Poker Hand #TM3567547474: Tournament #157476213, Bounty Hunters Special $1.08 Hold'em No Limit - Level7(175/350) - 2024/08/10 21:45:58
Table '47' 8-max Seat #1 is the button
Seat 1: df6cc5a3 (29,662 in chips)
Seat 2: 3ed1bbd3 (19,965 in chips)
Seat 3: Hero (16,474 in chips)
Seat 4: 45852cb2 (19,119 in chips)
Seat 5: d4334d47 (20,366 in chips)
Seat 6: 3308b4a8 (7,024 in chips)
Seat 7: 1f8c2cc3 (36,309 in chips)
Seat 8: a6200c8b (14,169 in chips)
a6200c8b: posts the ante 50
3308b4a8: posts the ante 50
d4334d47: posts the ante 50
3ed1bbd3: posts the ante 50
df6cc5a3: posts the ante 50
45852cb2: posts the ante 50
1f8c2cc3: posts the ante 50
Hero: posts the ante 50
3ed1bbd3: posts small blind 175
Hero: posts big blind 350
*** HOLE CARDS ***
Dealt to df6cc5a3 
Dealt to 3ed1bbd3 
Dealt to Hero [7s Ah]
Dealt to 45852cb2 
Dealt to d4334d47 
Dealt to 3308b4a8 
Dealt to 1f8c2cc3 
Dealt to a6200c8b 
45852cb2: folds
d4334d47: folds
3308b4a8: folds
1f8c2cc3: folds
a6200c8b: folds
df6cc5a3: raises 700 to 1,050
3ed1bbd3: folds
Hero: folds
Uncalled bet (700) returned to df6cc5a3
*** SHOWDOWN ***
df6cc5a3 collected 1,275 from pot
*** SUMMARY ***
Total pot 1,275 | Rake 0 | Jackpot 0 | Bingo 0 | Fortune 0 | Tax 0
Seat 1: df6cc5a3 (button) collected (1,275)
Seat 2: 3ed1bbd3 (small blind) folded before Flop
Seat 3: Hero (big blind) folded before Flop
Seat 4: 45852cb2 folded before Flop
Seat 5: d4334d47 folded before Flop
Seat 6: 3308b4a8 folded before Flop
Seat 7: 1f8c2cc3 folded before Flop
Seat 8: a6200c8b folded before Flop


Poker Hand #TM3567547444: Tournament #157476213, Bounty Hunters Special $1.08 Hold'em No Limit - Level7(175/350) - 2024/08/10 21:45:01
Table '47' 8-max Seat #8 is the button
Seat 1: df6cc5a3 (29,887 in chips)
Seat 2: 3ed1bbd3 (18,040 in chips)
Seat 3: Hero (17,224 in chips)
Seat 4: 45852cb2 (19,169 in chips)
Seat 5: d4334d47 (21,116 in chips)
Seat 6: 3308b4a8 (7,074 in chips)
Seat 7: 1f8c2cc3 (36,359 in chips)
Seat 8: a6200c8b (14,219 in chips)
a6200c8b: posts the ante 50
3308b4a8: posts the ante 50
d4334d47: posts the ante 50
3ed1bbd3: posts the ante 50
df6cc5a3: posts the ante 50
45852cb2: posts the ante 50
1f8c2cc3: posts the ante 50
Hero: posts the ante 50
df6cc5a3: posts small blind 175
3ed1bbd3: posts big blind 350
*** HOLE CARDS ***
Dealt to df6cc5a3 
Dealt to 3ed1bbd3 
Dealt to Hero [Kh 9d]
Dealt to 45852cb2 
Dealt to d4334d47 
Dealt to 3308b4a8 
Dealt to 1f8c2cc3 
Dealt to a6200c8b 
Hero: raises 350 to 700
45852cb2: folds
d4334d47: calls 700
3308b4a8: folds
1f8c2cc3: folds
a6200c8b: folds
df6cc5a3: folds
3ed1bbd3: raises 17,290 to 17,990 and is all-in
Hero: folds
d4334d47: folds
Uncalled bet (17,290) returned to 3ed1bbd3
*** SHOWDOWN ***
3ed1bbd3 collected 2,675 from pot
*** SUMMARY ***
Total pot 2,675 | Rake 0 | Jackpot 0 | Bingo 0 | Fortune 0 | Tax 0
Seat 1: df6cc5a3 (small blind) folded before Flop
Seat 2: 3ed1bbd3 (big blind) collected (2,675)
Seat 3: Hero folded before Flop
Seat 4: 45852cb2 folded before Flop
Seat 5: d4334d47 folded before Flop
Seat 6: 3308b4a8 folded before Flop
Seat 7: 1f8c2cc3 folded before Flop
Seat 8: a6200c8b (button) folded before Flop


Poker Hand #TM3567547420: Tournament #157476213, Bounty Hunters Special $1.08 Hold'em No Limit - Level7(175/350) - 2024/08/10 21:44:13
Table '47' 8-max Seat #7 is the button
Seat 1: df6cc5a3 (29,187 in chips)
Seat 2: 3ed1bbd3 (18,090 in chips)
Seat 3: Hero (17,274 in chips)
Seat 4: 45852cb2 (19,219 in chips)
Seat 5: d4334d47 (21,166 in chips)
Seat 6: 3308b4a8 (7,124 in chips)
Seat 7: 1f8c2cc3 (36,409 in chips)
Seat 8: a6200c8b (14,619 in chips)
a6200c8b: posts the ante 50
3308b4a8: posts the ante 50
d4334d47: posts the ante 50
3ed1bbd3: posts the ante 50
df6cc5a3: posts the ante 50
45852cb2: posts the ante 50
1f8c2cc3: posts the ante 50
Hero: posts the ante 50
a6200c8b: posts small blind 175
df6cc5a3: posts big blind 350
*** HOLE CARDS ***
Dealt to df6cc5a3 
Dealt to 3ed1bbd3 
Dealt to Hero [3h 7d]
Dealt to 45852cb2 
Dealt to d4334d47 
Dealt to 3308b4a8 
Dealt to 1f8c2cc3 
Dealt to a6200c8b 
3ed1bbd3: folds
Hero: folds
45852cb2: folds
d4334d47: folds
3308b4a8: folds
1f8c2cc3: folds
a6200c8b: calls 175
df6cc5a3: checks
*** FLOP *** [5d 3s 9h]
a6200c8b: checks
df6cc5a3: bets 550
a6200c8b: folds
Uncalled bet (550) returned to df6cc5a3
*** SHOWDOWN ***
df6cc5a3 collected 1,100 from pot
*** SUMMARY ***
Total pot 1,100 | Rake 0 | Jackpot 0 | Bingo 0 | Fortune 0 | Tax 0
Board [5d 3s 9h]
Seat 1: df6cc5a3 (big blind) won (1,100)
Seat 2: 3ed1bbd3 folded before Flop
Seat 3: Hero folded before Flop
Seat 4: 45852cb2 folded before Flop
Seat 5: d4334d47 folded before Flop
Seat 6: 3308b4a8 folded before Flop
Seat 7: 1f8c2cc3 (button) folded before Flop
Seat 8: a6200c8b (small blind) folded on the Flop


Poker Hand #TM3567547361: Tournament #157476213, Bounty Hunters Special $1.08 Hold'em No Limit - Level7(175/350) - 2024/08/10 21:42:16
Table '47' 8-max Seat #6 is the button
Seat 1: df6cc5a3 (29,237 in chips)
Seat 2: 3ed1bbd3 (13,077 in chips)
Seat 3: Hero (17,324 in chips)
Seat 4: 45852cb2 (23,057 in chips)
Seat 5: d4334d47 (21,216 in chips)
Seat 6: 3308b4a8 (7,174 in chips)
Seat 7: 1f8c2cc3 (36,634 in chips)
Seat 8: a6200c8b (15,369 in chips)
a6200c8b: posts the ante 50
3308b4a8: posts the ante 50
d4334d47: posts the ante 50
3ed1bbd3: posts the ante 50
df6cc5a3: posts the ante 50
45852cb2: posts the ante 50
1f8c2cc3: posts the ante 50
Hero: posts the ante 50
1f8c2cc3: posts small blind 175
a6200c8b: posts big blind 350
*** HOLE CARDS ***
Dealt to df6cc5a3 
Dealt to 3ed1bbd3 
Dealt to Hero [As 7h]
Dealt to 45852cb2 
Dealt to d4334d47 
Dealt to 3308b4a8 
Dealt to 1f8c2cc3 
Dealt to a6200c8b 
df6cc5a3: folds
3ed1bbd3: calls 350
Hero: folds
45852cb2: raises 350 to 700
d4334d47: folds
3308b4a8: folds
1f8c2cc3: folds
a6200c8b: calls 350
3ed1bbd3: calls 350
*** FLOP *** [6s Qc 4d]
a6200c8b: checks
3ed1bbd3: checks
45852cb2: checks
*** TURN *** [6s Qc 4d] [9d]
a6200c8b: checks
3ed1bbd3: checks
45852cb2: bets 875
a6200c8b: folds
3ed1bbd3: calls 875
*** RIVER *** [6s Qc 4d 9d] [9s]
3ed1bbd3: checks
45852cb2: bets 2,213
3ed1bbd3: raises 9,239 to 11,452 and is all-in
45852cb2: folds
Uncalled bet (9,239) returned to 3ed1bbd3
*** SHOWDOWN ***
3ed1bbd3 collected 8,851 from pot
*** SUMMARY ***
Total pot 8,851 | Rake 0 | Jackpot 0 | Bingo 0 | Fortune 0 | Tax 0
Board [6s Qc 4d 9d 9s]
Seat 1: df6cc5a3 folded before Flop
Seat 2: 3ed1bbd3 won (8,851)
Seat 3: Hero folded before Flop
Seat 4: 45852cb2 folded on the River
Seat 5: d4334d47 folded before Flop
Seat 6: 3308b4a8 (button) folded before Flop
Seat 7: 1f8c2cc3 (small blind) folded before Flop
Seat 8: a6200c8b (big blind) folded on the Turn


Poker Hand #TM3567547322: Tournament #157476213, Bounty Hunters Special $1.08 Hold'em No Limit - Level7(175/350) - 2024/08/10 21:40:51
Table '47' 8-max Seat #5 is the button
Seat 1: df6cc5a3 (14,031 in chips)
Seat 2: 3ed1bbd3 (13,127 in chips)
Seat 3: Hero (17,374 in chips)
Seat 4: 45852cb2 (37,088 in chips)
Seat 5: d4334d47 (21,266 in chips)
Seat 6: 3308b4a8 (7,399 in chips)
Seat 7: 1f8c2cc3 (37,034 in chips)
Seat 8: a6200c8b (15,769 in chips)
a6200c8b: posts the ante 50
d4334d47: posts the ante 50
3308b4a8: posts the ante 50
3ed1bbd3: posts the ante 50
df6cc5a3: posts the ante 50
45852cb2: posts the ante 50
1f8c2cc3: posts the ante 50
Hero: posts the ante 50
3308b4a8: posts small blind 175
1f8c2cc3: posts big blind 350
*** HOLE CARDS ***
Dealt to df6cc5a3 
Dealt to 3ed1bbd3 
Dealt to Hero [9s Ad]
Dealt to 45852cb2 
Dealt to d4334d47 
Dealt to 3308b4a8 
Dealt to 1f8c2cc3 
Dealt to a6200c8b 
a6200c8b: calls 350
df6cc5a3: raises 350 to 700
3ed1bbd3: folds
Hero: folds
45852cb2: raises 36,338 to 37,038 and is all-in
d4334d47: folds
3308b4a8: folds
1f8c2cc3: folds
a6200c8b: folds
df6cc5a3: calls 13,281 and is all-in
Uncalled bet (23,057) returned to 45852cb2
45852cb2: shows [5h 5s]
df6cc5a3: shows [7s 7h]
*** FLOP *** [2h 8d Kd]
*** TURN *** [2h 8d Kd] [6c]
*** RIVER *** [2h 8d Kd 6c] [Jc]
*** SHOWDOWN ***
df6cc5a3 collected 29,237 from pot
*** SUMMARY ***
Total pot 29,237 | Rake 0 | Jackpot 0 | Bingo 0 | Fortune 0 | Tax 0
Board [2h 8d Kd 6c Jc]
Seat 1: df6cc5a3 showed [7s 7h] and won (29,237) with Pair of Sevens
Seat 2: 3ed1bbd3 folded before Flop
Seat 3: Hero folded before Flop
Seat 4: 45852cb2 showed [5h 5s] and lost with Pair of Fives
Seat 5: d4334d47 (button) folded before Flop
Seat 6: 3308b4a8 (small blind) folded before Flop
Seat 7: 1f8c2cc3 (big blind) folded before Flop
Seat 8: a6200c8b folded before Flop


Poker Hand #TM3567547277: Tournament #157476213, Bounty Hunters Special $1.08 Hold'em No Limit - Level7(175/350) - 2024/08/10 21:39:24
Table '47' 8-max Seat #4 is the button
Seat 1: df6cc5a3 (14,081 in chips)
Seat 2: 3ed1bbd3 (13,177 in chips)
Seat 3: Hero (17,424 in chips)
Seat 4: 45852cb2 (44,560 in chips)
Seat 5: d4334d47 (21,491 in chips)
Seat 6: 3308b4a8 (7,799 in chips)
Seat 7: 1f8c2cc3 (37,084 in chips)
Seat 8: a6200c8b (7,472 in chips)
a6200c8b: posts the ante 50
3308b4a8: posts the ante 50
d4334d47: posts the ante 50
3ed1bbd3: posts the ante 50
df6cc5a3: posts the ante 50
45852cb2: posts the ante 50
1f8c2cc3: posts the ante 50
Hero: posts the ante 50
d4334d47: posts small blind 175
3308b4a8: posts big blind 350
*** HOLE CARDS ***
Dealt to df6cc5a3 
Dealt to 3ed1bbd3 
Dealt to Hero [3c 5c]
Dealt to 45852cb2 
Dealt to d4334d47 
Dealt to 3308b4a8 
Dealt to 1f8c2cc3 
Dealt to a6200c8b 
1f8c2cc3: folds
a6200c8b: raises 7,072 to 7,422 and is all-in
df6cc5a3: folds
3ed1bbd3: folds
Hero: folds
45852cb2: raises 37,088 to 44,510 and is all-in
d4334d47: folds
3308b4a8: folds
Uncalled bet (37,088) returned to 45852cb2
45852cb2: shows [3s 3d]
a6200c8b: shows [Ac Ah]
*** FLOP *** [Qs 8c Jd]
*** TURN *** [Qs 8c Jd] [2c]
*** RIVER *** [Qs 8c Jd 2c] [7c]
*** SHOWDOWN ***
a6200c8b collected 15,769 from pot
*** SUMMARY ***
Total pot 15,769 | Rake 0 | Jackpot 0 | Bingo 0 | Fortune 0 | Tax 0
Board [Qs 8c Jd 2c 7c]
Seat 1: df6cc5a3 folded before Flop
Seat 2: 3ed1bbd3 folded before Flop
Seat 3: Hero folded before Flop
Seat 4: 45852cb2 (button) showed [3s 3d] and lost with Pair of Treys
Seat 5: d4334d47 (small blind) folded before Flop
Seat 6: 3308b4a8 (big blind) folded before Flop
Seat 7: 1f8c2cc3 folded before Flop
Seat 8: a6200c8b showed [Ac Ah] and won (15,769) with Pair of Aces


Poker Hand #TM3567547235: Tournament #157476213, Bounty Hunters Special $1.08 Hold'em No Limit - Level7(175/350) - 2024/08/10 21:37:59
Table '47' 8-max Seat #3 is the button
Seat 1: df6cc5a3 (14,131 in chips)
Seat 2: 3ed1bbd3 (13,227 in chips)
Seat 3: Hero (19,862 in chips)
Seat 4: 45852cb2 (44,785 in chips)
Seat 5: d4334d47 (22,241 in chips)
Seat 6: 3308b4a8 (7,849 in chips)
Seat 7: 1f8c2cc3 (31,083 in chips)
Seat 8: a6200c8b (9,910 in chips)
a6200c8b: posts the ante 50
3308b4a8: posts the ante 50
d4334d47: posts the ante 50
3ed1bbd3: posts the ante 50
df6cc5a3: posts the ante 50
45852cb2: posts the ante 50
1f8c2cc3: posts the ante 50
Hero: posts the ante 50
45852cb2: posts small blind 175
d4334d47: posts big blind 350
*** HOLE CARDS ***
Dealt to df6cc5a3 
Dealt to 3ed1bbd3 
Dealt to Hero [Tc Ks]
Dealt to 45852cb2 
Dealt to d4334d47 
Dealt to 3308b4a8 
Dealt to 1f8c2cc3 
Dealt to a6200c8b 
3308b4a8: folds
1f8c2cc3: raises 350 to 700
a6200c8b: calls 700
df6cc5a3: folds
3ed1bbd3: folds
Hero: calls 700
45852cb2: folds
d4334d47: calls 350
*** FLOP *** [8d 4d Kd]
d4334d47: checks
1f8c2cc3: checks
a6200c8b: checks
Hero: bets 1,688
d4334d47: folds
1f8c2cc3: calls 1,688
a6200c8b: calls 1,688
*** TURN *** [8d 4d Kd] [2h]
1f8c2cc3: checks
a6200c8b: checks
Hero: checks
*** RIVER *** [8d 4d Kd 2h] [5s]
1f8c2cc3: checks
a6200c8b: checks
Hero: checks
1f8c2cc3: shows [Kc Ac] (Pair of Kings)
a6200c8b: shows [Qh Jd] (King-High)
Hero: shows [Tc Ks] (Pair of Kings)
*** SHOWDOWN ***
1f8c2cc3 collected 8,439 from pot
*** SUMMARY ***
Total pot 8,439 | Rake 0 | Jackpot 0 | Bingo 0 | Fortune 0 | Tax 0
Board [8d 4d Kd 2h 5s]
Seat 1: df6cc5a3 folded before Flop
Seat 2: 3ed1bbd3 folded before Flop
Seat 3: Hero (button) showed [Tc Ks] and lost with Pair of Kings
Seat 4: 45852cb2 (small blind) folded before Flop
Seat 5: d4334d47 (big blind) folded on the Flop
Seat 6: 3308b4a8 folded before Flop
Seat 7: 1f8c2cc3 showed [Kc Ac] and won (8,439) with Pair of Kings
Seat 8: a6200c8b showed [Qh Jd] and lost with King-High


Poker Hand #TM3567547211: Tournament #157476213, Bounty Hunters Special $1.08 Hold'em No Limit - Level6(150/300) - 2024/08/10 21:37:08
Table '47' 8-max Seat #2 is the button
Seat 1: df6cc5a3 (14,176 in chips)
Seat 2: 3ed1bbd3 (13,272 in chips)
Seat 3: Hero (21,107 in chips)
Seat 4: 45852cb2 (42,070 in chips)
Seat 5: d4334d47 (22,286 in chips)
Seat 6: 3308b4a8 (9,094 in chips)
Seat 7: 1f8c2cc3 (31,128 in chips)
Seat 8: a6200c8b (9,955 in chips)
a6200c8b: posts the ante 45
3308b4a8: posts the ante 45
d4334d47: posts the ante 45
3ed1bbd3: posts the ante 45
df6cc5a3: posts the ante 45
45852cb2: posts the ante 45
1f8c2cc3: posts the ante 45
Hero: posts the ante 45
Hero: posts small blind 150
45852cb2: posts big blind 300
*** HOLE CARDS ***
Dealt to df6cc5a3 
Dealt to 3ed1bbd3 
Dealt to Hero [As Th]
Dealt to 45852cb2 
Dealt to d4334d47 
Dealt to 3308b4a8 
Dealt to 1f8c2cc3 
Dealt to a6200c8b 
d4334d47: folds
3308b4a8: raises 300 to 600
1f8c2cc3: folds
a6200c8b: folds
df6cc5a3: folds
3ed1bbd3: folds
Hero: calls 450
45852cb2: calls 300
*** FLOP *** [Jc Qc 9c]
Hero: checks
45852cb2: bets 600
3308b4a8: calls 600
Hero: calls 600
*** TURN *** [Jc Qc 9c] [2d]
Hero: checks
45852cb2: bets 1,980
3308b4a8: folds
Hero: folds
Uncalled bet (1,980) returned to 45852cb2
*** SHOWDOWN ***
45852cb2 collected 3,960 from pot
*** SUMMARY ***
Total pot 3,960 | Rake 0 | Jackpot 0 | Bingo 0 | Fortune 0 | Tax 0
Board [Jc Qc 9c 2d]
Seat 1: df6cc5a3 folded before Flop
Seat 2: 3ed1bbd3 (button) folded before Flop
Seat 3: Hero (small blind) folded on the Turn
Seat 4: 45852cb2 (big blind) won (3,960)
Seat 5: d4334d47 folded before Flop
Seat 6: 3308b4a8 folded on the Turn
Seat 7: 1f8c2cc3 folded before Flop
Seat 8: a6200c8b folded before Flop


Poker Hand #TM3567547164: Tournament #157476213, Bounty Hunters Special $1.08 Hold'em No Limit - Level6(150/300) - 2024/08/10 21:35:33
Table '47' 8-max Seat #1 is the button
Seat 1: df6cc5a3 (14,221 in chips)
Seat 2: 3ed1bbd3 (13,467 in chips)
Seat 3: Hero (21,452 in chips)
Seat 4: 45852cb2 (52,853 in chips)
Seat 5: d4334d47 (10,783 in chips)
Seat 6: 3308b4a8 (9,139 in chips)
Seat 7: 1f8c2cc3 (31,173 in chips)
Seat 8: a6200c8b (10,000 in chips)
a6200c8b: posts the ante 45
3308b4a8: posts the ante 45
d4334d47: posts the ante 45
3ed1bbd3: posts the ante 45
df6cc5a3: posts the ante 45
45852cb2: posts the ante 45
1f8c2cc3: posts the ante 45
Hero: posts the ante 45
3ed1bbd3: posts small blind 150
Hero: posts big blind 300
*** HOLE CARDS ***
Dealt to df6cc5a3 
Dealt to 3ed1bbd3 
Dealt to Hero [3d 7s]
Dealt to 45852cb2 
Dealt to d4334d47 
Dealt to 3308b4a8 
Dealt to 1f8c2cc3 
Dealt to a6200c8b 
45852cb2: raises 300 to 600
d4334d47: raises 2,010 to 2,610
3308b4a8: folds
1f8c2cc3: folds
a6200c8b: folds
df6cc5a3: folds
3ed1bbd3: folds
Hero: folds
45852cb2: calls 2,010
*** FLOP *** [2c 6s 2s]
45852cb2: checks
d4334d47: bets 1,990
45852cb2: raises 48,208 to 50,198 and is all-in
d4334d47: calls 6,138 and is all-in
Uncalled bet (42,070) returned to 45852cb2
45852cb2: shows [Qs Ts] (Pair of Twos)
d4334d47: shows [Kh Kc] (Pair of Kings and Pair of Twos)
*** TURN *** [2c 6s 2s] [Jh]
*** RIVER *** [2c 6s 2s Jh] [Qh]
*** SHOWDOWN ***
d4334d47 collected 22,286 from pot
*** SUMMARY ***
Total pot 22,286 | Rake 0 | Jackpot 0 | Bingo 0 | Fortune 0 | Tax 0
Board [2c 6s 2s Jh Qh]
Seat 1: df6cc5a3 (button) folded before Flop
Seat 2: 3ed1bbd3 (small blind) folded before Flop
Seat 3: Hero (big blind) folded before Flop
Seat 4: 45852cb2 showed [Qs Ts] and lost with Pair of Queens and Pair of Twos
Seat 5: d4334d47 showed [Kh Kc] and won (22,286) with Pair of Kings and Pair of Twos
Seat 6: 3308b4a8 folded before Flop
Seat 7: 1f8c2cc3 folded before Flop
Seat 8: a6200c8b folded before Flop


Poker Hand #TM3567547132: Tournament #157476213, Bounty Hunters Special $1.08 Hold'em No Limit - Level6(150/300) - 2024/08/10 21:34:24
Table '47' 8-max Seat #8 is the button
Seat 1: df6cc5a3 (14,416 in chips)
Seat 2: 3ed1bbd3 (13,812 in chips)
Seat 3: Hero (21,497 in chips)
Seat 4: 45852cb2 (39,297 in chips)
Seat 5: d4334d47 (10,828 in chips)
Seat 6: 3308b4a8 (9,184 in chips)
Seat 7: 1f8c2cc3 (31,218 in chips)
Seat 8: 65bab2e1 (12,836 in chips)
3308b4a8: posts the ante 45
d4334d47: posts the ante 45
3ed1bbd3: posts the ante 45
df6cc5a3: posts the ante 45
45852cb2: posts the ante 45
1f8c2cc3: posts the ante 45
Hero: posts the ante 45
65bab2e1: posts the ante 45
df6cc5a3: posts small blind 150
3ed1bbd3: posts big blind 300
*** HOLE CARDS ***
Dealt to df6cc5a3 
Dealt to 3ed1bbd3 
Dealt to Hero [6d Ks]
Dealt to 45852cb2 
Dealt to d4334d47 
Dealt to 3308b4a8 
Dealt to 1f8c2cc3 
Dealt to 65bab2e1 
Hero: folds
45852cb2: raises 300 to 600
d4334d47: folds
3308b4a8: folds
1f8c2cc3: folds
65bab2e1: calls 600
df6cc5a3: folds
3ed1bbd3: folds
*** FLOP *** [Ts 8s 6s]
45852cb2: bets 600
65bab2e1: raises 11,591 to 12,191 and is all-in
45852cb2: calls 11,591
65bab2e1: shows [Tc Kc] (Pair of Tens)
45852cb2: shows [Th 8h] (Pair of Tens and Pair of Eights)
*** TURN *** [Ts 8s 6s] [9h]
*** RIVER *** [Ts 8s 6s 9h] [Ac]
*** SHOWDOWN ***
45852cb2 collected 26,392 from pot
*** SUMMARY ***
Total pot 26,392 | Rake 0 | Jackpot 0 | Bingo 0 | Fortune 0 | Tax 0
Board [Ts 8s 6s 9h Ac]
Seat 1: df6cc5a3 (small blind) folded before Flop
Seat 2: 3ed1bbd3 (big blind) folded before Flop
Seat 3: Hero folded before Flop
Seat 4: 45852cb2 showed [Th 8h] and won (26,392) with Pair of Tens and Pair of Eights
Seat 5: d4334d47 folded before Flop
Seat 6: 3308b4a8 folded before Flop
Seat 7: 1f8c2cc3 folded before Flop
Seat 8: 65bab2e1 (button) showed [Tc Kc] and lost with Pair of Tens


Poker Hand #TM3567547106: Tournament #157476213, Bounty Hunters Special $1.08 Hold'em No Limit - Level6(150/300) - 2024/08/10 21:33:20
Table '47' 8-max Seat #7 is the button
Seat 1: df6cc5a3 (14,761 in chips)
Seat 2: 3ed1bbd3 (13,857 in chips)
Seat 3: Hero (21,542 in chips)
Seat 4: 45852cb2 (39,342 in chips)
Seat 5: d4334d47 (10,873 in chips)
Seat 6: 3308b4a8 (9,229 in chips)
Seat 7: 1f8c2cc3 (15,324 in chips)
Seat 8: 65bab2e1 (28,160 in chips)
3308b4a8: posts the ante 45
d4334d47: posts the ante 45
3ed1bbd3: posts the ante 45
df6cc5a3: posts the ante 45
45852cb2: posts the ante 45
1f8c2cc3: posts the ante 45
Hero: posts the ante 45
65bab2e1: posts the ante 45
65bab2e1: posts small blind 150
df6cc5a3: posts big blind 300
*** HOLE CARDS ***
Dealt to df6cc5a3 
Dealt to 3ed1bbd3 
Dealt to Hero [5s 9c]
Dealt to 45852cb2 
Dealt to d4334d47 
Dealt to 3308b4a8 
Dealt to 1f8c2cc3 
Dealt to 65bab2e1 
3ed1bbd3: folds
Hero: folds
45852cb2: folds
d4334d47: folds
3308b4a8: folds
1f8c2cc3: raises 300 to 600
65bab2e1: calls 450
df6cc5a3: folds
*** FLOP *** [3s 5h Ts]
65bab2e1: bets 930
1f8c2cc3: raises 1,860 to 2,790
65bab2e1: raises 24,725 to 27,515 and is all-in
1f8c2cc3: calls 11,889 and is all-in
Uncalled bet (12,836) returned to 65bab2e1
65bab2e1: shows [8d Th] (Pair of Tens)
1f8c2cc3: shows [Ks Kc] (Pair of Kings)
*** TURN *** [3s 5h Ts] [As]
*** RIVER *** [3s 5h Ts As] [2d]
*** SHOWDOWN ***
1f8c2cc3 collected 31,218 from pot
*** SUMMARY ***
Total pot 31,218 | Rake 0 | Jackpot 0 | Bingo 0 | Fortune 0 | Tax 0
Board [3s 5h Ts As 2d]
Seat 1: df6cc5a3 (big blind) folded before Flop
Seat 2: 3ed1bbd3 folded before Flop
Seat 3: Hero folded before Flop
Seat 4: 45852cb2 folded before Flop
Seat 5: d4334d47 folded before Flop
Seat 6: 3308b4a8 folded before Flop
Seat 7: 1f8c2cc3 (button) showed [Ks Kc] and won (31,218) with Pair of Kings
Seat 8: 65bab2e1 (small blind) showed [8d Th] and lost with Pair of Tens


Poker Hand #TM3567547053: Tournament #157476213, Bounty Hunters Special $1.08 Hold'em No Limit - Level6(150/300) - 2024/08/10 21:31:32
Table '47' 8-max Seat #6 is the button
Seat 1: df6cc5a3 (14,806 in chips)
Seat 2: 3ed1bbd3 (13,902 in chips)
Seat 3: Hero (21,587 in chips)
Seat 4: 45852cb2 (39,987 in chips)
Seat 5: d4334d47 (13,528 in chips)
Seat 6: 3308b4a8 (21,494 in chips)
Seat 7: 1f8c2cc3 (15,519 in chips)
Seat 8: 65bab2e1 (12,265 in chips)
3308b4a8: posts the ante 45
d4334d47: posts the ante 45
3ed1bbd3: posts the ante 45
df6cc5a3: posts the ante 45
45852cb2: posts the ante 45
1f8c2cc3: posts the ante 45
Hero: posts the ante 45
65bab2e1: posts the ante 45
1f8c2cc3: posts small blind 150
65bab2e1: posts big blind 300
*** HOLE CARDS ***
Dealt to df6cc5a3 
Dealt to 3ed1bbd3 
Dealt to Hero [6d As]
Dealt to 45852cb2 
Dealt to d4334d47 
Dealt to 3308b4a8 
Dealt to 1f8c2cc3 
Dealt to 65bab2e1 
df6cc5a3: folds
3ed1bbd3: folds
Hero: folds
45852cb2: raises 300 to 600
d4334d47: raises 2,010 to 2,610
3308b4a8: calls 2,610
1f8c2cc3: folds
65bab2e1: calls 2,310
45852cb2: folds
*** FLOP *** [9d 3s 2d]
65bab2e1: bets 4,470
d4334d47: folds
3308b4a8: raises 4,470 to 8,940
65bab2e1: calls 4,470
*** TURN *** [9d 3s 2d] [6s]
65bab2e1: checks
3308b4a8: bets 300
65bab2e1: calls 300
*** RIVER *** [9d 3s 2d 6s] [Qc]
65bab2e1: checks
3308b4a8: bets 450
65bab2e1: calls 370 and is all-in
Uncalled bet (80) returned to 3308b4a8
3308b4a8: shows [Js Jc] (Pair of Jacks)
65bab2e1: shows [5s Qd] (Pair of Queens)
*** SHOWDOWN ***
65bab2e1 collected 28,160 from pot
*** SUMMARY ***
Total pot 28,160 | Rake 0 | Jackpot 0 | Bingo 0 | Fortune 0 | Tax 0
Board [9d 3s 2d 6s Qc]
Seat 1: df6cc5a3 folded before Flop
Seat 2: 3ed1bbd3 folded before Flop
Seat 3: Hero folded before Flop
Seat 4: 45852cb2 folded before Flop
Seat 5: d4334d47 folded on the Flop
Seat 6: 3308b4a8 (button) showed [Js Jc] and lost with Pair of Jacks
Seat 7: 1f8c2cc3 (small blind) folded before Flop
Seat 8: 65bab2e1 (big blind) showed [5s Qd] and won (28,160) with Pair of Queens


Poker Hand #TM3567547026: Tournament #157476213, Bounty Hunters Special $1.08 Hold'em No Limit - Level6(150/300) - 2024/08/10 21:30:42
Table '47' 8-max Seat #5 is the button
Seat 1: df6cc5a3 (14,851 in chips)
Seat 2: 3ed1bbd3 (13,947 in chips)
Seat 3: Hero (21,632 in chips)
Seat 4: 45852cb2 (40,032 in chips)
Seat 5: d4334d47 (14,473 in chips)
Seat 6: 3308b4a8 (21,689 in chips)
Seat 7: 1f8c2cc3 (16,464 in chips)
Seat 8: 65bab2e1 (10,000 in chips)
d4334d47: posts the ante 45
3308b4a8: posts the ante 45
3ed1bbd3: posts the ante 45
df6cc5a3: posts the ante 45
45852cb2: posts the ante 45
1f8c2cc3: posts the ante 45
Hero: posts the ante 45
65bab2e1: posts the ante 45
3308b4a8: posts small blind 150
1f8c2cc3: posts big blind 300
*** HOLE CARDS ***
Dealt to df6cc5a3 
Dealt to 3ed1bbd3 
Dealt to Hero [8h 7s]
Dealt to 45852cb2 
Dealt to d4334d47 
Dealt to 3308b4a8 
Dealt to 1f8c2cc3 
Dealt to 65bab2e1 
65bab2e1: raises 600 to 900
df6cc5a3: folds
3ed1bbd3: folds
Hero: folds
45852cb2: folds
d4334d47: calls 900
3308b4a8: folds
1f8c2cc3: calls 600
*** FLOP *** [6c Kh 8s]
1f8c2cc3: checks
65bab2e1: bets 1,605
d4334d47: folds
1f8c2cc3: folds
Uncalled bet (1,605) returned to 65bab2e1
*** SHOWDOWN ***
65bab2e1 collected 3,210 from pot
*** SUMMARY ***
Total pot 3,210 | Rake 0 | Jackpot 0 | Bingo 0 | Fortune 0 | Tax 0
Board [6c Kh 8s]
Seat 1: df6cc5a3 folded before Flop
Seat 2: 3ed1bbd3 folded before Flop
Seat 3: Hero folded before Flop
Seat 4: 45852cb2 folded before Flop
Seat 5: d4334d47 (button) folded on the Flop
Seat 6: 3308b4a8 (small blind) folded before Flop
Seat 7: 1f8c2cc3 (big blind) folded on the Flop
Seat 8: 65bab2e1 won (3,210)


Poker Hand #TM3567546980: Tournament #157476213, Bounty Hunters Special $1.08 Hold'em No Limit - Level6(150/300) - 2024/08/10 21:29:16
Table '47' 8-max Seat #4 is the button
Seat 1: df6cc5a3 (14,896 in chips)
Seat 2: 3ed1bbd3 (13,992 in chips)
Seat 3: Hero (22,427 in chips)
Seat 4: 45852cb2 (42,212 in chips)
Seat 5: d4334d47 (14,668 in chips)
Seat 6: 3308b4a8 (18,384 in chips)
Seat 7: 1f8c2cc3 (16,509 in chips)
3308b4a8: posts the ante 45
d4334d47: posts the ante 45
3ed1bbd3: posts the ante 45
df6cc5a3: posts the ante 45
45852cb2: posts the ante 45
1f8c2cc3: posts the ante 45
Hero: posts the ante 45
d4334d47: posts small blind 150
3308b4a8: posts big blind 300
*** HOLE CARDS ***
Dealt to df6cc5a3 
Dealt to 3ed1bbd3 
Dealt to Hero [Ks Js]
Dealt to 45852cb2 
Dealt to d4334d47 
Dealt to 3308b4a8 
Dealt to 1f8c2cc3 
1f8c2cc3: folds
df6cc5a3: folds
3ed1bbd3: folds
Hero: raises 450 to 750
45852cb2: calls 750
d4334d47: folds
3308b4a8: calls 450
*** FLOP *** [6s Tc 5d]
3308b4a8: checks
Hero: checks
45852cb2: checks
*** TURN *** [6s Tc 5d] [Td]
3308b4a8: bets 1,385
Hero: folds
45852cb2: calls 1,385
*** RIVER *** [6s Tc 5d Td] [Kc]
3308b4a8: bets 3,098
45852cb2: folds
Uncalled bet (3,098) returned to 3308b4a8
3308b4a8: shows [7s 2h] (Pair of Tens)
*** SHOWDOWN ***
3308b4a8 collected 5,485 from pot
*** SUMMARY ***
Total pot 5,485 | Rake 0 | Jackpot 0 | Bingo 0 | Fortune 0 | Tax 0
Board [6s Tc 5d Td Kc]
Seat 1: df6cc5a3 folded before Flop
Seat 2: 3ed1bbd3 folded before Flop
Seat 3: Hero folded on the Turn
Seat 4: 45852cb2 (button) folded on the River
Seat 5: d4334d47 (small blind) folded before Flop
Seat 6: 3308b4a8 (big blind) showed [7s 2h] and won (5,485)
Seat 7: 1f8c2cc3 folded before Flop


Poker Hand #TM3567546925: Tournament #157476213, Bounty Hunters Special $1.08 Hold'em No Limit - Level5(125/250) - 2024/08/10 21:27:14
Table '47' 8-max Seat #3 is the button
Seat 1: df6cc5a3 (15,431 in chips)
Seat 2: 3ed1bbd3 (14,027 in chips)
Seat 3: Hero (22,962 in chips)
Seat 4: 45852cb2 (31,987 in chips)
Seat 5: d4334d47 (15,203 in chips)
Seat 6: 3308b4a8 (19,544 in chips)
Seat 7: 1f8c2cc3 (16,544 in chips)
Seat 8: d7fadc5d (7,390 in chips)
3308b4a8: posts the ante 35
d4334d47: posts the ante 35
3ed1bbd3: posts the ante 35
df6cc5a3: posts the ante 35
d7fadc5d: posts the ante 35
45852cb2: posts the ante 35
1f8c2cc3: posts the ante 35
Hero: posts the ante 35
45852cb2: posts small blind 125
d4334d47: posts big blind 250
*** HOLE CARDS ***
Dealt to df6cc5a3 
Dealt to 3ed1bbd3 
Dealt to Hero [8h 9h]
Dealt to 45852cb2 
Dealt to d4334d47 
Dealt to 3308b4a8 
Dealt to 1f8c2cc3 
Dealt to d7fadc5d 
3308b4a8: raises 250 to 500
1f8c2cc3: folds
d7fadc5d: calls 500
df6cc5a3: calls 500
3ed1bbd3: folds
Hero: calls 500
45852cb2: calls 375
d4334d47: calls 250
*** FLOP *** [Jd 4d Jh]
45852cb2: checks
d4334d47: checks
3308b4a8: checks
d7fadc5d: checks
df6cc5a3: checks
Hero: checks
*** TURN *** [Jd 4d Jh] [3c]
45852cb2: bets 625
d4334d47: folds
3308b4a8: calls 625
d7fadc5d: raises 6,230 to 6,855 and is all-in
df6cc5a3: folds
Hero: folds
45852cb2: calls 6,230
3308b4a8: folds
d7fadc5d: shows [7c 6c] (Pair of Jacks)
45852cb2: shows [Ad 7d] (Pair of Jacks)
*** RIVER *** [Jd 4d Jh 3c] [8c]
*** SHOWDOWN ***
45852cb2 collected 17,615 from pot
*** SUMMARY ***
Total pot 17,615 | Rake 0 | Jackpot 0 | Bingo 0 | Fortune 0 | Tax 0
Board [Jd 4d Jh 3c 8c]
Seat 1: df6cc5a3 folded on the Turn
Seat 2: 3ed1bbd3 folded before Flop
Seat 3: Hero (button) folded on the Turn
Seat 4: 45852cb2 (small blind) showed [Ad 7d] and won (17,615) with Pair of Jacks
Seat 5: d4334d47 (big blind) folded on the Turn
Seat 6: 3308b4a8 folded on the Turn
Seat 7: 1f8c2cc3 folded before Flop
Seat 8: d7fadc5d showed [7c 6c] and lost with Pair of Jacks


Poker Hand #TM3567546885: Tournament #157476213, Bounty Hunters Special $1.08 Hold'em No Limit - Level5(125/250) - 2024/08/10 21:26:02
Table '47' 8-max Seat #2 is the button
Seat 1: df6cc5a3 (12,146 in chips)
Seat 2: 3ed1bbd3 (14,062 in chips)
Seat 3: Hero (23,247 in chips)
Seat 4: 45852cb2 (32,272 in chips)
Seat 5: d4334d47 (15,238 in chips)
Seat 6: 3308b4a8 (19,579 in chips)
Seat 7: 1f8c2cc3 (16,579 in chips)
Seat 8: d7fadc5d (9,965 in chips)
3308b4a8: posts the ante 35
d4334d47: posts the ante 35
3ed1bbd3: posts the ante 35
df6cc5a3: posts the ante 35
d7fadc5d: posts the ante 35
45852cb2: posts the ante 35
1f8c2cc3: posts the ante 35
Hero: posts the ante 35
Hero: posts small blind 125
45852cb2: posts big blind 250
*** HOLE CARDS ***
Dealt to df6cc5a3 
Dealt to 3ed1bbd3 
Dealt to Hero [3s Ad]
Dealt to 45852cb2 
Dealt to d4334d47 
Dealt to 3308b4a8 
Dealt to 1f8c2cc3 
Dealt to d7fadc5d 
d4334d47: folds
3308b4a8: folds
1f8c2cc3: folds
d7fadc5d: calls 250
df6cc5a3: calls 250
3ed1bbd3: folds
Hero: calls 125
45852cb2: checks
*** FLOP *** [7h 7s 4c]
Hero: checks
45852cb2: checks
d7fadc5d: checks
df6cc5a3: bets 423
Hero: folds
45852cb2: folds
d7fadc5d: calls 423
*** TURN *** [7h 7s 4c] [Th]
d7fadc5d: bets 702
df6cc5a3: calls 702
*** RIVER *** [7h 7s 4c Th] [3d]
d7fadc5d: bets 1,165
df6cc5a3: raises 5,860 to 7,025
d7fadc5d: folds
Uncalled bet (5,860) returned to df6cc5a3
*** SHOWDOWN ***
df6cc5a3 collected 5,860 from pot
*** SUMMARY ***
Total pot 5,860 | Rake 0 | Jackpot 0 | Bingo 0 | Fortune 0 | Tax 0
Board [7h 7s 4c Th 3d]
Seat 1: df6cc5a3 won (5,860)
Seat 2: 3ed1bbd3 (button) folded before Flop
Seat 3: Hero (small blind) folded on the Flop
Seat 4: 45852cb2 (big blind) folded on the Flop
Seat 5: d4334d47 folded before Flop
Seat 6: 3308b4a8 folded before Flop
Seat 7: 1f8c2cc3 folded before Flop
Seat 8: d7fadc5d folded on the River


Poker Hand #TM3567546837: Tournament #157476213, Bounty Hunters Special $1.08 Hold'em No Limit - Level5(125/250) - 2024/08/10 21:24:15
Table '47' 8-max Seat #1 is the button
Seat 1: df6cc5a3 (12,730 in chips)
Seat 2: 3ed1bbd3 (14,222 in chips)
Seat 3: Hero (22,328 in chips)
Seat 4: 45852cb2 (32,307 in chips)
Seat 5: d4334d47 (15,273 in chips)
Seat 6: 3308b4a8 (19,614 in chips)
Seat 7: 1f8c2cc3 (16,614 in chips)
Seat 8: d7fadc5d (10,000 in chips)
3308b4a8: posts the ante 35
d4334d47: posts the ante 35
3ed1bbd3: posts the ante 35
df6cc5a3: posts the ante 35
d7fadc5d: posts the ante 35
45852cb2: posts the ante 35
1f8c2cc3: posts the ante 35
Hero: posts the ante 35
3ed1bbd3: posts small blind 125
Hero: posts big blind 250
*** HOLE CARDS ***
Dealt to df6cc5a3 
Dealt to 3ed1bbd3 
Dealt to Hero [5d 9h]
Dealt to 45852cb2 
Dealt to d4334d47 
Dealt to 3308b4a8 
Dealt to 1f8c2cc3 
Dealt to d7fadc5d 
45852cb2: folds
d4334d47: folds
3308b4a8: folds
1f8c2cc3: folds
d7fadc5d: folds
df6cc5a3: calls 250
3ed1bbd3: folds
Hero: checks
*** FLOP *** [5s 8c 9d]
Hero: checks
df6cc5a3: checks
*** TURN *** [5s 8c 9d] [5h]
Hero: bets 299
df6cc5a3: calls 299
*** RIVER *** [5s 8c 9d 5h] [Kd]
Hero: bets 752
df6cc5a3: folds
Uncalled bet (752) returned to Hero
*** SHOWDOWN ***
Hero collected 1,503 from pot
*** SUMMARY ***
Total pot 1,503 | Rake 0 | Jackpot 0 | Bingo 0 | Fortune 0 | Tax 0
Board [5s 8c 9d 5h Kd]
Seat 1: df6cc5a3 (button) folded on the River
Seat 2: 3ed1bbd3 (small blind) folded before Flop
Seat 3: Hero (big blind) won (1,503)
Seat 4: 45852cb2 folded before Flop
Seat 5: d4334d47 folded before Flop
Seat 6: 3308b4a8 folded before Flop
Seat 7: 1f8c2cc3 folded before Flop
Seat 8: d7fadc5d folded before Flop


Poker Hand #TM3567546812: Tournament #157476213, Bounty Hunters Special $1.08 Hold'em No Limit - Level5(125/250) - 2024/08/10 21:23:23
Table '47' 8-max Seat #7 is the button
Seat 1: df6cc5a3 (12,890 in chips)
Seat 2: 3ed1bbd3 (14,507 in chips)
Seat 3: Hero (22,363 in chips)
Seat 4: 45852cb2 (32,842 in chips)
Seat 5: d4334d47 (15,308 in chips)
Seat 6: 3308b4a8 (19,649 in chips)
Seat 7: 1f8c2cc3 (15,529 in chips)
3308b4a8: posts the ante 35
d4334d47: posts the ante 35
3ed1bbd3: posts the ante 35
df6cc5a3: posts the ante 35
45852cb2: posts the ante 35
1f8c2cc3: posts the ante 35
Hero: posts the ante 35
df6cc5a3: posts small blind 125
3ed1bbd3: posts big blind 250
*** HOLE CARDS ***
Dealt to df6cc5a3 
Dealt to 3ed1bbd3 
Dealt to Hero [Qd 6h]
Dealt to 45852cb2 
Dealt to d4334d47 
Dealt to 3308b4a8 
Dealt to 1f8c2cc3 
Hero: folds
45852cb2: raises 250 to 500
d4334d47: folds
3308b4a8: folds
1f8c2cc3: raises 1,185 to 1,685
df6cc5a3: folds
3ed1bbd3: folds
45852cb2: folds
Uncalled bet (1,185) returned to 1f8c2cc3
*** SHOWDOWN ***
1f8c2cc3 collected 1,620 from pot
*** SUMMARY ***
Total pot 1,620 | Rake 0 | Jackpot 0 | Bingo 0 | Fortune 0 | Tax 0
Seat 1: df6cc5a3 (small blind) folded before Flop
Seat 2: 3ed1bbd3 (big blind) folded before Flop
Seat 3: Hero folded before Flop
Seat 4: 45852cb2 folded before Flop
Seat 5: d4334d47 folded before Flop
Seat 6: 3308b4a8 folded before Flop
Seat 7: 1f8c2cc3 (button) collected (1,620)


Poker Hand #TM3567546767: Tournament #157476213, Bounty Hunters Special $1.08 Hold'em No Limit - Level5(125/250) - 2024/08/10 21:22:01
Table '47' 8-max Seat #6 is the button
Seat 1: df6cc5a3 (13,175 in chips)
Seat 2: 3ed1bbd3 (14,542 in chips)
Seat 3: Hero (22,398 in chips)
Seat 4: 45852cb2 (23,324 in chips)
Seat 5: d4334d47 (15,343 in chips)
Seat 6: 3308b4a8 (20,434 in chips)
Seat 7: 1f8c2cc3 (16,314 in chips)
Seat 8: acfab9cc (7,558 in chips)
3308b4a8: posts the ante 35
d4334d47: posts the ante 35
3ed1bbd3: posts the ante 35
df6cc5a3: posts the ante 35
45852cb2: posts the ante 35
acfab9cc: posts the ante 35
1f8c2cc3: posts the ante 35
Hero: posts the ante 35
1f8c2cc3: posts small blind 125
acfab9cc: posts big blind 250
*** HOLE CARDS ***
Dealt to df6cc5a3 
Dealt to 3ed1bbd3 
Dealt to Hero [3c Qc]
Dealt to 45852cb2 
Dealt to d4334d47 
Dealt to 3308b4a8 
Dealt to 1f8c2cc3 
Dealt to acfab9cc 
df6cc5a3: calls 250
3ed1bbd3: folds
Hero: folds
45852cb2: raises 500 to 750
d4334d47: folds
3308b4a8: calls 750
1f8c2cc3: calls 625
acfab9cc: raises 6,773 to 7,523 and is all-in
df6cc5a3: folds
45852cb2: raises 15,766 to 23,289 and is all-in
3308b4a8: folds
1f8c2cc3: folds
Uncalled bet (15,766) returned to 45852cb2
45852cb2: shows [Td Ts]
acfab9cc: shows [Ad Ac]
*** FLOP *** [Jd 2d Jh]
*** TURN *** [Jd 2d Jh] [8s]
*** RIVER *** [Jd 2d Jh 8s] [Tc]
*** SHOWDOWN ***
45852cb2 collected 17,076 from pot
*** SUMMARY ***
Total pot 17,076 | Rake 0 | Jackpot 0 | Bingo 0 | Fortune 0 | Tax 0
Board [Jd 2d Jh 8s Tc]
Seat 1: df6cc5a3 folded before Flop
Seat 2: 3ed1bbd3 folded before Flop
Seat 3: Hero folded before Flop
Seat 4: 45852cb2 showed [Td Ts] and won (17,076) with Tens Full over Jacks
Seat 5: d4334d47 folded before Flop
Seat 6: 3308b4a8 (button) folded before Flop
Seat 7: 1f8c2cc3 (small blind) folded before Flop
Seat 8: acfab9cc (big blind) showed [Ad Ac] and lost with Pair of Aces and Pair of Jacks


Poker Hand #TM3567546735: Tournament #157476213, Bounty Hunters Special $1.08 Hold'em No Limit - Level5(125/250) - 2024/08/10 21:21:05
Table '47' 8-max Seat #5 is the button
Seat 1: df6cc5a3 (13,210 in chips)
Seat 2: 3ed1bbd3 (24,154 in chips)
Seat 3: Hero (23,183 in chips)
Seat 4: 45852cb2 (23,359 in chips)
Seat 5: d4334d47 (15,378 in chips)
Seat 6: 3308b4a8 (9,612 in chips)
Seat 7: 1f8c2cc3 (16,599 in chips)
Seat 8: acfab9cc (7,593 in chips)
d4334d47: posts the ante 35
3308b4a8: posts the ante 35
3ed1bbd3: posts the ante 35
df6cc5a3: posts the ante 35
45852cb2: posts the ante 35
acfab9cc: posts the ante 35
1f8c2cc3: posts the ante 35
Hero: posts the ante 35
3308b4a8: posts small blind 125
1f8c2cc3: posts big blind 250
*** HOLE CARDS ***
Dealt to df6cc5a3 
Dealt to 3ed1bbd3 
Dealt to Hero [Ac Td]
Dealt to 45852cb2 
Dealt to d4334d47 
Dealt to 3308b4a8 
Dealt to 1f8c2cc3 
Dealt to acfab9cc 
acfab9cc: folds
df6cc5a3: folds
3ed1bbd3: raises 500 to 750
Hero: calls 750
45852cb2: folds
d4334d47: folds
3308b4a8: raises 8,827 to 9,577 and is all-in
1f8c2cc3: folds
3ed1bbd3: calls 8,827
Hero: folds
3308b4a8: shows [Ad Js]
3ed1bbd3: shows [Ah Ks]
*** FLOP *** [9d Qs 2s]
*** TURN *** [9d Qs 2s] [6d]
*** RIVER *** [9d Qs 2s 6d] [Jc]
Hero: shows [Ac Td] (Ace-High)
*** SHOWDOWN ***
3308b4a8 collected 20,434 from pot
*** SUMMARY ***
Total pot 20,434 | Rake 0 | Jackpot 0 | Bingo 0 | Fortune 0 | Tax 0
Board [9d Qs 2s 6d Jc]
Seat 1: df6cc5a3 folded before Flop
Seat 2: 3ed1bbd3 showed [Ah Ks] and lost with Ace-High
Seat 3: Hero folded before Flop
Seat 4: 45852cb2 folded before Flop
Seat 5: d4334d47 (button) folded before Flop
Seat 6: 3308b4a8 (small blind) showed [Ad Js] and won (20,434) with Pair of Jacks
Seat 7: 1f8c2cc3 (big blind) folded before Flop
Seat 8: acfab9cc folded before Flop


Poker Hand #TM3567546683: Tournament #157476213, Bounty Hunters Special $1.08 Hold'em No Limit - Level5(125/250) - 2024/08/10 21:19:27
Table '47' 8-max Seat #4 is the button
Seat 1: df6cc5a3 (13,245 in chips)
Seat 2: 3ed1bbd3 (24,189 in chips)
Seat 3: Hero (23,218 in chips)
Seat 4: 45852cb2 (26,174 in chips)
Seat 5: d4334d47 (12,103 in chips)
Seat 6: 3308b4a8 (9,897 in chips)
Seat 7: 1f8c2cc3 (16,634 in chips)
Seat 8: acfab9cc (7,628 in chips)
3308b4a8: posts the ante 35
d4334d47: posts the ante 35
3ed1bbd3: posts the ante 35
df6cc5a3: posts the ante 35
45852cb2: posts the ante 35
acfab9cc: posts the ante 35
1f8c2cc3: posts the ante 35
Hero: posts the ante 35
d4334d47: posts small blind 125
3308b4a8: posts big blind 250
*** HOLE CARDS ***
Dealt to df6cc5a3 
Dealt to 3ed1bbd3 
Dealt to Hero [8h 4c]
Dealt to 45852cb2 
Dealt to d4334d47 
Dealt to 3308b4a8 
Dealt to 1f8c2cc3 
Dealt to acfab9cc 
1f8c2cc3: folds
acfab9cc: folds
df6cc5a3: folds
3ed1bbd3: folds
Hero: folds
45852cb2: raises 250 to 500
d4334d47: raises 1,530 to 2,030
3308b4a8: folds
45852cb2: calls 1,530
*** FLOP *** [Ah Td Ac]
d4334d47: checks
45852cb2: bets 750
d4334d47: calls 750
*** TURN *** [Ah Td Ac] [Ad]
d4334d47: checks
45852cb2: checks
*** RIVER *** [Ah Td Ac Ad] [3s]
d4334d47: bets 6,090
45852cb2: folds
Uncalled bet (6,090) returned to d4334d47
*** SHOWDOWN ***
d4334d47 collected 6,090 from pot
*** SUMMARY ***
Total pot 6,090 | Rake 0 | Jackpot 0 | Bingo 0 | Fortune 0 | Tax 0
Board [Ah Td Ac Ad 3s]
Seat 1: df6cc5a3 folded before Flop
Seat 2: 3ed1bbd3 folded before Flop
Seat 3: Hero folded before Flop
Seat 4: 45852cb2 (button) folded on the River
Seat 5: d4334d47 (small blind) won (6,090)
Seat 6: 3308b4a8 (big blind) folded before Flop
Seat 7: 1f8c2cc3 folded before Flop
Seat 8: acfab9cc folded before Flop


Poker Hand #TM3567546658: Tournament #157476213, Bounty Hunters Special $1.08 Hold'em No Limit - Level5(125/250) - 2024/08/10 21:18:53
Table '47' 8-max Seat #3 is the button
Seat 1: df6cc5a3 (13,280 in chips)
Seat 2: 3ed1bbd3 (24,224 in chips)
Seat 3: Hero (23,253 in chips)
Seat 4: 45852cb2 (25,179 in chips)
Seat 5: d4334d47 (12,388 in chips)
Seat 6: 3308b4a8 (10,432 in chips)
Seat 7: 1f8c2cc3 (16,669 in chips)
Seat 8: acfab9cc (7,663 in chips)
3308b4a8: posts the ante 35
d4334d47: posts the ante 35
3ed1bbd3: posts the ante 35
df6cc5a3: posts the ante 35
45852cb2: posts the ante 35
acfab9cc: posts the ante 35
1f8c2cc3: posts the ante 35
Hero: posts the ante 35
45852cb2: posts small blind 125
d4334d47: posts big blind 250
*** HOLE CARDS ***
Dealt to df6cc5a3 
Dealt to 3ed1bbd3 
Dealt to Hero [Qh 3s]
Dealt to 45852cb2 
Dealt to d4334d47 
Dealt to 3308b4a8 
Dealt to 1f8c2cc3 
Dealt to acfab9cc 
3308b4a8: raises 250 to 500
1f8c2cc3: folds
acfab9cc: folds
df6cc5a3: folds
3ed1bbd3: folds
Hero: folds
45852cb2: raises 24,644 to 25,144 and is all-in
d4334d47: folds
3308b4a8: folds
Uncalled bet (24,644) returned to 45852cb2
*** SHOWDOWN ***
45852cb2 collected 1,530 from pot
*** SUMMARY ***
Total pot 1,530 | Rake 0 | Jackpot 0 | Bingo 0 | Fortune 0 | Tax 0
Seat 1: df6cc5a3 folded before Flop
Seat 2: 3ed1bbd3 folded before Flop
Seat 3: Hero (button) folded before Flop
Seat 4: 45852cb2 (small blind) collected (1,530)
Seat 5: d4334d47 (big blind) folded before Flop
Seat 6: 3308b4a8 folded before Flop
Seat 7: 1f8c2cc3 folded before Flop
Seat 8: acfab9cc folded before Flop


Poker Hand #TM3567546600: Tournament #157476213, Bounty Hunters Special $1.08 Hold'em No Limit - Level4(100/200) - 2024/08/10 21:17:17
Table '47' 8-max Seat #2 is the button
Seat 1: df6cc5a3 (13,310 in chips)
Seat 2: 3ed1bbd3 (24,254 in chips)
Seat 3: Hero (23,383 in chips)
Seat 4: 45852cb2 (25,609 in chips)
Seat 5: d4334d47 (9,490 in chips)
Seat 6: 3308b4a8 (12,650 in chips)
Seat 7: 1f8c2cc3 (16,699 in chips)
Seat 8: acfab9cc (7,693 in chips)
3308b4a8: posts the ante 30
d4334d47: posts the ante 30
3ed1bbd3: posts the ante 30
df6cc5a3: posts the ante 30
45852cb2: posts the ante 30
acfab9cc: posts the ante 30
1f8c2cc3: posts the ante 30
Hero: posts the ante 30
Hero: posts small blind 100
45852cb2: posts big blind 200
*** HOLE CARDS ***
Dealt to df6cc5a3 
Dealt to 3ed1bbd3 
Dealt to Hero [7h Kd]
Dealt to 45852cb2 
Dealt to d4334d47 
Dealt to 3308b4a8 
Dealt to 1f8c2cc3 
Dealt to acfab9cc 
d4334d47: raises 200 to 400
3308b4a8: calls 400
1f8c2cc3: folds
acfab9cc: folds
df6cc5a3: folds
3ed1bbd3: folds
Hero: folds
45852cb2: calls 200
*** FLOP *** [5c 9s Ah]
45852cb2: checks
d4334d47: bets 509
3308b4a8: calls 509
45852cb2: folds
*** TURN *** [5c 9s Ah] [4h]
d4334d47: bets 1,279
3308b4a8: calls 1,279
*** RIVER *** [5c 9s Ah 4h] [8s]
d4334d47: bets 7,272 and is all-in
3308b4a8: folds
Uncalled bet (7,272) returned to d4334d47
*** SHOWDOWN ***
d4334d47 collected 5,116 from pot
*** SUMMARY ***
Total pot 5,116 | Rake 0 | Jackpot 0 | Bingo 0 | Fortune 0 | Tax 0
Board [5c 9s Ah 4h 8s]
Seat 1: df6cc5a3 folded before Flop
Seat 2: 3ed1bbd3 (button) folded before Flop
Seat 3: Hero (small blind) folded before Flop
Seat 4: 45852cb2 (big blind) folded on the Flop
Seat 5: d4334d47 won (5,116)
Seat 6: 3308b4a8 folded on the River
Seat 7: 1f8c2cc3 folded before Flop
Seat 8: acfab9cc folded before Flop


Poker Hand #TM3567546561: Tournament #157476213, Bounty Hunters Special $1.08 Hold'em No Limit - Level4(100/200) - 2024/08/10 21:16:06
Table '47' 8-max Seat #1 is the button
Seat 1: df6cc5a3 (14,510 in chips)
Seat 2: 3ed1bbd3 (24,384 in chips)
Seat 3: Hero (24,583 in chips)
Seat 4: 45852cb2 (25,639 in chips)
Seat 5: d4334d47 (9,520 in chips)
Seat 6: 3308b4a8 (10,000 in chips)
Seat 7: 1f8c2cc3 (16,729 in chips)
Seat 8: acfab9cc (7,723 in chips)
3308b4a8: posts the ante 30
d4334d47: posts the ante 30
3ed1bbd3: posts the ante 30
df6cc5a3: posts the ante 30
45852cb2: posts the ante 30
acfab9cc: posts the ante 30
1f8c2cc3: posts the ante 30
Hero: posts the ante 30
3ed1bbd3: posts small blind 100
Hero: posts big blind 200
*** HOLE CARDS ***
Dealt to df6cc5a3 
Dealt to 3ed1bbd3 
Dealt to Hero [8c 2c]
Dealt to 45852cb2 
Dealt to d4334d47 
Dealt to 3308b4a8 
Dealt to 1f8c2cc3 
Dealt to acfab9cc 
45852cb2: folds
d4334d47: folds
3308b4a8: raises 200 to 400
1f8c2cc3: folds
acfab9cc: folds
df6cc5a3: calls 400
3ed1bbd3: folds
Hero: calls 200
*** FLOP *** [9d Kc 5c]
Hero: checks
3308b4a8: checks
df6cc5a3: checks
*** TURN *** [9d Kc 5c] [8d]
Hero: bets 770
3308b4a8: calls 770
df6cc5a3: calls 770
*** RIVER *** [9d Kc 5c 8d] [6h]
Hero: checks
3308b4a8: checks
df6cc5a3: checks
Hero: shows [8c 2c] (Pair of Eights)
3308b4a8: shows [Js Jh] (Pair of Jacks)
df6cc5a3: shows [6d Td] (Pair of Sixes)
*** SHOWDOWN ***
3308b4a8 collected 3,850 from pot
*** SUMMARY ***
Total pot 3,850 | Rake 0 | Jackpot 0 | Bingo 0 | Fortune 0 | Tax 0
Board [9d Kc 5c 8d 6h]
Seat 1: df6cc5a3 (button) showed [6d Td] and lost with Pair of Sixes
Seat 2: 3ed1bbd3 (small blind) folded before Flop
Seat 3: Hero (big blind) showed [8c 2c] and lost with Pair of Eights
Seat 4: 45852cb2 folded before Flop
Seat 5: d4334d47 folded before Flop
Seat 6: 3308b4a8 showed [Js Jh] and won (3,850) with Pair of Jacks
Seat 7: 1f8c2cc3 folded before Flop
Seat 8: acfab9cc folded before Flop


Poker Hand #TM3567546517: Tournament #157476213, Bounty Hunters Special $1.08 Hold'em No Limit - Level4(100/200) - 2024/08/10 21:14:49
Table '47' 8-max Seat #8 is the button
Seat 1: df6cc5a3 (14,640 in chips)
Seat 2: 3ed1bbd3 (24,614 in chips)
Seat 3: Hero (26,113 in chips)
Seat 4: 45852cb2 (28,823 in chips)
Seat 5: d4334d47 (9,550 in chips)
Seat 7: 1f8c2cc3 (11,595 in chips)
Seat 8: acfab9cc (7,753 in chips)
d4334d47: posts the ante 30
3ed1bbd3: posts the ante 30
df6cc5a3: posts the ante 30
45852cb2: posts the ante 30
acfab9cc: posts the ante 30
1f8c2cc3: posts the ante 30
Hero: posts the ante 30
df6cc5a3: posts small blind 100
3ed1bbd3: posts big blind 200
*** HOLE CARDS ***
Dealt to df6cc5a3 
Dealt to 3ed1bbd3 
Dealt to Hero [Jd Qc]
Dealt to 45852cb2 
Dealt to d4334d47 
Dealt to 1f8c2cc3 
Dealt to acfab9cc 
Hero: raises 240 to 440
45852cb2: calls 440
d4334d47: folds
1f8c2cc3: raises 1,060 to 1,500
acfab9cc: folds
df6cc5a3: folds
3ed1bbd3: folds
Hero: calls 1,060
45852cb2: calls 1,060
*** FLOP *** [Ah 2s 9c]
Hero: checks
45852cb2: checks
1f8c2cc3: bets 1,654
Hero: folds
45852cb2: calls 1,654
*** TURN *** [Ah 2s 9c] [3d]
45852cb2: checks
1f8c2cc3: bets 8,411 and is all-in
45852cb2: folds
Uncalled bet (8,411) returned to 1f8c2cc3
*** SHOWDOWN ***
1f8c2cc3 collected 8,318 from pot
*** SUMMARY ***
Total pot 8,318 | Rake 0 | Jackpot 0 | Bingo 0 | Fortune 0 | Tax 0
Board [Ah 2s 9c 3d]
Seat 1: df6cc5a3 (small blind) folded before Flop
Seat 2: 3ed1bbd3 (big blind) folded before Flop
Seat 3: Hero folded on the Flop
Seat 4: 45852cb2 folded on the Turn
Seat 5: d4334d47 folded before Flop
Seat 7: 1f8c2cc3 won (8,318)
Seat 8: acfab9cc (button) folded before Flop


Poker Hand #TM3567546480: Tournament #157476213, Bounty Hunters Special $1.08 Hold'em No Limit - Level4(100/200) - 2024/08/10 21:13:57
Table '47' 8-max Seat #7 is the button
Seat 1: df6cc5a3 (14,870 in chips)
Seat 3: Hero (23,168 in chips)
Seat 4: 45852cb2 (28,853 in chips)
Seat 5: d4334d47 (9,580 in chips)
Seat 6: d9152fa5 (17,891 in chips)
Seat 7: 1f8c2cc3 (11,625 in chips)
Seat 8: acfab9cc (7,883 in chips)
d9152fa5: posts the ante 30
d4334d47: posts the ante 30
df6cc5a3: posts the ante 30
45852cb2: posts the ante 30
1f8c2cc3: posts the ante 30
acfab9cc: posts the ante 30
Hero: posts the ante 30
acfab9cc: posts small blind 100
df6cc5a3: posts big blind 200
*** HOLE CARDS ***
Dealt to df6cc5a3 
Dealt to Hero [Qs Qh]
Dealt to 45852cb2 
Dealt to d4334d47 
Dealt to d9152fa5 
Dealt to 1f8c2cc3 
Dealt to acfab9cc 
Hero: calls 200
45852cb2: folds
d4334d47: folds
d9152fa5: raises 200 to 400
1f8c2cc3: folds
acfab9cc: folds
df6cc5a3: folds
Hero: raises 983 to 1,383
d9152fa5: calls 983
*** FLOP *** [As 8h Qc]
Hero: checks
d9152fa5: checks
*** TURN *** [As 8h Qc] [5c]
Hero: bets 1,082
d9152fa5: calls 1,082
*** RIVER *** [As 8h Qc 5c] [9d]
Hero: bets 4,080
d9152fa5: folds
Uncalled bet (4,080) returned to Hero
*** SHOWDOWN ***
Hero collected 5,440 from pot
*** SUMMARY ***
Total pot 5,440 | Rake 0 | Jackpot 0 | Bingo 0 | Fortune 0 | Tax 0
Board [As 8h Qc 5c 9d]
Seat 1: df6cc5a3 (big blind) folded before Flop
Seat 3: Hero won (5,440)
Seat 4: 45852cb2 folded before Flop
Seat 5: d4334d47 folded before Flop
Seat 6: d9152fa5 folded on the River
Seat 7: 1f8c2cc3 (button) folded before Flop
Seat 8: acfab9cc (small blind) folded before Flop


Poker Hand #TM3567546439: Tournament #157476213, Bounty Hunters Special $1.08 Hold'em No Limit - Level4(100/200) - 2024/08/10 21:12:48
Table '47' 8-max Seat #6 is the button
Seat 1: df6cc5a3 (15,894 in chips)
Seat 2: c9b363b5 (148 in chips)
Seat 3: Hero (20,552 in chips)
Seat 4: 45852cb2 (29,877 in chips)
Seat 5: d4334d47 (9,610 in chips)
Seat 6: d9152fa5 (17,921 in chips)
Seat 7: 1f8c2cc3 (11,755 in chips)
Seat 8: acfab9cc (8,113 in chips)
d9152fa5: posts the ante 30
d4334d47: posts the ante 30
df6cc5a3: posts the ante 30
45852cb2: posts the ante 30
c9b363b5: posts the ante 30
acfab9cc: posts the ante 30
1f8c2cc3: posts the ante 30
Hero: posts the ante 30
1f8c2cc3: posts small blind 100
acfab9cc: posts big blind 200
*** HOLE CARDS ***
Dealt to df6cc5a3 
Dealt to c9b363b5 
Dealt to Hero [Js Tc]
Dealt to 45852cb2 
Dealt to d4334d47 
Dealt to d9152fa5 
Dealt to 1f8c2cc3 
Dealt to acfab9cc 
df6cc5a3: calls 200
c9b363b5: calls 118 and is all-in
Hero: raises 794 to 994
45852cb2: calls 994
d4334d47: folds
d9152fa5: folds
1f8c2cc3: folds
acfab9cc: folds
df6cc5a3: calls 794
*** FLOP *** [6h 4h Jd]
df6cc5a3: checks
Hero: bets 19,528 and is all-in
45852cb2: folds
df6cc5a3: folds
Uncalled bet (19,528) returned to Hero
Hero: shows [Js Tc] (Pair of Jacks)
c9b363b5: shows [7s 3s] (Jack-High)
*** TURN *** [6h 4h Jd] [9h]
*** RIVER *** [6h 4h Jd 9h] [Qd]
*** SHOWDOWN ***
Hero collected 930 from pot
Hero collected 2,710 from pot
*** SUMMARY ***
Total pot 3,640 | Rake 0 | Jackpot 0 | Bingo 0 | Fortune 0 | Tax 0
Board [6h 4h Jd 9h Qd]
Seat 1: df6cc5a3 folded on the Flop
Seat 2: c9b363b5 showed [7s 3s] and lost with Queen-High
Seat 3: Hero showed [Js Tc] and won (3,640) with Pair of Jacks
Seat 4: 45852cb2 folded on the Flop
Seat 5: d4334d47 folded before Flop
Seat 6: d9152fa5 (button) folded before Flop
Seat 7: 1f8c2cc3 (small blind) folded before Flop
Seat 8: acfab9cc (big blind) folded before Flop


Poker Hand #TM3567546395: Tournament #157476213, Bounty Hunters Special $1.08 Hold'em No Limit - Level4(100/200) - 2024/08/10 21:11:27
Table '47' 8-max Seat #5 is the button
Seat 1: df6cc5a3 (15,924 in chips)
Seat 2: c9b363b5 (9,484 in chips)
Seat 3: Hero (9,336 in chips)
Seat 4: 45852cb2 (29,907 in chips)
Seat 5: d4334d47 (9,640 in chips)
Seat 6: d9152fa5 (18,051 in chips)
Seat 7: 1f8c2cc3 (11,985 in chips)
Seat 8: acfab9cc (9,543 in chips)
d4334d47: posts the ante 30
d9152fa5: posts the ante 30
df6cc5a3: posts the ante 30
45852cb2: posts the ante 30
c9b363b5: posts the ante 30
acfab9cc: posts the ante 30
1f8c2cc3: posts the ante 30
Hero: posts the ante 30
d9152fa5: posts small blind 100
1f8c2cc3: posts big blind 200
*** HOLE CARDS ***
Dealt to df6cc5a3 
Dealt to c9b363b5 
Dealt to Hero [Td Ad]
Dealt to 45852cb2 
Dealt to d4334d47 
Dealt to d9152fa5 
Dealt to 1f8c2cc3 
Dealt to acfab9cc 
acfab9cc: raises 400 to 600
df6cc5a3: folds
c9b363b5: calls 600
Hero: calls 600
45852cb2: folds
d4334d47: folds
d9152fa5: folds
1f8c2cc3: folds
*** FLOP *** [Th 8d 4d]
acfab9cc: bets 800
c9b363b5: raises 1,970 to 2,770
Hero: raises 5,936 to 8,706 and is all-in
acfab9cc: folds
c9b363b5: calls 5,936
Hero: shows [Td Ad] (Pair of Tens)
c9b363b5: shows [8s 8h] (Three Eights)
*** TURN *** [Th 8d 4d] [9s]
*** RIVER *** [Th 8d 4d 9s] [3d]
*** SHOWDOWN ***
Hero collected 20,552 from pot
*** SUMMARY ***
Total pot 20,552 | Rake 0 | Jackpot 0 | Bingo 0 | Fortune 0 | Tax 0
Board [Th 8d 4d 9s 3d]
Seat 1: df6cc5a3 folded before Flop
Seat 2: c9b363b5 showed [8s 8h] and lost with Three Eights
Seat 3: Hero showed [Td Ad] and won (20,552) with Ace High Flush
Seat 4: 45852cb2 folded before Flop
Seat 5: d4334d47 (button) folded before Flop
Seat 6: d9152fa5 (small blind) folded before Flop
Seat 7: 1f8c2cc3 (big blind) folded before Flop
Seat 8: acfab9cc folded on the Flop


Poker Hand #TM3567546362: Tournament #157476213, Bounty Hunters Special $1.08 Hold'em No Limit - Level4(100/200) - 2024/08/10 21:10:42
Table '47' 8-max Seat #4 is the button
Seat 1: df6cc5a3 (14,974 in chips)
Seat 2: c9b363b5 (9,514 in chips)
Seat 3: Hero (9,366 in chips)
Seat 4: 45852cb2 (29,937 in chips)
Seat 5: d4334d47 (9,770 in chips)
Seat 6: d9152fa5 (18,281 in chips)
Seat 7: 1f8c2cc3 (12,455 in chips)
Seat 8: acfab9cc (9,573 in chips)
d9152fa5: posts the ante 30
d4334d47: posts the ante 30
df6cc5a3: posts the ante 30
45852cb2: posts the ante 30
c9b363b5: posts the ante 30
acfab9cc: posts the ante 30
1f8c2cc3: posts the ante 30
Hero: posts the ante 30
d4334d47: posts small blind 100
d9152fa5: posts big blind 200
*** HOLE CARDS ***
Dealt to df6cc5a3 
Dealt to c9b363b5 
Dealt to Hero [Qs 9d]
Dealt to 45852cb2 
Dealt to d4334d47 
Dealt to d9152fa5 
Dealt to 1f8c2cc3 
Dealt to acfab9cc 
1f8c2cc3: raises 240 to 440
acfab9cc: folds
df6cc5a3: calls 440
c9b363b5: folds
Hero: folds
45852cb2: folds
d4334d47: folds
d9152fa5: folds
*** FLOP *** [3s 6h 5d]
1f8c2cc3: checks
df6cc5a3: bets 1,420
1f8c2cc3: folds
Uncalled bet (1,420) returned to df6cc5a3
*** SHOWDOWN ***
df6cc5a3 collected 1,420 from pot
*** SUMMARY ***
Total pot 1,420 | Rake 0 | Jackpot 0 | Bingo 0 | Fortune 0 | Tax 0
Board [3s 6h 5d]
Seat 1: df6cc5a3 won (1,420)
Seat 2: c9b363b5 folded before Flop
Seat 3: Hero folded before Flop
Seat 4: 45852cb2 (button) folded before Flop
Seat 5: d4334d47 (small blind) folded before Flop
Seat 6: d9152fa5 (big blind) folded before Flop
Seat 7: 1f8c2cc3 folded on the Flop
Seat 8: acfab9cc folded before Flop


Poker Hand #TM3567546316: Tournament #157476213, Bounty Hunters Special $1.08 Hold'em No Limit - Level4(100/200) - 2024/08/10 21:09:37
Table '47' 8-max Seat #3 is the button
Seat 1: df6cc5a3 (15,204 in chips)
Seat 2: c9b363b5 (9,544 in chips)
Seat 3: Hero (9,396 in chips)
Seat 4: 45852cb2 (29,327 in chips)
Seat 5: d4334d47 (10,000 in chips)
Seat 6: d9152fa5 (18,311 in chips)
Seat 7: 1f8c2cc3 (12,485 in chips)
Seat 8: acfab9cc (9,603 in chips)
d9152fa5: posts the ante 30
d4334d47: posts the ante 30
df6cc5a3: posts the ante 30
c9b363b5: posts the ante 30
45852cb2: posts the ante 30
acfab9cc: posts the ante 30
1f8c2cc3: posts the ante 30
Hero: posts the ante 30
45852cb2: posts small blind 100
d4334d47: posts big blind 200
*** HOLE CARDS ***
Dealt to df6cc5a3 
Dealt to c9b363b5 
Dealt to Hero [3h 4d]
Dealt to 45852cb2 
Dealt to d4334d47 
Dealt to d9152fa5 
Dealt to 1f8c2cc3 
Dealt to acfab9cc 
d9152fa5: folds
1f8c2cc3: folds
acfab9cc: folds
df6cc5a3: calls 200
c9b363b5: folds
Hero: folds
45852cb2: calls 100
d4334d47: checks
*** FLOP *** [8h 8s 4s]
45852cb2: bets 300
d4334d47: folds
df6cc5a3: folds
Uncalled bet (300) returned to 45852cb2
*** SHOWDOWN ***
45852cb2 collected 840 from pot
*** SUMMARY ***
Total pot 840 | Rake 0 | Jackpot 0 | Bingo 0 | Fortune 0 | Tax 0
Board [8h 8s 4s]
Seat 1: df6cc5a3 folded on the Flop
Seat 2: c9b363b5 folded before Flop
Seat 3: Hero (button) folded before Flop
Seat 4: 45852cb2 (small blind) won (840)
Seat 5: d4334d47 (big blind) folded on the Flop
Seat 6: d9152fa5 folded before Flop
Seat 7: 1f8c2cc3 folded before Flop
Seat 8: acfab9cc folded before Flop


Poker Hand #TM3567546286: Tournament #157476213, Bounty Hunters Special $1.08 Hold'em No Limit - Level4(100/200) - 2024/08/10 21:08:41
Table '47' 8-max Seat #2 is the button
Seat 1: df6cc5a3 (16,067 in chips)
Seat 2: c9b363b5 (8,231 in chips)
Seat 3: Hero (9,526 in chips)
Seat 4: 45852cb2 (29,557 in chips)
Seat 6: d9152fa5 (18,341 in chips)
Seat 7: 1f8c2cc3 (12,515 in chips)
Seat 8: acfab9cc (9,633 in chips)
d9152fa5: posts the ante 30
df6cc5a3: posts the ante 30
c9b363b5: posts the ante 30
45852cb2: posts the ante 30
acfab9cc: posts the ante 30
1f8c2cc3: posts the ante 30
Hero: posts the ante 30
Hero: posts small blind 100
45852cb2: posts big blind 200
*** HOLE CARDS ***
Dealt to df6cc5a3 
Dealt to c9b363b5 
Dealt to Hero [Qs 7d]
Dealt to 45852cb2 
Dealt to d9152fa5 
Dealt to 1f8c2cc3 
Dealt to acfab9cc 
d9152fa5: folds
1f8c2cc3: folds
acfab9cc: folds
df6cc5a3: raises 200 to 400
c9b363b5: calls 400
Hero: folds
45852cb2: folds
*** FLOP *** [2d 4d Th]
df6cc5a3: checks
c9b363b5: checks
*** TURN *** [2d 4d Th] [Qc]
df6cc5a3: bets 433
c9b363b5: calls 433
*** RIVER *** [2d 4d Th Qc] [Qd]
df6cc5a3: checks
c9b363b5: bets 1,888
df6cc5a3: folds
Uncalled bet (1,888) returned to c9b363b5
*** SHOWDOWN ***
c9b363b5 collected 2,176 from pot
*** SUMMARY ***
Total pot 2,176 | Rake 0 | Jackpot 0 | Bingo 0 | Fortune 0 | Tax 0
Board [2d 4d Th Qc Qd]
Seat 1: df6cc5a3 folded on the River
Seat 2: c9b363b5 (button) won (2,176)
Seat 3: Hero (small blind) folded before Flop
Seat 4: 45852cb2 (big blind) folded before Flop
Seat 6: d9152fa5 folded before Flop
Seat 7: 1f8c2cc3 folded before Flop
Seat 8: acfab9cc folded before Flop


Poker Hand #TM3567546263: Tournament #157476213, Bounty Hunters Special $1.08 Hold'em No Limit - Level4(100/200) - 2024/08/10 21:07:52
Table '47' 8-max Seat #1 is the button
Seat 1: df6cc5a3 (16,097 in chips)
Seat 2: c9b363b5 (8,361 in chips)
Seat 3: Hero (9,216 in chips)
Seat 4: 45852cb2 (29,587 in chips)
Seat 5: 2f2cfc26 (19,539 in chips)
Seat 6: d9152fa5 (18,371 in chips)
Seat 7: 1f8c2cc3 (12,545 in chips)
Seat 8: acfab9cc (9,663 in chips)
d9152fa5: posts the ante 30
2f2cfc26: posts the ante 30
df6cc5a3: posts the ante 30
45852cb2: posts the ante 30
c9b363b5: posts the ante 30
acfab9cc: posts the ante 30
1f8c2cc3: posts the ante 30
Hero: posts the ante 30
c9b363b5: posts small blind 100
Hero: posts big blind 200
*** HOLE CARDS ***
Dealt to df6cc5a3 
Dealt to c9b363b5 
Dealt to Hero [4c Qh]
Dealt to 45852cb2 
Dealt to 2f2cfc26 
Dealt to d9152fa5 
Dealt to 1f8c2cc3 
Dealt to acfab9cc 
45852cb2: folds
2f2cfc26: folds
d9152fa5: folds
1f8c2cc3: folds
acfab9cc: folds
df6cc5a3: folds
c9b363b5: folds
Uncalled bet (100) returned to Hero
*** SHOWDOWN ***
Hero collected 440 from pot
*** SUMMARY ***
Total pot 440 | Rake 0 | Jackpot 0 | Bingo 0 | Fortune 0 | Tax 0
Seat 1: df6cc5a3 (button) folded before Flop
Seat 2: c9b363b5 (small blind) folded before Flop
Seat 3: Hero (big blind) collected (440)
Seat 4: 45852cb2 folded before Flop
Seat 5: 2f2cfc26 folded before Flop
Seat 6: d9152fa5 folded before Flop
Seat 7: 1f8c2cc3 folded before Flop
Seat 8: acfab9cc folded before Flop


Poker Hand #TM3567546239: Tournament #157476213, Bounty Hunters Special $1.08 Hold'em No Limit - Level3(80/160) - 2024/08/10 21:07:15
Table '47' 8-max Seat #8 is the button
Seat 1: df6cc5a3 (15,449 in chips)
Seat 2: c9b363b5 (8,545 in chips)
Seat 3: Hero (9,240 in chips)
Seat 4: 45852cb2 (29,931 in chips)
Seat 5: 2f2cfc26 (19,563 in chips)
Seat 6: d9152fa5 (18,395 in chips)
Seat 7: 1f8c2cc3 (12,569 in chips)
Seat 8: acfab9cc (9,687 in chips)
d9152fa5: posts the ante 24
2f2cfc26: posts the ante 24
df6cc5a3: posts the ante 24
45852cb2: posts the ante 24
c9b363b5: posts the ante 24
acfab9cc: posts the ante 24
1f8c2cc3: posts the ante 24
Hero: posts the ante 24
df6cc5a3: posts small blind 80
c9b363b5: posts big blind 160
*** HOLE CARDS ***
Dealt to df6cc5a3 
Dealt to c9b363b5 
Dealt to Hero [3c 7s]
Dealt to 45852cb2 
Dealt to 2f2cfc26 
Dealt to d9152fa5 
Dealt to 1f8c2cc3 
Dealt to acfab9cc 
Hero: folds
45852cb2: raises 160 to 320
2f2cfc26: folds
d9152fa5: folds
1f8c2cc3: folds
acfab9cc: folds
df6cc5a3: raises 15,105 to 15,425 and is all-in
c9b363b5: folds
45852cb2: folds
Uncalled bet (15,105) returned to df6cc5a3
*** SHOWDOWN ***
df6cc5a3 collected 992 from pot
*** SUMMARY ***
Total pot 992 | Rake 0 | Jackpot 0 | Bingo 0 | Fortune 0 | Tax 0
Seat 1: df6cc5a3 (small blind) collected (992)
Seat 2: c9b363b5 (big blind) folded before Flop
Seat 3: Hero folded before Flop
Seat 4: 45852cb2 folded before Flop
Seat 5: 2f2cfc26 folded before Flop
Seat 6: d9152fa5 folded before Flop
Seat 7: 1f8c2cc3 folded before Flop
Seat 8: acfab9cc (button) folded before Flop


Poker Hand #TM3567546206: Tournament #157476213, Bounty Hunters Special $1.08 Hold'em No Limit - Level3(80/160) - 2024/08/10 21:06:13
Table '47' 8-max Seat #7 is the button
Seat 1: df6cc5a3 (15,793 in chips)
Seat 2: c9b363b5 (8,569 in chips)
Seat 3: Hero (9,584 in chips)
Seat 4: 45852cb2 (29,955 in chips)
Seat 5: 2f2cfc26 (18,675 in chips)
Seat 6: d9152fa5 (18,419 in chips)
Seat 7: 1f8c2cc3 (12,593 in chips)
Seat 8: acfab9cc (9,791 in chips)
d9152fa5: posts the ante 24
2f2cfc26: posts the ante 24
df6cc5a3: posts the ante 24
45852cb2: posts the ante 24
c9b363b5: posts the ante 24
1f8c2cc3: posts the ante 24
acfab9cc: posts the ante 24
Hero: posts the ante 24
acfab9cc: posts small blind 80
df6cc5a3: posts big blind 160
*** HOLE CARDS ***
Dealt to df6cc5a3 
Dealt to c9b363b5 
Dealt to Hero [8s As]
Dealt to 45852cb2 
Dealt to 2f2cfc26 
Dealt to d9152fa5 
Dealt to 1f8c2cc3 
Dealt to acfab9cc 
c9b363b5: folds
Hero: raises 160 to 320
45852cb2: folds
2f2cfc26: calls 320
d9152fa5: folds
1f8c2cc3: folds
acfab9cc: folds
df6cc5a3: calls 160
*** FLOP *** [2d Qc 4c]
df6cc5a3: checks
Hero: checks
2f2cfc26: bets 345
df6cc5a3: folds
Hero: folds
Uncalled bet (345) returned to 2f2cfc26
*** SHOWDOWN ***
2f2cfc26 collected 1,232 from pot
*** SUMMARY ***
Total pot 1,232 | Rake 0 | Jackpot 0 | Bingo 0 | Fortune 0 | Tax 0
Board [2d Qc 4c]
Seat 1: df6cc5a3 (big blind) folded on the Flop
Seat 2: c9b363b5 folded before Flop
Seat 3: Hero folded on the Flop
Seat 4: 45852cb2 folded before Flop
Seat 5: 2f2cfc26 won (1,232)
Seat 6: d9152fa5 folded before Flop
Seat 7: 1f8c2cc3 (button) folded before Flop
Seat 8: acfab9cc (small blind) folded before Flop


Poker Hand #TM3567546169: Tournament #157476213, Bounty Hunters Special $1.08 Hold'em No Limit - Level3(80/160) - 2024/08/10 21:05:05
Table '47' 8-max Seat #6 is the button
Seat 1: df6cc5a3 (15,817 in chips)
Seat 2: c9b363b5 (8,593 in chips)
Seat 3: Hero (9,928 in chips)
Seat 4: 45852cb2 (29,979 in chips)
Seat 5: 2f2cfc26 (19,019 in chips)
Seat 6: d9152fa5 (18,443 in chips)
Seat 7: 1f8c2cc3 (12,697 in chips)
Seat 8: acfab9cc (8,903 in chips)
d9152fa5: posts the ante 24
2f2cfc26: posts the ante 24
df6cc5a3: posts the ante 24
45852cb2: posts the ante 24
c9b363b5: posts the ante 24
acfab9cc: posts the ante 24
1f8c2cc3: posts the ante 24
Hero: posts the ante 24
1f8c2cc3: posts small blind 80
acfab9cc: posts big blind 160
*** HOLE CARDS ***
Dealt to df6cc5a3 
Dealt to c9b363b5 
Dealt to Hero [9s Jc]
Dealt to 45852cb2 
Dealt to 2f2cfc26 
Dealt to d9152fa5 
Dealt to 1f8c2cc3 
Dealt to acfab9cc 
df6cc5a3: folds
c9b363b5: folds
Hero: raises 160 to 320
45852cb2: folds
2f2cfc26: calls 320
d9152fa5: folds
1f8c2cc3: folds
acfab9cc: calls 160
*** FLOP *** [6c 4c Qs]
acfab9cc: checks
Hero: checks
2f2cfc26: checks
*** TURN *** [6c 4c Qs] [9h]
acfab9cc: bets 320
Hero: folds
2f2cfc26: folds
Uncalled bet (320) returned to acfab9cc
*** SHOWDOWN ***
acfab9cc collected 1,232 from pot
*** SUMMARY ***
Total pot 1,232 | Rake 0 | Jackpot 0 | Bingo 0 | Fortune 0 | Tax 0
Board [6c 4c Qs 9h]
Seat 1: df6cc5a3 folded before Flop
Seat 2: c9b363b5 folded before Flop
Seat 3: Hero folded on the Turn
Seat 4: 45852cb2 folded before Flop
Seat 5: 2f2cfc26 folded on the Turn
Seat 6: d9152fa5 (button) folded before Flop
Seat 7: 1f8c2cc3 (small blind) folded before Flop
Seat 8: acfab9cc (big blind) won (1,232)


Poker Hand #TM3567546148: Tournament #157476213, Bounty Hunters Special $1.08 Hold'em No Limit - Level3(80/160) - 2024/08/10 21:04:26
Table '47' 8-max Seat #5 is the button
Seat 1: df6cc5a3 (15,841 in chips)
Seat 2: c9b363b5 (8,617 in chips)
Seat 3: Hero (9,952 in chips)
Seat 4: 45852cb2 (30,003 in chips)
Seat 5: 2f2cfc26 (18,611 in chips)
Seat 6: d9152fa5 (18,547 in chips)
Seat 7: 1f8c2cc3 (12,881 in chips)
Seat 8: acfab9cc (8,927 in chips)
d9152fa5: posts the ante 24
2f2cfc26: posts the ante 24
df6cc5a3: posts the ante 24
45852cb2: posts the ante 24
c9b363b5: posts the ante 24
acfab9cc: posts the ante 24
1f8c2cc3: posts the ante 24
Hero: posts the ante 24
d9152fa5: posts small blind 80
1f8c2cc3: posts big blind 160
*** HOLE CARDS ***
Dealt to df6cc5a3 
Dealt to c9b363b5 
Dealt to Hero [Kc 2s]
Dealt to 45852cb2 
Dealt to 2f2cfc26 
Dealt to d9152fa5 
Dealt to 1f8c2cc3 
Dealt to acfab9cc 
acfab9cc: folds
df6cc5a3: folds
c9b363b5: folds
Hero: folds
45852cb2: folds
2f2cfc26: raises 176 to 336
d9152fa5: folds
1f8c2cc3: folds
Uncalled bet (176) returned to 2f2cfc26
*** SHOWDOWN ***
2f2cfc26 collected 592 from pot
*** SUMMARY ***
Total pot 592 | Rake 0 | Jackpot 0 | Bingo 0 | Fortune 0 | Tax 0
Seat 1: df6cc5a3 folded before Flop
Seat 2: c9b363b5 folded before Flop
Seat 3: Hero folded before Flop
Seat 4: 45852cb2 folded before Flop
Seat 5: 2f2cfc26 (button) collected (592)
Seat 6: d9152fa5 (small blind) folded before Flop
Seat 7: 1f8c2cc3 (big blind) folded before Flop
Seat 8: acfab9cc folded before Flop


Poker Hand #TM3567546117: Tournament #157476213, Bounty Hunters Special $1.08 Hold'em No Limit - Level3(80/160) - 2024/08/10 21:03:24
Table '47' 8-max Seat #4 is the button
Seat 1: df6cc5a3 (17,622 in chips)
Seat 2: c9b363b5 (8,641 in chips)
Seat 3: Hero (9,976 in chips)
Seat 4: 45852cb2 (30,027 in chips)
Seat 5: 2f2cfc26 (18,715 in chips)
Seat 6: d9152fa5 (16,542 in chips)
Seat 7: 1f8c2cc3 (12,905 in chips)
Seat 8: acfab9cc (8,951 in chips)
d9152fa5: posts the ante 24
2f2cfc26: posts the ante 24
df6cc5a3: posts the ante 24
45852cb2: posts the ante 24
c9b363b5: posts the ante 24
acfab9cc: posts the ante 24
1f8c2cc3: posts the ante 24
Hero: posts the ante 24
2f2cfc26: posts small blind 80
d9152fa5: posts big blind 160
*** HOLE CARDS ***
Dealt to df6cc5a3 
Dealt to c9b363b5 
Dealt to Hero [3h 5d]
Dealt to 45852cb2 
Dealt to 2f2cfc26 
Dealt to d9152fa5 
Dealt to 1f8c2cc3 
Dealt to acfab9cc 
1f8c2cc3: folds
acfab9cc: folds
df6cc5a3: raises 160 to 320
c9b363b5: folds
Hero: folds
45852cb2: folds
2f2cfc26: folds
d9152fa5: raises 684 to 1,004
df6cc5a3: calls 684
*** FLOP *** [6c Kd 2s]
d9152fa5: bets 753
df6cc5a3: calls 753
*** TURN *** [6c Kd 2s] [6d]
d9152fa5: bets 2,840
df6cc5a3: folds
Uncalled bet (2,840) returned to d9152fa5
*** SHOWDOWN ***
d9152fa5 collected 3,786 from pot
*** SUMMARY ***
Total pot 3,786 | Rake 0 | Jackpot 0 | Bingo 0 | Fortune 0 | Tax 0
Board [6c Kd 2s 6d]
Seat 1: df6cc5a3 folded on the Turn
Seat 2: c9b363b5 folded before Flop
Seat 3: Hero folded before Flop
Seat 4: 45852cb2 (button) folded before Flop
Seat 5: 2f2cfc26 (small blind) folded before Flop
Seat 6: d9152fa5 (big blind) won (3,786)
Seat 7: 1f8c2cc3 folded before Flop
Seat 8: acfab9cc folded before Flop


Poker Hand #TM3567416663: Tournament #157476213, Bounty Hunters Special $1.08 Hold'em No Limit - Level3(80/160) - 2024/08/10 21:02:37
Table '165' 8-max Seat #5 is the button
Seat 1: ff911c57 (10,000 in chips)
Seat 2: 3469a68a (10,000 in chips)
Seat 3: cacabacc (10,000 in chips)
Seat 4: f8fcd84e (10,000 in chips)
Seat 5: Hero (10,000 in chips)
Seat 6: 7158f49e (10,000 in chips)
cacabacc: posts the ante 24
ff911c57: posts the ante 24
3469a68a: posts the ante 24
Hero: posts the ante 24
f8fcd84e: posts the ante 24
7158f49e: posts the ante 24
7158f49e: posts small blind 80
ff911c57: posts big blind 160
*** HOLE CARDS ***
Dealt to ff911c57 
Dealt to 3469a68a 
Dealt to cacabacc 
Dealt to f8fcd84e 
Dealt to Hero [2h Jd]
Dealt to 7158f49e 
3469a68a: raises 160 to 320
cacabacc: raises 9,656 to 9,976 and is all-in
f8fcd84e: calls 9,976 and is all-in
Hero: folds
7158f49e: folds
ff911c57: folds
3469a68a: calls 9,656 and is all-in
cacabacc: shows [9d 9h]
f8fcd84e: shows [Ah Td]
3469a68a: shows [Js As]
*** FLOP *** [Kc Qh 2c]
*** TURN *** [Kc Qh 2c] [7h]
*** RIVER *** [Kc Qh 2c 7h] [8h]
ff911c57: shows [Ks 3c] (Pair of Kings)
*** SHOWDOWN ***
cacabacc collected 30,312 from pot
*** SUMMARY ***
Total pot 30,312 | Rake 0 | Jackpot 0 | Bingo 0 | Fortune 0 | Tax 0
Board [Kc Qh 2c 7h 8h]
Seat 1: ff911c57 (big blind) folded before Flop
Seat 2: 3469a68a showed [Js As] and lost with Ace-High
Seat 3: cacabacc showed [9d 9h] and won (30,312) with Pair of Nines
Seat 4: f8fcd84e showed [Ah Td] and lost with Ace-High
Seat 5: Hero (button) folded before Flop
Seat 6: 7158f49e (small blind) folded before Flop


