Poker Hand #TM3547543955: Tournament #156323098, Bounty Hunters $1.08 Hold'em No Limit - Level19(1,750/3,500) - 2024/08/04 00:50:05
Table '12' 8-max Seat #6 is the button
Seat 1: Hero (37,058 in chips)
Seat 2: de851319 (333,906 in chips)
Seat 3: 42d07d8f (50,300 in chips)
Seat 4: 95b2710a (111,083 in chips)
Seat 5: a75b7bb6 (28,226 in chips)
Seat 6: a88021a (228,502 in chips)
Seat 7: eca57803 (67,931 in chips)
95b2710a: posts the ante 500
42d07d8f: posts the ante 500
eca57803: posts the ante 500
de851319: posts the ante 500
a75b7bb6: posts the ante 500
Hero: posts the ante 500
a88021a: posts the ante 500
eca57803: posts small blind 1,750
Hero: posts big blind 3,500
*** HOLE CARDS ***
Dealt to Hero [Ah Ad]
Dealt to de851319 
Dealt to 42d07d8f 
Dealt to 95b2710a 
Dealt to a75b7bb6 
Dealt to a88021a 
Dealt to eca57803 
de851319: folds
42d07d8f: folds
95b2710a: folds
a75b7bb6: folds
a88021a: raises 3,500 to 7,000
eca57803: folds
Hero: raises 29,558 to 36,558 and is all-in
a88021a: calls 29,558
Hero: shows [Ah Ad]
a88021a: shows [Jc 9s]
*** FLOP *** [3d 4s 5s]
*** TURN *** [3d 4s 5s] [6s]
*** RIVER *** [3d 4s 5s 6s] [As]
*** SHOWDOWN ***
a88021a collected 78,366 from pot
*** SUMMARY ***
Total pot 78,366 | Rake 0 | Jackpot 0 | Bingo 0 | Fortune 0 | Tax 0
Board [3d 4s 5s 6s As]
Seat 1: Hero (big blind) showed [Ah Ad] and lost with Three Aces
Seat 2: de851319 folded before Flop
Seat 3: 42d07d8f folded before Flop
Seat 4: 95b2710a folded before Flop
Seat 5: a75b7bb6 folded before Flop
Seat 6: a88021a (button) showed [Jc 9s] and won (78,366) with Ace High Flush
Seat 7: eca57803 (small blind) folded before Flop


Poker Hand #TM3547543941: Tournament #156323098, Bounty Hunters $1.08 Hold'em No Limit - Level19(1,750/3,500) - 2024/08/04 00:49:42
Table '12' 8-max Seat #5 is the button
Seat 1: Hero (37,558 in chips)
Seat 2: de851319 (334,406 in chips)
Seat 3: 42d07d8f (50,800 in chips)
Seat 4: 95b2710a (111,583 in chips)
Seat 5: a75b7bb6 (28,726 in chips)
Seat 6: a88021a (222,002 in chips)
Seat 7: eca57803 (71,931 in chips)
95b2710a: posts the ante 500
42d07d8f: posts the ante 500
eca57803: posts the ante 500
de851319: posts the ante 500
a75b7bb6: posts the ante 500
Hero: posts the ante 500
a88021a: posts the ante 500
a88021a: posts small blind 1,750
eca57803: posts big blind 3,500
*** HOLE CARDS ***
Dealt to Hero [Tc 3d]
Dealt to de851319 
Dealt to 42d07d8f 
Dealt to 95b2710a 
Dealt to a75b7bb6 
Dealt to a88021a 
Dealt to eca57803 
Hero: folds
de851319: folds
42d07d8f: folds
95b2710a: folds
a75b7bb6: folds
a88021a: raises 3,500 to 7,000
eca57803: folds
Uncalled bet (3,500) returned to a88021a
*** SHOWDOWN ***
a88021a collected 10,500 from pot
*** SUMMARY ***
Total pot 10,500 | Rake 0 | Jackpot 0 | Bingo 0 | Fortune 0 | Tax 0
Seat 1: Hero folded before Flop
Seat 2: de851319 folded before Flop
Seat 3: 42d07d8f folded before Flop
Seat 4: 95b2710a folded before Flop
Seat 5: a75b7bb6 (button) folded before Flop
Seat 6: a88021a (small blind) collected (10,500)
Seat 7: eca57803 (big blind) folded before Flop


Poker Hand #TM3547543908: Tournament #156323098, Bounty Hunters $1.08 Hold'em No Limit - Level19(1,750/3,500) - 2024/08/04 00:48:50
Table '12' 8-max Seat #4 is the button
Seat 1: Hero (46,808 in chips)
Seat 2: de851319 (334,906 in chips)
Seat 3: 42d07d8f (16,900 in chips)
Seat 4: 95b2710a (128,483 in chips)
Seat 5: a75b7bb6 (30,976 in chips)
Seat 6: a88021a (226,002 in chips)
Seat 7: eca57803 (72,431 in chips)
Seat 8: 207e2b94 (60,889 in chips)
207e2b94: posts the ante 500
95b2710a: posts the ante 500
42d07d8f: posts the ante 500
eca57803: posts the ante 500
de851319: posts the ante 500
a75b7bb6: posts the ante 500
Hero: posts the ante 500
a88021a: posts the ante 500
a75b7bb6: posts small blind 1,750
a88021a: posts big blind 3,500
*** HOLE CARDS ***
Dealt to Hero [7h 8h]
Dealt to de851319 
Dealt to 42d07d8f 
Dealt to 95b2710a 
Dealt to a75b7bb6 
Dealt to a88021a 
Dealt to eca57803 
Dealt to 207e2b94 
eca57803: folds
207e2b94: folds
Hero: raises 5,250 to 8,750
de851319: folds
42d07d8f: raises 7,650 to 16,400 and is all-in
95b2710a: raises 111,583 to 127,983 and is all-in
a75b7bb6: folds
a88021a: folds
Hero: folds
Uncalled bet (111,583) returned to 95b2710a
95b2710a: shows [9d 9c]
42d07d8f: shows [Ah Qc]
*** FLOP *** [Tc Qd 7c]
*** TURN *** [Tc Qd 7c] [5d]
*** RIVER *** [Tc Qd 7c 5d] [As]
*** SHOWDOWN ***
42d07d8f collected 50,800 from pot
*** SUMMARY ***
Total pot 50,800 | Rake 0 | Jackpot 0 | Bingo 0 | Fortune 0 | Tax 0
Board [Tc Qd 7c 5d As]
Seat 1: Hero folded before Flop
Seat 2: de851319 folded before Flop
Seat 3: 42d07d8f showed [Ah Qc] and won (50,800) with Pair of Aces and Pair of Queens
Seat 4: 95b2710a (button) showed [9d 9c] and lost with Pair of Nines
Seat 5: a75b7bb6 (small blind) folded before Flop
Seat 6: a88021a (big blind) folded before Flop
Seat 7: eca57803 folded before Flop
Seat 8: 207e2b94 folded before Flop


Poker Hand #TM3547543883: Tournament #156323098, Bounty Hunters $1.08 Hold'em No Limit - Level18(1,500/3,000) - 2024/08/04 00:48:20
Table '12' 8-max Seat #3 is the button
Seat 1: Hero (47,258 in chips)
Seat 2: de851319 (335,356 in chips)
Seat 3: 42d07d8f (17,350 in chips)
Seat 4: 95b2710a (122,333 in chips)
Seat 5: a75b7bb6 (34,426 in chips)
Seat 6: a88021a (226,452 in chips)
Seat 7: eca57803 (72,881 in chips)
Seat 8: 207e2b94 (61,339 in chips)
207e2b94: posts the ante 450
95b2710a: posts the ante 450
42d07d8f: posts the ante 450
eca57803: posts the ante 450
de851319: posts the ante 450
a75b7bb6: posts the ante 450
Hero: posts the ante 450
a88021a: posts the ante 450
95b2710a: posts small blind 1,500
a75b7bb6: posts big blind 3,000
*** HOLE CARDS ***
Dealt to Hero [4s 2h]
Dealt to de851319 
Dealt to 42d07d8f 
Dealt to 95b2710a 
Dealt to a75b7bb6 
Dealt to a88021a 
Dealt to eca57803 
Dealt to 207e2b94 
a88021a: folds
eca57803: folds
207e2b94: folds
Hero: folds
de851319: folds
42d07d8f: folds
95b2710a: raises 118,883 to 121,883 and is all-in
a75b7bb6: folds
Uncalled bet (118,883) returned to 95b2710a
*** SHOWDOWN ***
95b2710a collected 9,600 from pot
*** SUMMARY ***
Total pot 9,600 | Rake 0 | Jackpot 0 | Bingo 0 | Fortune 0 | Tax 0
Seat 1: Hero folded before Flop
Seat 2: de851319 folded before Flop
Seat 3: 42d07d8f (button) folded before Flop
Seat 4: 95b2710a (small blind) collected (9,600)
Seat 5: a75b7bb6 (big blind) folded before Flop
Seat 6: a88021a folded before Flop
Seat 7: eca57803 folded before Flop
Seat 8: 207e2b94 folded before Flop


Poker Hand #TM3547543834: Tournament #156323098, Bounty Hunters $1.08 Hold'em No Limit - Level18(1,500/3,000) - 2024/08/04 00:47:07
Table '12' 8-max Seat #2 is the button
Seat 1: Hero (47,708 in chips)
Seat 2: de851319 (335,806 in chips)
Seat 3: 42d07d8f (19,300 in chips)
Seat 4: 95b2710a (137,333 in chips)
Seat 5: a75b7bb6 (34,876 in chips)
Seat 6: a88021a (207,252 in chips)
Seat 7: eca57803 (73,331 in chips)
Seat 8: 207e2b94 (61,789 in chips)
207e2b94: posts the ante 450
95b2710a: posts the ante 450
42d07d8f: posts the ante 450
eca57803: posts the ante 450
de851319: posts the ante 450
a75b7bb6: posts the ante 450
Hero: posts the ante 450
a88021a: posts the ante 450
42d07d8f: posts small blind 1,500
95b2710a: posts big blind 3,000
*** HOLE CARDS ***
Dealt to Hero [3s Ah]
Dealt to de851319 
Dealt to 42d07d8f 
Dealt to 95b2710a 
Dealt to a75b7bb6 
Dealt to a88021a 
Dealt to eca57803 
Dealt to 207e2b94 
a75b7bb6: folds
a88021a: raises 3,000 to 6,000
eca57803: folds
207e2b94: folds
Hero: folds
de851319: folds
42d07d8f: folds
95b2710a: calls 3,000
*** FLOP *** [5d 5h 6d]
95b2710a: checks
a88021a: checks
*** TURN *** [5d 5h 6d] [7s]
95b2710a: bets 8,550
a88021a: raises 11,286 to 19,836
95b2710a: folds
Uncalled bet (11,286) returned to a88021a
*** SHOWDOWN ***
a88021a collected 34,200 from pot
*** SUMMARY ***
Total pot 34,200 | Rake 0 | Jackpot 0 | Bingo 0 | Fortune 0 | Tax 0
Board [5d 5h 6d 7s]
Seat 1: Hero folded before Flop
Seat 2: de851319 (button) folded before Flop
Seat 3: 42d07d8f (small blind) folded before Flop
Seat 4: 95b2710a (big blind) folded on the Turn
Seat 5: a75b7bb6 folded before Flop
Seat 6: a88021a won (34,200)
Seat 7: eca57803 folded before Flop
Seat 8: 207e2b94 folded before Flop


Poker Hand #TM3547543811: Tournament #156323098, Bounty Hunters $1.08 Hold'em No Limit - Level18(1,500/3,000) - 2024/08/04 00:46:29
Table '12' 8-max Seat #1 is the button
Seat 1: Hero (37,508 in chips)
Seat 2: de851319 (337,756 in chips)
Seat 3: 42d07d8f (25,750 in chips)
Seat 5: a75b7bb6 (35,326 in chips)
Seat 6: a88021a (207,702 in chips)
Seat 7: eca57803 (73,781 in chips)
Seat 8: 207e2b94 (62,239 in chips)
207e2b94: posts the ante 450
42d07d8f: posts the ante 450
eca57803: posts the ante 450
de851319: posts the ante 450
a75b7bb6: posts the ante 450
Hero: posts the ante 450
a88021a: posts the ante 450
de851319: posts small blind 1,500
42d07d8f: posts big blind 3,000
*** HOLE CARDS ***
Dealt to Hero [Jc Qh]
Dealt to de851319 
Dealt to 42d07d8f 
Dealt to a75b7bb6 
Dealt to a88021a 
Dealt to eca57803 
Dealt to 207e2b94 
a75b7bb6: folds
a88021a: folds
eca57803: folds
207e2b94: folds
Hero: raises 3,000 to 6,000
de851319: folds
42d07d8f: calls 3,000
*** FLOP *** [8d 9s 5c]
42d07d8f: checks
Hero: bets 8,325
42d07d8f: folds
Uncalled bet (8,325) returned to Hero
*** SHOWDOWN ***
Hero collected 16,650 from pot
*** SUMMARY ***
Total pot 16,650 | Rake 0 | Jackpot 0 | Bingo 0 | Fortune 0 | Tax 0
Board [8d 9s 5c]
Seat 1: Hero (button) won (16,650)
Seat 2: de851319 (small blind) folded before Flop
Seat 3: 42d07d8f (big blind) folded on the Flop
Seat 5: a75b7bb6 folded before Flop
Seat 6: a88021a folded before Flop
Seat 7: eca57803 folded before Flop
Seat 8: 207e2b94 folded before Flop


Poker Hand #TM3547543788: Tournament #156323098, Bounty Hunters $1.08 Hold'em No Limit - Level18(1,500/3,000) - 2024/08/04 00:45:58
Table '12' 8-max Seat #8 is the button
Seat 1: Hero (31,808 in chips)
Seat 2: de851319 (341,206 in chips)
Seat 3: 42d07d8f (26,200 in chips)
Seat 5: a75b7bb6 (35,776 in chips)
Seat 6: a88021a (208,152 in chips)
Seat 7: eca57803 (74,231 in chips)
Seat 8: 207e2b94 (62,689 in chips)
207e2b94: posts the ante 450
42d07d8f: posts the ante 450
eca57803: posts the ante 450
de851319: posts the ante 450
a75b7bb6: posts the ante 450
Hero: posts the ante 450
a88021a: posts the ante 450
Hero: posts small blind 1,500
de851319: posts big blind 3,000
*** HOLE CARDS ***
Dealt to Hero [Ks 6d]
Dealt to de851319 
Dealt to 42d07d8f 
Dealt to a75b7bb6 
Dealt to a88021a 
Dealt to eca57803 
Dealt to 207e2b94 
42d07d8f: folds
a75b7bb6: folds
a88021a: folds
eca57803: folds
207e2b94: folds
Hero: calls 1,500
de851319: checks
*** FLOP *** [Jh 5d 4c]
Hero: bets 3,020
de851319: folds
Uncalled bet (3,020) returned to Hero
*** SHOWDOWN ***
Hero collected 9,150 from pot
*** SUMMARY ***
Total pot 9,150 | Rake 0 | Jackpot 0 | Bingo 0 | Fortune 0 | Tax 0
Board [Jh 5d 4c]
Seat 1: Hero (small blind) won (9,150)
Seat 2: de851319 (big blind) folded on the Flop
Seat 3: 42d07d8f folded before Flop
Seat 5: a75b7bb6 folded before Flop
Seat 6: a88021a folded before Flop
Seat 7: eca57803 folded before Flop
Seat 8: 207e2b94 (button) folded before Flop


Poker Hand #TM3547543776: Tournament #156323098, Bounty Hunters $1.08 Hold'em No Limit - Level18(1,500/3,000) - 2024/08/04 00:45:44
Table '12' 8-max Seat #6 is the button
Seat 1: Hero (28,058 in chips)
Seat 2: de851319 (341,656 in chips)
Seat 3: 42d07d8f (26,650 in chips)
Seat 5: a75b7bb6 (36,226 in chips)
Seat 6: a88021a (208,602 in chips)
Seat 8: 207e2b94 (64,639 in chips)
207e2b94: posts the ante 450
42d07d8f: posts the ante 450
de851319: posts the ante 450
a75b7bb6: posts the ante 450
Hero: posts the ante 450
a88021a: posts the ante 450
207e2b94: posts small blind 1,500
Hero: posts big blind 3,000
*** HOLE CARDS ***
Dealt to Hero [Qc 4c]
Dealt to de851319 
Dealt to 42d07d8f 
Dealt to a75b7bb6 
Dealt to a88021a 
Dealt to 207e2b94 
de851319: folds
42d07d8f: folds
a75b7bb6: folds
a88021a: folds
207e2b94: folds
Uncalled bet (1,500) returned to Hero
*** SHOWDOWN ***
Hero collected 5,700 from pot
*** SUMMARY ***
Total pot 5,700 | Rake 0 | Jackpot 0 | Bingo 0 | Fortune 0 | Tax 0
Seat 1: Hero (big blind) collected (5,700)
Seat 2: de851319 folded before Flop
Seat 3: 42d07d8f folded before Flop
Seat 5: a75b7bb6 folded before Flop
Seat 6: a88021a (button) folded before Flop
Seat 8: 207e2b94 (small blind) folded before Flop


Poker Hand #TM3547543758: Tournament #156323098, Bounty Hunters $1.08 Hold'em No Limit - Level18(1,500/3,000) - 2024/08/04 00:45:12
Table '12' 8-max Seat #5 is the button
Seat 1: Hero (28,508 in chips)
Seat 2: de851319 (342,106 in chips)
Seat 3: 42d07d8f (27,100 in chips)
Seat 5: a75b7bb6 (36,676 in chips)
Seat 6: a88021a (210,552 in chips)
Seat 8: 207e2b94 (60,889 in chips)
207e2b94: posts the ante 450
42d07d8f: posts the ante 450
de851319: posts the ante 450
a75b7bb6: posts the ante 450
Hero: posts the ante 450
a88021a: posts the ante 450
a88021a: posts small blind 1,500
207e2b94: posts big blind 3,000
*** HOLE CARDS ***
Dealt to Hero [9s Qd]
Dealt to de851319 
Dealt to 42d07d8f 
Dealt to a75b7bb6 
Dealt to a88021a 
Dealt to 207e2b94 
Hero: folds
de851319: folds
42d07d8f: folds
a75b7bb6: folds
a88021a: folds
Uncalled bet (1,500) returned to 207e2b94
*** SHOWDOWN ***
207e2b94 collected 5,700 from pot
*** SUMMARY ***
Total pot 5,700 | Rake 0 | Jackpot 0 | Bingo 0 | Fortune 0 | Tax 0
Seat 1: Hero folded before Flop
Seat 2: de851319 folded before Flop
Seat 3: 42d07d8f folded before Flop
Seat 5: a75b7bb6 (button) folded before Flop
Seat 6: a88021a (small blind) folded before Flop
Seat 8: 207e2b94 (big blind) collected (5,700)


Poker Hand #TM3547543730: Tournament #156323098, Bounty Hunters $1.08 Hold'em No Limit - Level18(1,500/3,000) - 2024/08/04 00:44:25
Table '12' 8-max Seat #4 is the button
Seat 1: Hero (28,958 in chips)
Seat 2: de851319 (165,272 in chips)
Seat 3: 42d07d8f (27,550 in chips)
Seat 4: 7c5448c1 (61,905 in chips)
Seat 5: a75b7bb6 (38,626 in chips)
Seat 6: a88021a (214,002 in chips)
Seat 7: fcdde401 (108,179 in chips)
Seat 8: 207e2b94 (61,339 in chips)
207e2b94: posts the ante 450
42d07d8f: posts the ante 450
7c5448c1: posts the ante 450
de851319: posts the ante 450
fcdde401: posts the ante 450
a75b7bb6: posts the ante 450
Hero: posts the ante 450
a88021a: posts the ante 450
a75b7bb6: posts small blind 1,500
a88021a: posts big blind 3,000
*** HOLE CARDS ***
Dealt to Hero [Td 4c]
Dealt to de851319 
Dealt to 42d07d8f 
Dealt to 7c5448c1 
Dealt to a75b7bb6 
Dealt to a88021a 
Dealt to fcdde401 
Dealt to 207e2b94 
fcdde401: raises 9,000 to 12,000
207e2b94: folds
Hero: folds
de851319: calls 12,000
42d07d8f: folds
7c5448c1: raises 49,455 to 61,455 and is all-in
a75b7bb6: folds
a88021a: folds
fcdde401: raises 46,274 to 107,729 and is all-in
de851319: calls 95,729
fcdde401: shows [Qh As]
de851319: shows [Js Jh]
7c5448c1: shows [Ad Qd]
*** FLOP *** [3c 9s 3h]
*** TURN *** [3c 9s 3h] [5h]
*** RIVER *** [3c 9s 3h 5h] [4d]
*** SHOWDOWN ***
de851319 collected 192,465 from pot
de851319 collected 92,548 from pot
*** SUMMARY ***
Total pot 285,013 | Rake 0 | Jackpot 0 | Bingo 0 | Fortune 0 | Tax 0
Board [3c 9s 3h 5h 4d]
Seat 1: Hero folded before Flop
Seat 2: de851319 showed [Js Jh] and won (285,013) with Pair of Jacks and Pair of Treys
Seat 3: 42d07d8f folded before Flop
Seat 4: 7c5448c1 (button) showed [Ad Qd] and lost with Pair of Treys
Seat 5: a75b7bb6 (small blind) folded before Flop
Seat 6: a88021a (big blind) folded before Flop
Seat 7: fcdde401 showed [Qh As] and lost with Pair of Treys
Seat 8: 207e2b94 folded before Flop


Poker Hand #TM3547543678: Tournament #156323098, Bounty Hunters $1.08 Hold'em No Limit - Level18(1,500/3,000) - 2024/08/04 00:42:46
Table '12' 8-max Seat #3 is the button
Seat 1: Hero (29,408 in chips)
Seat 2: de851319 (165,722 in chips)
Seat 3: 42d07d8f (28,000 in chips)
Seat 4: 7c5448c1 (49,755 in chips)
Seat 5: a75b7bb6 (48,076 in chips)
Seat 6: a88021a (214,452 in chips)
Seat 7: fcdde401 (108,629 in chips)
Seat 8: 207e2b94 (61,789 in chips)
207e2b94: posts the ante 450
42d07d8f: posts the ante 450
7c5448c1: posts the ante 450
de851319: posts the ante 450
fcdde401: posts the ante 450
a75b7bb6: posts the ante 450
Hero: posts the ante 450
a88021a: posts the ante 450
7c5448c1: posts small blind 1,500
a75b7bb6: posts big blind 3,000
*** HOLE CARDS ***
Dealt to Hero [9c 6h]
Dealt to de851319 
Dealt to 42d07d8f 
Dealt to 7c5448c1 
Dealt to a75b7bb6 
Dealt to a88021a 
Dealt to fcdde401 
Dealt to 207e2b94 
a88021a: folds
fcdde401: folds
207e2b94: folds
Hero: folds
de851319: folds
42d07d8f: folds
7c5448c1: raises 6,000 to 9,000
a75b7bb6: calls 6,000
*** FLOP *** [Qd 2s 8s]
7c5448c1: checks
a75b7bb6: checks
*** TURN *** [Qd 2s 8s] [Jh]
7c5448c1: checks
a75b7bb6: checks
*** RIVER *** [Qd 2s 8s Jh] [3d]
7c5448c1: bets 12,000
a75b7bb6: folds
Uncalled bet (12,000) returned to 7c5448c1
*** SHOWDOWN ***
7c5448c1 collected 21,600 from pot
*** SUMMARY ***
Total pot 21,600 | Rake 0 | Jackpot 0 | Bingo 0 | Fortune 0 | Tax 0
Board [Qd 2s 8s Jh 3d]
Seat 1: Hero folded before Flop
Seat 2: de851319 folded before Flop
Seat 3: 42d07d8f (button) folded before Flop
Seat 4: 7c5448c1 (small blind) won (21,600)
Seat 5: a75b7bb6 (big blind) folded on the River
Seat 6: a88021a folded before Flop
Seat 7: fcdde401 folded before Flop
Seat 8: 207e2b94 folded before Flop


Poker Hand #TM3547543656: Tournament #156323098, Bounty Hunters $1.08 Hold'em No Limit - Level18(1,500/3,000) - 2024/08/04 00:42:06
Table '12' 8-max Seat #2 is the button
Seat 1: Hero (29,858 in chips)
Seat 2: de851319 (155,072 in chips)
Seat 3: 42d07d8f (29,950 in chips)
Seat 4: 7c5448c1 (56,205 in chips)
Seat 5: a75b7bb6 (48,526 in chips)
Seat 6: a88021a (214,902 in chips)
Seat 7: fcdde401 (109,079 in chips)
Seat 8: 207e2b94 (62,239 in chips)
207e2b94: posts the ante 450
42d07d8f: posts the ante 450
7c5448c1: posts the ante 450
de851319: posts the ante 450
fcdde401: posts the ante 450
a75b7bb6: posts the ante 450
Hero: posts the ante 450
a88021a: posts the ante 450
42d07d8f: posts small blind 1,500
7c5448c1: posts big blind 3,000
*** HOLE CARDS ***
Dealt to Hero [4d 5s]
Dealt to de851319 
Dealt to 42d07d8f 
Dealt to 7c5448c1 
Dealt to a75b7bb6 
Dealt to a88021a 
Dealt to fcdde401 
Dealt to 207e2b94 
a75b7bb6: folds
a88021a: folds
fcdde401: folds
207e2b94: folds
Hero: folds
de851319: raises 3,000 to 6,000
42d07d8f: folds
7c5448c1: calls 3,000
*** FLOP *** [Kh Ks 5h]
7c5448c1: checks
de851319: bets 5,643
7c5448c1: folds
Uncalled bet (5,643) returned to de851319
*** SHOWDOWN ***
de851319 collected 17,100 from pot
*** SUMMARY ***
Total pot 17,100 | Rake 0 | Jackpot 0 | Bingo 0 | Fortune 0 | Tax 0
Board [Kh Ks 5h]
Seat 1: Hero folded before Flop
Seat 2: de851319 (button) won (17,100)
Seat 3: 42d07d8f (small blind) folded before Flop
Seat 4: 7c5448c1 (big blind) folded on the Flop
Seat 5: a75b7bb6 folded before Flop
Seat 6: a88021a folded before Flop
Seat 7: fcdde401 folded before Flop
Seat 8: 207e2b94 folded before Flop


Poker Hand #TM3547543640: Tournament #156323098, Bounty Hunters $1.08 Hold'em No Limit - Level17(1,250/2,500) - 2024/08/04 00:41:36
Table '12' 8-max Seat #1 is the button
Seat 1: Hero (30,208 in chips)
Seat 2: de851319 (156,672 in chips)
Seat 3: 42d07d8f (32,800 in chips)
Seat 4: 7c5448c1 (47,505 in chips)
Seat 5: a75b7bb6 (48,876 in chips)
Seat 6: a88021a (215,252 in chips)
Seat 7: fcdde401 (111,929 in chips)
Seat 8: 207e2b94 (62,589 in chips)
207e2b94: posts the ante 350
42d07d8f: posts the ante 350
7c5448c1: posts the ante 350
fcdde401: posts the ante 350
de851319: posts the ante 350
a75b7bb6: posts the ante 350
Hero: posts the ante 350
a88021a: posts the ante 350
de851319: posts small blind 1,250
42d07d8f: posts big blind 2,500
*** HOLE CARDS ***
Dealt to Hero [9h 2c]
Dealt to de851319 
Dealt to 42d07d8f 
Dealt to 7c5448c1 
Dealt to a75b7bb6 
Dealt to a88021a 
Dealt to fcdde401 
Dealt to 207e2b94 
7c5448c1: calls 2,500
a75b7bb6: folds
a88021a: folds
fcdde401: calls 2,500
207e2b94: folds
Hero: folds
de851319: folds
42d07d8f: checks
*** FLOP *** [5c Qh Js]
42d07d8f: checks
7c5448c1: bets 6,250
fcdde401: folds
42d07d8f: folds
Uncalled bet (6,250) returned to 7c5448c1
*** SHOWDOWN ***
7c5448c1 collected 11,550 from pot
*** SUMMARY ***
Total pot 11,550 | Rake 0 | Jackpot 0 | Bingo 0 | Fortune 0 | Tax 0
Board [5c Qh Js]
Seat 1: Hero (button) folded before Flop
Seat 2: de851319 (small blind) folded before Flop
Seat 3: 42d07d8f (big blind) folded on the Flop
Seat 4: 7c5448c1 won (11,550)
Seat 5: a75b7bb6 folded before Flop
Seat 6: a88021a folded before Flop
Seat 7: fcdde401 folded on the Flop
Seat 8: 207e2b94 folded before Flop


Poker Hand #TM3547543615: Tournament #156323098, Bounty Hunters $1.08 Hold'em No Limit - Level17(1,250/2,500) - 2024/08/04 00:40:51
Table '12' 8-max Seat #8 is the button
Seat 1: Hero (31,808 in chips)
Seat 2: de851319 (159,522 in chips)
Seat 3: 42d07d8f (33,150 in chips)
Seat 4: 7c5448c1 (47,855 in chips)
Seat 5: a75b7bb6 (49,226 in chips)
Seat 6: a88021a (204,052 in chips)
Seat 7: fcdde401 (112,279 in chips)
Seat 8: 207e2b94 (67,939 in chips)
207e2b94: posts the ante 350
42d07d8f: posts the ante 350
7c5448c1: posts the ante 350
fcdde401: posts the ante 350
de851319: posts the ante 350
a75b7bb6: posts the ante 350
Hero: posts the ante 350
a88021a: posts the ante 350
Hero: posts small blind 1,250
de851319: posts big blind 2,500
*** HOLE CARDS ***
Dealt to Hero [5d 6s]
Dealt to de851319 
Dealt to 42d07d8f 
Dealt to 7c5448c1 
Dealt to a75b7bb6 
Dealt to a88021a 
Dealt to fcdde401 
Dealt to 207e2b94 
42d07d8f: folds
7c5448c1: folds
a75b7bb6: folds
a88021a: raises 2,500 to 5,000
fcdde401: folds
207e2b94: calls 5,000
Hero: folds
de851319: folds
*** FLOP *** [As 4d 7h]
a88021a: bets 5,462
207e2b94: folds
Uncalled bet (5,462) returned to a88021a
*** SHOWDOWN ***
a88021a collected 16,550 from pot
*** SUMMARY ***
Total pot 16,550 | Rake 0 | Jackpot 0 | Bingo 0 | Fortune 0 | Tax 0
Board [As 4d 7h]
Seat 1: Hero (small blind) folded before Flop
Seat 2: de851319 (big blind) folded before Flop
Seat 3: 42d07d8f folded before Flop
Seat 4: 7c5448c1 folded before Flop
Seat 5: a75b7bb6 folded before Flop
Seat 6: a88021a won (16,550)
Seat 7: fcdde401 folded before Flop
Seat 8: 207e2b94 (button) folded on the Flop


Poker Hand #TM3547543561: Tournament #156323098, Bounty Hunters $1.08 Hold'em No Limit - Level17(1,250/2,500) - 2024/08/04 00:39:22
Table '12' 8-max Seat #7 is the button
Seat 1: Hero (34,658 in chips)
Seat 2: de851319 (159,872 in chips)
Seat 3: 42d07d8f (33,500 in chips)
Seat 4: 7c5448c1 (144,456 in chips)
Seat 5: a75b7bb6 (54,576 in chips)
Seat 6: a88021a (96,601 in chips)
Seat 7: fcdde401 (112,629 in chips)
Seat 8: 207e2b94 (69,539 in chips)
207e2b94: posts the ante 350
42d07d8f: posts the ante 350
7c5448c1: posts the ante 350
fcdde401: posts the ante 350
de851319: posts the ante 350
a75b7bb6: posts the ante 350
Hero: posts the ante 350
a88021a: posts the ante 350
207e2b94: posts small blind 1,250
Hero: posts big blind 2,500
*** HOLE CARDS ***
Dealt to Hero [3s 5d]
Dealt to de851319 
Dealt to 42d07d8f 
Dealt to 7c5448c1 
Dealt to a75b7bb6 
Dealt to a88021a 
Dealt to fcdde401 
Dealt to 207e2b94 
de851319: folds
42d07d8f: folds
7c5448c1: calls 2,500
a75b7bb6: calls 2,500
a88021a: raises 2,500 to 5,000
fcdde401: folds
207e2b94: folds
Hero: folds
7c5448c1: calls 2,500
a75b7bb6: calls 2,500
*** FLOP *** [Ks Jd Qs]
7c5448c1: checks
a75b7bb6: checks
a88021a: bets 7,112
7c5448c1: calls 7,112
a75b7bb6: folds
*** TURN *** [Ks Jd Qs] [Ts]
7c5448c1: bets 20,000
a88021a: calls 20,000
*** RIVER *** [Ks Jd Qs Ts] [Kc]
7c5448c1: bets 111,994 and is all-in
a88021a: calls 64,139 and is all-in
Uncalled bet (47,855) returned to 7c5448c1
7c5448c1: shows [9c Th] (Kings-High Straight)
a88021a: shows [Qd As] (Aces-High Straight)
*** SHOWDOWN ***
a88021a collected 204,052 from pot
*** SUMMARY ***
Total pot 204,052 | Rake 0 | Jackpot 0 | Bingo 0 | Fortune 0 | Tax 0
Board [Ks Jd Qs Ts Kc]
Seat 1: Hero (big blind) folded before Flop
Seat 2: de851319 folded before Flop
Seat 3: 42d07d8f folded before Flop
Seat 4: 7c5448c1 showed [9c Th] and lost with Kings-High Straight
Seat 5: a75b7bb6 folded on the Flop
Seat 6: a88021a showed [Qd As] and won (204,052) with Aces-High Straight
Seat 7: fcdde401 (button) folded before Flop
Seat 8: 207e2b94 (small blind) folded before Flop


Poker Hand #TM3547543516: Tournament #156323098, Bounty Hunters $1.08 Hold'em No Limit - Level17(1,250/2,500) - 2024/08/04 00:38:14
Table '12' 8-max Seat #5 is the button
Seat 1: Hero (35,008 in chips)
Seat 2: de851319 (160,222 in chips)
Seat 3: 42d07d8f (33,850 in chips)
Seat 4: 7c5448c1 (144,806 in chips)
Seat 5: a75b7bb6 (25,788 in chips)
Seat 7: fcdde401 (114,229 in chips)
Seat 8: 207e2b94 (95,327 in chips)
207e2b94: posts the ante 350
42d07d8f: posts the ante 350
7c5448c1: posts the ante 350
de851319: posts the ante 350
fcdde401: posts the ante 350
a75b7bb6: posts the ante 350
Hero: posts the ante 350
fcdde401: posts small blind 1,250
207e2b94: posts big blind 2,500
*** HOLE CARDS ***
Dealt to Hero [8c 7h]
Dealt to de851319 
Dealt to 42d07d8f 
Dealt to 7c5448c1 
Dealt to a75b7bb6 
Dealt to fcdde401 
Dealt to 207e2b94 
Hero: folds
de851319: folds
42d07d8f: folds
7c5448c1: folds
a75b7bb6: raises 22,938 to 25,438 and is all-in
fcdde401: folds
207e2b94: calls 22,938
a75b7bb6: shows [As Ks]
207e2b94: shows [Tc Th]
*** FLOP *** [5c Jh Qh]
*** TURN *** [5c Jh Qh] [Kc]
*** RIVER *** [5c Jh Qh Kc] [Kh]
*** SHOWDOWN ***
a75b7bb6 collected 54,576 from pot
*** SUMMARY ***
Total pot 54,576 | Rake 0 | Jackpot 0 | Bingo 0 | Fortune 0 | Tax 0
Board [5c Jh Qh Kc Kh]
Seat 1: Hero folded before Flop
Seat 2: de851319 folded before Flop
Seat 3: 42d07d8f folded before Flop
Seat 4: 7c5448c1 folded before Flop
Seat 5: a75b7bb6 (button) showed [As Ks] and won (54,576) with Three Kings
Seat 7: fcdde401 (small blind) folded before Flop
Seat 8: 207e2b94 (big blind) showed [Tc Th] and lost with Pair of Kings and Pair of Tens


Poker Hand #TM3547543492: Tournament #156323098, Bounty Hunters $1.08 Hold'em No Limit - Level17(1,250/2,500) - 2024/08/04 00:37:33
Table '12' 8-max Seat #4 is the button
Seat 1: Hero (41,608 in chips)
Seat 2: de851319 (160,572 in chips)
Seat 3: 42d07d8f (34,200 in chips)
Seat 4: 7c5448c1 (145,156 in chips)
Seat 5: a75b7bb6 (27,388 in chips)
Seat 7: fcdde401 (120,829 in chips)
Seat 8: 207e2b94 (79,477 in chips)
207e2b94: posts the ante 350
42d07d8f: posts the ante 350
7c5448c1: posts the ante 350
de851319: posts the ante 350
fcdde401: posts the ante 350
a75b7bb6: posts the ante 350
Hero: posts the ante 350
a75b7bb6: posts small blind 1,250
fcdde401: posts big blind 2,500
*** HOLE CARDS ***
Dealt to Hero [Kd Qs]
Dealt to de851319 
Dealt to 42d07d8f 
Dealt to 7c5448c1 
Dealt to a75b7bb6 
Dealt to fcdde401 
Dealt to 207e2b94 
207e2b94: raises 3,750 to 6,250
Hero: calls 6,250
de851319: folds
42d07d8f: folds
7c5448c1: folds
a75b7bb6: folds
fcdde401: calls 3,750
*** FLOP *** [As 7c 9c]
fcdde401: checks
207e2b94: bets 16,838
Hero: folds
fcdde401: folds
Uncalled bet (16,838) returned to 207e2b94
*** SHOWDOWN ***
207e2b94 collected 22,450 from pot
*** SUMMARY ***
Total pot 22,450 | Rake 0 | Jackpot 0 | Bingo 0 | Fortune 0 | Tax 0
Board [As 7c 9c]
Seat 1: Hero folded on the Flop
Seat 2: de851319 folded before Flop
Seat 3: 42d07d8f folded before Flop
Seat 4: 7c5448c1 (button) folded before Flop
Seat 5: a75b7bb6 (small blind) folded before Flop
Seat 7: fcdde401 (big blind) folded on the Flop
Seat 8: 207e2b94 won (22,450)


Poker Hand #TM3547543419: Tournament #156323098, Bounty Hunters $1.08 Hold'em No Limit - Level17(1,250/2,500) - 2024/08/04 00:35:33
Table '12' 8-max Seat #3 is the button
Seat 1: Hero (41,958 in chips)
Seat 2: de851319 (160,922 in chips)
Seat 3: 42d07d8f (34,550 in chips)
Seat 4: 7c5448c1 (73,470 in chips)
Seat 5: a75b7bb6 (30,238 in chips)
Seat 6: cd7e1bca (67,086 in chips)
Seat 7: fcdde401 (121,179 in chips)
Seat 8: 207e2b94 (79,827 in chips)
207e2b94: posts the ante 350
42d07d8f: posts the ante 350
cd7e1bca: posts the ante 350
7c5448c1: posts the ante 350
de851319: posts the ante 350
fcdde401: posts the ante 350
a75b7bb6: posts the ante 350
Hero: posts the ante 350
7c5448c1: posts small blind 1,250
a75b7bb6: posts big blind 2,500
*** HOLE CARDS ***
Dealt to Hero [2s 2c]
Dealt to de851319 
Dealt to 42d07d8f 
Dealt to 7c5448c1 
Dealt to a75b7bb6 
Dealt to cd7e1bca 
Dealt to fcdde401 
Dealt to 207e2b94 
cd7e1bca: raises 3,750 to 6,250
fcdde401: folds
207e2b94: folds
Hero: folds
de851319: folds
42d07d8f: folds
7c5448c1: calls 5,000
a75b7bb6: folds
*** FLOP *** [9c Tc 7h]
7c5448c1: checks
cd7e1bca: bets 7,476
7c5448c1: calls 7,476
*** TURN *** [9c Tc 7h] [3s]
7c5448c1: checks
cd7e1bca: bets 22,599
7c5448c1: raises 36,795 to 59,394 and is all-in
cd7e1bca: calls 30,411 and is all-in
Uncalled bet (6,384) returned to 7c5448c1
7c5448c1: shows [8c Js] (Jacks-High Straight)
cd7e1bca: shows [7s 7d] (Three Sevens)
*** RIVER *** [9c Tc 7h 3s] [5d]
*** SHOWDOWN ***
7c5448c1 collected 138,772 from pot
*** SUMMARY ***
Total pot 138,772 | Rake 0 | Jackpot 0 | Bingo 0 | Fortune 0 | Tax 0
Board [9c Tc 7h 3s 5d]
Seat 1: Hero folded before Flop
Seat 2: de851319 folded before Flop
Seat 3: 42d07d8f (button) folded before Flop
Seat 4: 7c5448c1 (small blind) showed [8c Js] and won (138,772) with Jacks-High Straight
Seat 5: a75b7bb6 (big blind) folded before Flop
Seat 6: cd7e1bca showed [7s 7d] and lost with Three Sevens
Seat 7: fcdde401 folded before Flop
Seat 8: 207e2b94 folded before Flop


Poker Hand #TM3547543406: Tournament #156323098, Bounty Hunters $1.08 Hold'em No Limit - Level17(1,250/2,500) - 2024/08/04 00:35:15
Table '12' 8-max Seat #2 is the button
Seat 1: Hero (42,308 in chips)
Seat 2: de851319 (161,272 in chips)
Seat 3: 42d07d8f (29,600 in chips)
Seat 4: 7c5448c1 (76,320 in chips)
Seat 5: a75b7bb6 (30,588 in chips)
Seat 6: cd7e1bca (67,436 in chips)
Seat 7: fcdde401 (121,529 in chips)
Seat 8: 207e2b94 (80,177 in chips)
207e2b94: posts the ante 350
cd7e1bca: posts the ante 350
42d07d8f: posts the ante 350
7c5448c1: posts the ante 350
de851319: posts the ante 350
fcdde401: posts the ante 350
a75b7bb6: posts the ante 350
Hero: posts the ante 350
42d07d8f: posts small blind 1,250
7c5448c1: posts big blind 2,500
*** HOLE CARDS ***
Dealt to Hero [Jc 2c]
Dealt to de851319 
Dealt to 42d07d8f 
Dealt to 7c5448c1 
Dealt to a75b7bb6 
Dealt to cd7e1bca 
Dealt to fcdde401 
Dealt to 207e2b94 
a75b7bb6: folds
cd7e1bca: folds
fcdde401: folds
207e2b94: folds
Hero: folds
de851319: folds
42d07d8f: raises 2,500 to 5,000
7c5448c1: folds
Uncalled bet (2,500) returned to 42d07d8f
*** SHOWDOWN ***
42d07d8f collected 7,800 from pot
*** SUMMARY ***
Total pot 7,800 | Rake 0 | Jackpot 0 | Bingo 0 | Fortune 0 | Tax 0
Seat 1: Hero folded before Flop
Seat 2: de851319 (button) folded before Flop
Seat 3: 42d07d8f (small blind) collected (7,800)
Seat 4: 7c5448c1 (big blind) folded before Flop
Seat 5: a75b7bb6 folded before Flop
Seat 6: cd7e1bca folded before Flop
Seat 7: fcdde401 folded before Flop
Seat 8: 207e2b94 folded before Flop


Poker Hand #TM3547543390: Tournament #156323098, Bounty Hunters $1.08 Hold'em No Limit - Level17(1,250/2,500) - 2024/08/04 00:34:54
Table '12' 8-max Seat #1 is the button
Seat 1: Hero (36,108 in chips)
Seat 2: de851319 (162,872 in chips)
Seat 3: 42d07d8f (32,450 in chips)
Seat 4: 7c5448c1 (76,670 in chips)
Seat 5: a75b7bb6 (30,938 in chips)
Seat 6: cd7e1bca (67,786 in chips)
Seat 7: fcdde401 (121,879 in chips)
Seat 8: 207e2b94 (80,527 in chips)
207e2b94: posts the ante 350
cd7e1bca: posts the ante 350
42d07d8f: posts the ante 350
7c5448c1: posts the ante 350
fcdde401: posts the ante 350
de851319: posts the ante 350
a75b7bb6: posts the ante 350
Hero: posts the ante 350
de851319: posts small blind 1,250
42d07d8f: posts big blind 2,500
*** HOLE CARDS ***
Dealt to Hero [Qh Ad]
Dealt to de851319 
Dealt to 42d07d8f 
Dealt to 7c5448c1 
Dealt to a75b7bb6 
Dealt to cd7e1bca 
Dealt to fcdde401 
Dealt to 207e2b94 
7c5448c1: folds
a75b7bb6: folds
cd7e1bca: folds
fcdde401: folds
207e2b94: folds
Hero: raises 3,750 to 6,250
de851319: folds
42d07d8f: folds
Uncalled bet (3,750) returned to Hero
Hero: shows [Qh Ad]
*** SHOWDOWN ***
Hero collected 9,050 from pot
*** SUMMARY ***
Total pot 9,050 | Rake 0 | Jackpot 0 | Bingo 0 | Fortune 0 | Tax 0
Seat 1: Hero (button) showed [Qh Ad] and collected (9,050)
Seat 2: de851319 (small blind) folded before Flop
Seat 3: 42d07d8f (big blind) folded before Flop
Seat 4: 7c5448c1 folded before Flop
Seat 5: a75b7bb6 folded before Flop
Seat 6: cd7e1bca folded before Flop
Seat 7: fcdde401 folded before Flop
Seat 8: 207e2b94 folded before Flop


Poker Hand #TM3547543370: Tournament #156323098, Bounty Hunters $1.08 Hold'em No Limit - Level16(1,000/2,000) - 2024/08/04 00:34:19
Table '12' 8-max Seat #8 is the button
Seat 1: Hero (37,408 in chips)
Seat 2: de851319 (165,172 in chips)
Seat 3: 42d07d8f (32,750 in chips)
Seat 4: 7c5448c1 (67,570 in chips)
Seat 5: a75b7bb6 (31,238 in chips)
Seat 6: cd7e1bca (68,086 in chips)
Seat 7: fcdde401 (122,179 in chips)
Seat 8: 207e2b94 (84,827 in chips)
207e2b94: posts the ante 300
cd7e1bca: posts the ante 300
42d07d8f: posts the ante 300
7c5448c1: posts the ante 300
fcdde401: posts the ante 300
de851319: posts the ante 300
a75b7bb6: posts the ante 300
Hero: posts the ante 300
Hero: posts small blind 1,000
de851319: posts big blind 2,000
*** HOLE CARDS ***
Dealt to Hero [Td 3c]
Dealt to de851319 
Dealt to 42d07d8f 
Dealt to 7c5448c1 
Dealt to a75b7bb6 
Dealt to cd7e1bca 
Dealt to fcdde401 
Dealt to 207e2b94 
42d07d8f: folds
7c5448c1: raises 2,000 to 4,000
a75b7bb6: folds
cd7e1bca: folds
fcdde401: folds
207e2b94: calls 4,000
Hero: folds
de851319: folds
*** FLOP *** [2s 6d 2d]
7c5448c1: bets 8,000
207e2b94: folds
Uncalled bet (8,000) returned to 7c5448c1
*** SHOWDOWN ***
7c5448c1 collected 13,400 from pot
*** SUMMARY ***
Total pot 13,400 | Rake 0 | Jackpot 0 | Bingo 0 | Fortune 0 | Tax 0
Board [2s 6d 2d]
Seat 1: Hero (small blind) folded before Flop
Seat 2: de851319 (big blind) folded before Flop
Seat 3: 42d07d8f folded before Flop
Seat 4: 7c5448c1 won (13,400)
Seat 5: a75b7bb6 folded before Flop
Seat 6: cd7e1bca folded before Flop
Seat 7: fcdde401 folded before Flop
Seat 8: 207e2b94 (button) folded on the Flop


Poker Hand #TM3547543341: Tournament #156323098, Bounty Hunters $1.08 Hold'em No Limit - Level16(1,000/2,000) - 2024/08/04 00:33:38
Table '12' 8-max Seat #7 is the button
Seat 1: Hero (39,708 in chips)
Seat 2: de851319 (165,472 in chips)
Seat 3: 42d07d8f (33,050 in chips)
Seat 4: 7c5448c1 (67,870 in chips)
Seat 5: a75b7bb6 (26,138 in chips)
Seat 6: cd7e1bca (68,386 in chips)
Seat 7: fcdde401 (122,479 in chips)
Seat 8: 207e2b94 (86,127 in chips)
207e2b94: posts the ante 300
cd7e1bca: posts the ante 300
42d07d8f: posts the ante 300
7c5448c1: posts the ante 300
fcdde401: posts the ante 300
de851319: posts the ante 300
a75b7bb6: posts the ante 300
Hero: posts the ante 300
207e2b94: posts small blind 1,000
Hero: posts big blind 2,000
*** HOLE CARDS ***
Dealt to Hero [8s Th]
Dealt to de851319 
Dealt to 42d07d8f 
Dealt to 7c5448c1 
Dealt to a75b7bb6 
Dealt to cd7e1bca 
Dealt to fcdde401 
Dealt to 207e2b94 
de851319: folds
42d07d8f: folds
7c5448c1: folds
a75b7bb6: raises 22,000 to 24,000
cd7e1bca: folds
fcdde401: folds
207e2b94: folds
Hero: folds
Uncalled bet (22,000) returned to a75b7bb6
*** SHOWDOWN ***
a75b7bb6 collected 7,400 from pot
*** SUMMARY ***
Total pot 7,400 | Rake 0 | Jackpot 0 | Bingo 0 | Fortune 0 | Tax 0
Seat 1: Hero (big blind) folded before Flop
Seat 2: de851319 folded before Flop
Seat 3: 42d07d8f folded before Flop
Seat 4: 7c5448c1 folded before Flop
Seat 5: a75b7bb6 collected (7,400)
Seat 6: cd7e1bca folded before Flop
Seat 7: fcdde401 (button) folded before Flop
Seat 8: 207e2b94 (small blind) folded before Flop


Poker Hand #TM3547543267: Tournament #156323098, Bounty Hunters $1.08 Hold'em No Limit - Level16(1,000/2,000) - 2024/08/04 00:31:33
Table '12' 8-max Seat #6 is the button
Seat 1: Hero (44,008 in chips)
Seat 2: de851319 (165,772 in chips)
Seat 3: 42d07d8f (33,350 in chips)
Seat 4: 7c5448c1 (68,170 in chips)
Seat 5: a75b7bb6 (30,438 in chips)
Seat 6: cd7e1bca (72,686 in chips)
Seat 7: fcdde401 (106,379 in chips)
Seat 8: 207e2b94 (88,427 in chips)
207e2b94: posts the ante 300
cd7e1bca: posts the ante 300
42d07d8f: posts the ante 300
7c5448c1: posts the ante 300
de851319: posts the ante 300
fcdde401: posts the ante 300
a75b7bb6: posts the ante 300
Hero: posts the ante 300
fcdde401: posts small blind 1,000
207e2b94: posts big blind 2,000
*** HOLE CARDS ***
Dealt to Hero [5h Ah]
Dealt to de851319 
Dealt to 42d07d8f 
Dealt to 7c5448c1 
Dealt to a75b7bb6 
Dealt to cd7e1bca 
Dealt to fcdde401 
Dealt to 207e2b94 
Hero: raises 2,000 to 4,000
de851319: folds
42d07d8f: folds
7c5448c1: folds
a75b7bb6: calls 4,000
cd7e1bca: calls 4,000
fcdde401: calls 3,000
207e2b94: folds
*** FLOP *** [4h 9c Js]
fcdde401: checks
Hero: checks
a75b7bb6: checks
cd7e1bca: checks
*** TURN *** [4h 9c Js] [9h]
fcdde401: checks
Hero: checks
a75b7bb6: checks
cd7e1bca: checks
*** RIVER *** [4h 9c Js 9h] [3d]
fcdde401: checks
Hero: checks
a75b7bb6: checks
cd7e1bca: checks
fcdde401: shows [5c 4c] (Pair of Nines and Pair of Fours)
Hero: shows [5h Ah] (Pair of Nines)
a75b7bb6: shows [Qc As] (Pair of Nines)
cd7e1bca: shows [5d Ad] (Pair of Nines)
*** SHOWDOWN ***
fcdde401 collected 20,400 from pot
*** SUMMARY ***
Total pot 20,400 | Rake 0 | Jackpot 0 | Bingo 0 | Fortune 0 | Tax 0
Board [4h 9c Js 9h 3d]
Seat 1: Hero showed [5h Ah] and lost with Pair of Nines
Seat 2: de851319 folded before Flop
Seat 3: 42d07d8f folded before Flop
Seat 4: 7c5448c1 folded before Flop
Seat 5: a75b7bb6 showed [Qc As] and lost with Pair of Nines
Seat 6: cd7e1bca (button) showed [5d Ad] and lost with Pair of Nines
Seat 7: fcdde401 (small blind) showed [5c 4c] and won (20,400) with Pair of Nines and Pair of Fours
Seat 8: 207e2b94 (big blind) folded before Flop


Poker Hand #TM3547543236: Tournament #156323098, Bounty Hunters $1.08 Hold'em No Limit - Level16(1,000/2,000) - 2024/08/04 00:30:48
Table '12' 8-max Seat #5 is the button
Seat 1: Hero (44,308 in chips)
Seat 2: de851319 (166,072 in chips)
Seat 3: 42d07d8f (26,250 in chips)
Seat 4: 7c5448c1 (68,470 in chips)
Seat 5: a75b7bb6 (30,738 in chips)
Seat 6: cd7e1bca (73,986 in chips)
Seat 7: fcdde401 (110,679 in chips)
Seat 8: 207e2b94 (88,727 in chips)
207e2b94: posts the ante 300
42d07d8f: posts the ante 300
cd7e1bca: posts the ante 300
7c5448c1: posts the ante 300
de851319: posts the ante 300
fcdde401: posts the ante 300
a75b7bb6: posts the ante 300
Hero: posts the ante 300
cd7e1bca: posts small blind 1,000
fcdde401: posts big blind 2,000
*** HOLE CARDS ***
Dealt to Hero [9d Kc]
Dealt to de851319 
Dealt to 42d07d8f 
Dealt to 7c5448c1 
Dealt to a75b7bb6 
Dealt to cd7e1bca 
Dealt to fcdde401 
Dealt to 207e2b94 
207e2b94: folds
Hero: folds
de851319: folds
42d07d8f: raises 2,000 to 4,000
7c5448c1: folds
a75b7bb6: folds
cd7e1bca: folds
fcdde401: calls 2,000
*** FLOP *** [Jc 5d 3c]
fcdde401: checks
42d07d8f: checks
*** TURN *** [Jc 5d 3c] [4d]
fcdde401: checks
42d07d8f: checks
*** RIVER *** [Jc 5d 3c 4d] [Kd]
fcdde401: checks
42d07d8f: checks
fcdde401: shows [2h 7d] (King-High)
42d07d8f: shows [8s As] (Ace-High)
*** SHOWDOWN ***
42d07d8f collected 11,400 from pot
*** SUMMARY ***
Total pot 11,400 | Rake 0 | Jackpot 0 | Bingo 0 | Fortune 0 | Tax 0
Board [Jc 5d 3c 4d Kd]
Seat 1: Hero folded before Flop
Seat 2: de851319 folded before Flop
Seat 3: 42d07d8f showed [8s As] and won (11,400) with Ace-High
Seat 4: 7c5448c1 folded before Flop
Seat 5: a75b7bb6 (button) folded before Flop
Seat 6: cd7e1bca (small blind) folded before Flop
Seat 7: fcdde401 (big blind) showed [2h 7d] and lost with King-High
Seat 8: 207e2b94 folded before Flop


Poker Hand #TM3547543225: Tournament #156323098, Bounty Hunters $1.08 Hold'em No Limit - Level16(1,000/2,000) - 2024/08/04 00:30:32
Table '12' 8-max Seat #4 is the button
Seat 1: Hero (44,608 in chips)
Seat 2: de851319 (166,372 in chips)
Seat 3: 42d07d8f (26,550 in chips)
Seat 4: 7c5448c1 (68,770 in chips)
Seat 5: a75b7bb6 (32,038 in chips)
Seat 6: cd7e1bca (70,886 in chips)
Seat 7: fcdde401 (110,979 in chips)
Seat 8: 207e2b94 (89,027 in chips)
207e2b94: posts the ante 300
42d07d8f: posts the ante 300
cd7e1bca: posts the ante 300
7c5448c1: posts the ante 300
de851319: posts the ante 300
fcdde401: posts the ante 300
a75b7bb6: posts the ante 300
Hero: posts the ante 300
a75b7bb6: posts small blind 1,000
cd7e1bca: posts big blind 2,000
*** HOLE CARDS ***
Dealt to Hero [3s 4h]
Dealt to de851319 
Dealt to 42d07d8f 
Dealt to 7c5448c1 
Dealt to a75b7bb6 
Dealt to cd7e1bca 
Dealt to fcdde401 
Dealt to 207e2b94 
fcdde401: folds
207e2b94: folds
Hero: folds
de851319: folds
42d07d8f: folds
7c5448c1: folds
a75b7bb6: folds
Uncalled bet (1,000) returned to cd7e1bca
*** SHOWDOWN ***
cd7e1bca collected 4,400 from pot
*** SUMMARY ***
Total pot 4,400 | Rake 0 | Jackpot 0 | Bingo 0 | Fortune 0 | Tax 0
Seat 1: Hero folded before Flop
Seat 2: de851319 folded before Flop
Seat 3: 42d07d8f folded before Flop
Seat 4: 7c5448c1 (button) folded before Flop
Seat 5: a75b7bb6 (small blind) folded before Flop
Seat 6: cd7e1bca (big blind) collected (4,400)
Seat 7: fcdde401 folded before Flop
Seat 8: 207e2b94 folded before Flop


Poker Hand #TM3547543189: Tournament #156323098, Bounty Hunters $1.08 Hold'em No Limit - Level16(1,000/2,000) - 2024/08/04 00:29:34
Table '12' 8-max Seat #3 is the button
Seat 1: Hero (17,904 in chips)
Seat 2: de851319 (166,672 in chips)
Seat 3: 42d07d8f (44,454 in chips)
Seat 4: 7c5448c1 (70,070 in chips)
Seat 5: a75b7bb6 (34,338 in chips)
Seat 6: cd7e1bca (71,186 in chips)
Seat 7: fcdde401 (115,279 in chips)
Seat 8: 207e2b94 (89,327 in chips)
207e2b94: posts the ante 300
42d07d8f: posts the ante 300
cd7e1bca: posts the ante 300
7c5448c1: posts the ante 300
de851319: posts the ante 300
fcdde401: posts the ante 300
a75b7bb6: posts the ante 300
Hero: posts the ante 300
7c5448c1: posts small blind 1,000
a75b7bb6: posts big blind 2,000
*** HOLE CARDS ***
Dealt to Hero [Ah 9s]
Dealt to de851319 
Dealt to 42d07d8f 
Dealt to 7c5448c1 
Dealt to a75b7bb6 
Dealt to cd7e1bca 
Dealt to fcdde401 
Dealt to 207e2b94 
cd7e1bca: folds
fcdde401: calls 2,000
207e2b94: folds
Hero: calls 2,000
de851319: folds
42d07d8f: raises 2,000 to 4,000
7c5448c1: folds
a75b7bb6: folds
fcdde401: calls 2,000
Hero: calls 2,000
*** FLOP *** [Jc 8c 9h]
fcdde401: checks
Hero: bets 13,604 and is all-in
42d07d8f: raises 26,550 to 40,154 and is all-in
fcdde401: folds
Uncalled bet (26,550) returned to 42d07d8f
42d07d8f: shows [Th Ac] (Ace-High)
Hero: shows [Ah 9s] (Pair of Nines)
*** TURN *** [Jc 8c 9h] [Jh]
*** RIVER *** [Jc 8c 9h Jh] [3s]
*** SHOWDOWN ***
Hero collected 44,608 from pot
*** SUMMARY ***
Total pot 44,608 | Rake 0 | Jackpot 0 | Bingo 0 | Fortune 0 | Tax 0
Board [Jc 8c 9h Jh 3s]
Seat 1: Hero showed [Ah 9s] and won (44,608) with Pair of Jacks and Pair of Nines
Seat 2: de851319 folded before Flop
Seat 3: 42d07d8f (button) showed [Th Ac] and lost with Pair of Jacks
Seat 4: 7c5448c1 (small blind) folded before Flop
Seat 5: a75b7bb6 (big blind) folded before Flop
Seat 6: cd7e1bca folded before Flop
Seat 7: fcdde401 folded on the Flop
Seat 8: 207e2b94 folded before Flop


Poker Hand #TM3547543142: Tournament #156323098, Bounty Hunters $1.08 Hold'em No Limit - Level16(1,000/2,000) - 2024/08/04 00:28:23
Table '12' 8-max Seat #2 is the button
Seat 1: Hero (18,204 in chips)
Seat 2: de851319 (166,972 in chips)
Seat 3: 42d07d8f (45,754 in chips)
Seat 4: 7c5448c1 (78,370 in chips)
Seat 5: a75b7bb6 (34,638 in chips)
Seat 6: cd7e1bca (90,994 in chips)
Seat 7: fcdde401 (84,671 in chips)
Seat 8: 207e2b94 (89,627 in chips)
207e2b94: posts the ante 300
cd7e1bca: posts the ante 300
42d07d8f: posts the ante 300
7c5448c1: posts the ante 300
de851319: posts the ante 300
fcdde401: posts the ante 300
a75b7bb6: posts the ante 300
Hero: posts the ante 300
42d07d8f: posts small blind 1,000
7c5448c1: posts big blind 2,000
*** HOLE CARDS ***
Dealt to Hero [6s 5s]
Dealt to de851319 
Dealt to 42d07d8f 
Dealt to 7c5448c1 
Dealt to a75b7bb6 
Dealt to cd7e1bca 
Dealt to fcdde401 
Dealt to 207e2b94 
a75b7bb6: folds
cd7e1bca: raises 3,000 to 5,000
fcdde401: raises 3,000 to 8,000
207e2b94: folds
Hero: folds
de851319: folds
42d07d8f: folds
7c5448c1: calls 6,000
cd7e1bca: calls 3,000
*** FLOP *** [6c Kh Qs]
7c5448c1: checks
cd7e1bca: checks
fcdde401: checks
*** TURN *** [6c Kh Qs] [Ac]
7c5448c1: checks
cd7e1bca: bets 11,508
fcdde401: raises 13,508 to 25,016
7c5448c1: folds
cd7e1bca: folds
Uncalled bet (13,508) returned to fcdde401
*** SHOWDOWN ***
fcdde401 collected 50,416 from pot
*** SUMMARY ***
Total pot 50,416 | Rake 0 | Jackpot 0 | Bingo 0 | Fortune 0 | Tax 0
Board [6c Kh Qs Ac]
Seat 1: Hero folded before Flop
Seat 2: de851319 (button) folded before Flop
Seat 3: 42d07d8f (small blind) folded before Flop
Seat 4: 7c5448c1 (big blind) folded on the Turn
Seat 5: a75b7bb6 folded before Flop
Seat 6: cd7e1bca folded on the Turn
Seat 7: fcdde401 won (50,416)
Seat 8: 207e2b94 folded before Flop


Poker Hand #TM3547543108: Tournament #156323098, Bounty Hunters $1.08 Hold'em No Limit - Level15(800/1,600) - 2024/08/04 00:27:31
Table '12' 8-max Seat #1 is the button
Seat 1: Hero (18,454 in chips)
Seat 2: de851319 (168,022 in chips)
Seat 3: 42d07d8f (47,604 in chips)
Seat 4: 7c5448c1 (57,620 in chips)
Seat 5: a75b7bb6 (34,888 in chips)
Seat 6: cd7e1bca (91,244 in chips)
Seat 7: fcdde401 (101,521 in chips)
Seat 8: 207e2b94 (89,877 in chips)
207e2b94: posts the ante 250
cd7e1bca: posts the ante 250
42d07d8f: posts the ante 250
7c5448c1: posts the ante 250
fcdde401: posts the ante 250
de851319: posts the ante 250
a75b7bb6: posts the ante 250
Hero: posts the ante 250
de851319: posts small blind 800
42d07d8f: posts big blind 1,600
*** HOLE CARDS ***
Dealt to Hero [3d 5s]
Dealt to de851319 
Dealt to 42d07d8f 
Dealt to 7c5448c1 
Dealt to a75b7bb6 
Dealt to cd7e1bca 
Dealt to fcdde401 
Dealt to 207e2b94 
7c5448c1: raises 1,600 to 3,200
a75b7bb6: folds
cd7e1bca: folds
fcdde401: calls 3,200
207e2b94: folds
Hero: folds
de851319: folds
42d07d8f: folds
*** FLOP *** [Ks 2s As]
7c5448c1: checks
fcdde401: checks
*** TURN *** [Ks 2s As] [8s]
7c5448c1: bets 5,400
fcdde401: calls 5,400
*** RIVER *** [Ks 2s As 8s] [Kd]
7c5448c1: bets 8,000
fcdde401: calls 8,000
7c5448c1: shows [3c 3s] (Ace High Flush)
fcdde401: shows [Ah 2h] (Pair of Aces and Pair of Kings)
*** SHOWDOWN ***
7c5448c1 collected 37,600 from pot
*** SUMMARY ***
Total pot 37,600 | Rake 0 | Jackpot 0 | Bingo 0 | Fortune 0 | Tax 0
Board [Ks 2s As 8s Kd]
Seat 1: Hero (button) folded before Flop
Seat 2: de851319 (small blind) folded before Flop
Seat 3: 42d07d8f (big blind) folded before Flop
Seat 4: 7c5448c1 showed [3c 3s] and won (37,600) with Ace High Flush
Seat 5: a75b7bb6 folded before Flop
Seat 6: cd7e1bca folded before Flop
Seat 7: fcdde401 showed [Ah 2h] and lost with Pair of Aces and Pair of Kings
Seat 8: 207e2b94 folded before Flop


Poker Hand #TM3547543037: Tournament #156323098, Bounty Hunters $1.08 Hold'em No Limit - Level15(800/1,600) - 2024/08/04 00:26:03
Table '12' 8-max Seat #8 is the button
Seat 1: Hero (19,504 in chips)
Seat 2: de851319 (135,844 in chips)
Seat 3: 42d07d8f (47,854 in chips)
Seat 4: 7c5448c1 (67,470 in chips)
Seat 5: a75b7bb6 (35,138 in chips)
Seat 6: cd7e1bca (91,494 in chips)
Seat 7: fcdde401 (121,799 in chips)
Seat 8: 207e2b94 (90,127 in chips)
207e2b94: posts the ante 250
cd7e1bca: posts the ante 250
42d07d8f: posts the ante 250
7c5448c1: posts the ante 250
fcdde401: posts the ante 250
de851319: posts the ante 250
a75b7bb6: posts the ante 250
Hero: posts the ante 250
Hero: posts small blind 800
de851319: posts big blind 1,600
*** HOLE CARDS ***
Dealt to Hero [Qc 7s]
Dealt to de851319 
Dealt to 42d07d8f 
Dealt to 7c5448c1 
Dealt to a75b7bb6 
Dealt to cd7e1bca 
Dealt to fcdde401 
Dealt to 207e2b94 
42d07d8f: folds
7c5448c1: raises 1,600 to 3,200
a75b7bb6: folds
cd7e1bca: folds
fcdde401: raises 6,400 to 9,600
207e2b94: folds
Hero: folds
de851319: calls 8,000
7c5448c1: calls 6,400
*** FLOP *** [8d 6d 7c]
de851319: checks
7c5448c1: checks
fcdde401: bets 10,428
de851319: calls 10,428
7c5448c1: folds
*** TURN *** [8d 6d 7c] [Jd]
de851319: checks
fcdde401: checks
*** RIVER *** [8d 6d 7c Jd] [Jc]
de851319: bets 115,566 and is all-in
fcdde401: folds
Uncalled bet (115,566) returned to de851319
*** SHOWDOWN ***
de851319 collected 52,456 from pot
*** SUMMARY ***
Total pot 52,456 | Rake 0 | Jackpot 0 | Bingo 0 | Fortune 0 | Tax 0
Board [8d 6d 7c Jd Jc]
Seat 1: Hero (small blind) folded before Flop
Seat 2: de851319 (big blind) won (52,456)
Seat 3: 42d07d8f folded before Flop
Seat 4: 7c5448c1 folded on the Flop
Seat 5: a75b7bb6 folded before Flop
Seat 6: cd7e1bca folded before Flop
Seat 7: fcdde401 folded on the River
Seat 8: 207e2b94 (button) folded before Flop


Poker Hand #TM3547542975: Tournament #156323098, Bounty Hunters $1.08 Hold'em No Limit - Level15(800/1,600) - 2024/08/04 00:24:40
Table '12' 8-max Seat #7 is the button
Seat 1: Hero (21,354 in chips)
Seat 2: de851319 (136,094 in chips)
Seat 3: 42d07d8f (48,104 in chips)
Seat 4: 7c5448c1 (67,720 in chips)
Seat 5: a75b7bb6 (36,988 in chips)
Seat 6: cd7e1bca (99,140 in chips)
Seat 7: fcdde401 (122,049 in chips)
Seat 8: 207e2b94 (77,781 in chips)
207e2b94: posts the ante 250
cd7e1bca: posts the ante 250
42d07d8f: posts the ante 250
7c5448c1: posts the ante 250
fcdde401: posts the ante 250
de851319: posts the ante 250
a75b7bb6: posts the ante 250
Hero: posts the ante 250
207e2b94: posts small blind 800
Hero: posts big blind 1,600
*** HOLE CARDS ***
Dealt to Hero [3d 9d]
Dealt to de851319 
Dealt to 42d07d8f 
Dealt to 7c5448c1 
Dealt to a75b7bb6 
Dealt to cd7e1bca 
Dealt to fcdde401 
Dealt to 207e2b94 
de851319: folds
42d07d8f: folds
7c5448c1: folds
a75b7bb6: calls 1,600
cd7e1bca: calls 1,600
fcdde401: folds
207e2b94: calls 800
Hero: checks
*** FLOP *** [5d 2c Kd]
207e2b94: checks
Hero: checks
a75b7bb6: checks
cd7e1bca: bets 5,796
207e2b94: calls 5,796
Hero: folds
a75b7bb6: folds
*** TURN *** [5d 2c Kd] [4c]
207e2b94: checks
cd7e1bca: checks
*** RIVER *** [5d 2c Kd 4c] [5h]
207e2b94: checks
cd7e1bca: checks
207e2b94: shows [4h 3h] (Pair of Fives and Pair of Fours)
cd7e1bca: shows [7d Ad] (Pair of Fives)
*** SHOWDOWN ***
207e2b94 collected 19,992 from pot
*** SUMMARY ***
Total pot 19,992 | Rake 0 | Jackpot 0 | Bingo 0 | Fortune 0 | Tax 0
Board [5d 2c Kd 4c 5h]
Seat 1: Hero (big blind) folded on the Flop
Seat 2: de851319 folded before Flop
Seat 3: 42d07d8f folded before Flop
Seat 4: 7c5448c1 folded before Flop
Seat 5: a75b7bb6 folded on the Flop
Seat 6: cd7e1bca showed [7d Ad] and lost with Pair of Fives
Seat 7: fcdde401 (button) folded before Flop
Seat 8: 207e2b94 (small blind) showed [4h 3h] and won (19,992) with Pair of Fives and Pair of Fours


Poker Hand #TM3547542924: Tournament #156323098, Bounty Hunters $1.08 Hold'em No Limit - Level15(800/1,600) - 2024/08/04 00:23:43
Table '12' 8-max Seat #6 is the button
Seat 1: Hero (21,604 in chips)
Seat 2: de851319 (136,344 in chips)
Seat 3: 42d07d8f (48,354 in chips)
Seat 4: 7c5448c1 (67,970 in chips)
Seat 5: a75b7bb6 (17,344 in chips)
Seat 6: cd7e1bca (99,390 in chips)
Seat 7: fcdde401 (123,099 in chips)
Seat 8: 207e2b94 (95,125 in chips)
207e2b94: posts the ante 250
cd7e1bca: posts the ante 250
42d07d8f: posts the ante 250
7c5448c1: posts the ante 250
de851319: posts the ante 250
fcdde401: posts the ante 250
a75b7bb6: posts the ante 250
Hero: posts the ante 250
fcdde401: posts small blind 800
207e2b94: posts big blind 1,600
*** HOLE CARDS ***
Dealt to Hero [7c 3h]
Dealt to de851319 
Dealt to 42d07d8f 
Dealt to 7c5448c1 
Dealt to a75b7bb6 
Dealt to cd7e1bca 
Dealt to fcdde401 
Dealt to 207e2b94 
Hero: folds
de851319: folds
42d07d8f: folds
7c5448c1: folds
a75b7bb6: raises 15,494 to 17,094 and is all-in
cd7e1bca: folds
fcdde401: folds
207e2b94: calls 15,494
a75b7bb6: shows [Ah Th]
207e2b94: shows [Js As]
*** FLOP *** [9d 7s 6d]
*** TURN *** [9d 7s 6d] [8s]
*** RIVER *** [9d 7s 6d 8s] [2h]
*** SHOWDOWN ***
a75b7bb6 collected 36,988 from pot
*** SUMMARY ***
Total pot 36,988 | Rake 0 | Jackpot 0 | Bingo 0 | Fortune 0 | Tax 0
Board [9d 7s 6d 8s 2h]
Seat 1: Hero folded before Flop
Seat 2: de851319 folded before Flop
Seat 3: 42d07d8f folded before Flop
Seat 4: 7c5448c1 folded before Flop
Seat 5: a75b7bb6 showed [Ah Th] and won (36,988) with Tens-High Straight
Seat 6: cd7e1bca (button) folded before Flop
Seat 7: fcdde401 (small blind) folded before Flop
Seat 8: 207e2b94 (big blind) showed [Js As] and lost with Ace-High


Poker Hand #TM3547542895: Tournament #156323098, Bounty Hunters $1.08 Hold'em No Limit - Level15(800/1,600) - 2024/08/04 00:23:03
Table '12' 8-max Seat #5 is the button
Seat 1: Hero (21,854 in chips)
Seat 2: de851319 (136,594 in chips)
Seat 4: 7c5448c1 (68,220 in chips)
Seat 5: a75b7bb6 (10,244 in chips)
Seat 6: cd7e1bca (100,440 in chips)
Seat 7: fcdde401 (124,949 in chips)
Seat 8: 207e2b94 (98,575 in chips)
207e2b94: posts the ante 250
cd7e1bca: posts the ante 250
7c5448c1: posts the ante 250
de851319: posts the ante 250
fcdde401: posts the ante 250
a75b7bb6: posts the ante 250
Hero: posts the ante 250
cd7e1bca: posts small blind 800
fcdde401: posts big blind 1,600
*** HOLE CARDS ***
Dealt to Hero [5d Qh]
Dealt to de851319 
Dealt to 7c5448c1 
Dealt to a75b7bb6 
Dealt to cd7e1bca 
Dealt to fcdde401 
Dealt to 207e2b94 
207e2b94: raises 1,600 to 3,200
Hero: folds
de851319: folds
7c5448c1: folds
a75b7bb6: raises 6,794 to 9,994 and is all-in
cd7e1bca: folds
fcdde401: folds
207e2b94: folds
Uncalled bet (6,794) returned to a75b7bb6
*** SHOWDOWN ***
a75b7bb6 collected 10,550 from pot
*** SUMMARY ***
Total pot 10,550 | Rake 0 | Jackpot 0 | Bingo 0 | Fortune 0 | Tax 0
Seat 1: Hero folded before Flop
Seat 2: de851319 folded before Flop
Seat 4: 7c5448c1 folded before Flop
Seat 5: a75b7bb6 (button) collected (10,550)
Seat 6: cd7e1bca (small blind) folded before Flop
Seat 7: fcdde401 (big blind) folded before Flop
Seat 8: 207e2b94 folded before Flop


Poker Hand #TM3547542845: Tournament #156323098, Bounty Hunters $1.08 Hold'em No Limit - Level15(800/1,600) - 2024/08/04 00:22:06
Table '12' 8-max Seat #4 is the button
Seat 1: Hero (22,104 in chips)
Seat 2: de851319 (136,844 in chips)
Seat 3: 26bfd0ac (13,916 in chips)
Seat 4: 7c5448c1 (68,470 in chips)
Seat 5: a75b7bb6 (11,294 in chips)
Seat 6: cd7e1bca (102,290 in chips)
Seat 7: fcdde401 (93,433 in chips)
Seat 8: 207e2b94 (112,525 in chips)
207e2b94: posts the ante 250
26bfd0ac: posts the ante 250
cd7e1bca: posts the ante 250
7c5448c1: posts the ante 250
de851319: posts the ante 250
fcdde401: posts the ante 250
a75b7bb6: posts the ante 250
Hero: posts the ante 250
a75b7bb6: posts small blind 800
cd7e1bca: posts big blind 1,600
*** HOLE CARDS ***
Dealt to Hero [9c Jd]
Dealt to de851319 
Dealt to 26bfd0ac 
Dealt to 7c5448c1 
Dealt to a75b7bb6 
Dealt to cd7e1bca 
Dealt to fcdde401 
Dealt to 207e2b94 
fcdde401: raises 1,600 to 3,200
207e2b94: calls 3,200
Hero: folds
de851319: folds
26bfd0ac: calls 3,200
7c5448c1: folds
a75b7bb6: folds
cd7e1bca: folds
*** FLOP *** [Tc Qh Jh]
fcdde401: checks
207e2b94: checks
26bfd0ac: checks
*** TURN *** [Tc Qh Jh] [As]
fcdde401: checks
207e2b94: bets 10,500
26bfd0ac: calls 10,466 and is all-in
fcdde401: calls 10,500
*** RIVER *** [Tc Qh Jh As] [Qs]
fcdde401: checks
207e2b94: checks
fcdde401: shows [Ad Ts] (Pair of Aces and Pair of Queens)
207e2b94: shows [2h 2d] (Pair of Queens and Pair of Twos)
26bfd0ac: shows [8h 7h] (Pair of Queens)
*** SHOWDOWN ***
fcdde401 collected 45,398 from pot
fcdde401 collected 68 from pot
*** SUMMARY ***
Total pot 45,466 | Rake 0 | Jackpot 0 | Bingo 0 | Fortune 0 | Tax 0
Board [Tc Qh Jh As Qs]
Seat 1: Hero folded before Flop
Seat 2: de851319 folded before Flop
Seat 3: 26bfd0ac showed [8h 7h] and lost with Pair of Queens
Seat 4: 7c5448c1 (button) folded before Flop
Seat 5: a75b7bb6 (small blind) folded before Flop
Seat 6: cd7e1bca (big blind) folded before Flop
Seat 7: fcdde401 showed [Ad Ts] and won (45,466) with Pair of Aces and Pair of Queens
Seat 8: 207e2b94 showed [2h 2d] and lost with Pair of Queens and Pair of Twos


Poker Hand #TM3547542807: Tournament #156323098, Bounty Hunters $1.08 Hold'em No Limit - Level15(800/1,600) - 2024/08/04 00:21:22
Table '12' 8-max Seat #3 is the button
Seat 1: Hero (22,354 in chips)
Seat 2: de851319 (137,094 in chips)
Seat 3: 26bfd0ac (5,808 in chips)
Seat 4: 7c5448c1 (69,520 in chips)
Seat 5: a75b7bb6 (17,102 in chips)
Seat 6: cd7e1bca (102,540 in chips)
Seat 7: fcdde401 (93,683 in chips)
Seat 8: 207e2b94 (112,775 in chips)
207e2b94: posts the ante 250
26bfd0ac: posts the ante 250
cd7e1bca: posts the ante 250
7c5448c1: posts the ante 250
de851319: posts the ante 250
fcdde401: posts the ante 250
a75b7bb6: posts the ante 250
Hero: posts the ante 250
7c5448c1: posts small blind 800
a75b7bb6: posts big blind 1,600
*** HOLE CARDS ***
Dealt to Hero [Js 5h]
Dealt to de851319 
Dealt to 26bfd0ac 
Dealt to 7c5448c1 
Dealt to a75b7bb6 
Dealt to cd7e1bca 
Dealt to fcdde401 
Dealt to 207e2b94 
cd7e1bca: folds
fcdde401: folds
207e2b94: folds
Hero: folds
de851319: folds
26bfd0ac: raises 3,958 to 5,558 and is all-in
7c5448c1: folds
a75b7bb6: calls 3,958
26bfd0ac: shows [9c Ac]
a75b7bb6: shows [9d Td]
*** FLOP *** [3d 2s Ah]
*** TURN *** [3d 2s Ah] [5s]
*** RIVER *** [3d 2s Ah 5s] [8h]
*** SHOWDOWN ***
26bfd0ac collected 13,916 from pot
*** SUMMARY ***
Total pot 13,916 | Rake 0 | Jackpot 0 | Bingo 0 | Fortune 0 | Tax 0
Board [3d 2s Ah 5s 8h]
Seat 1: Hero folded before Flop
Seat 2: de851319 folded before Flop
Seat 3: 26bfd0ac (button) showed [9c Ac] and won (13,916) with Pair of Aces
Seat 4: 7c5448c1 (small blind) folded before Flop
Seat 5: a75b7bb6 (big blind) showed [9d Td] and lost with Ace-High
Seat 6: cd7e1bca folded before Flop
Seat 7: fcdde401 folded before Flop
Seat 8: 207e2b94 folded before Flop


Poker Hand #TM3547542769: Tournament #156323098, Bounty Hunters $1.08 Hold'em No Limit - Level14(600/1,200) - 2024/08/04 00:20:44
Table '12' 8-max Seat #2 is the button
Seat 1: Hero (22,534 in chips)
Seat 2: de851319 (137,274 in chips)
Seat 3: 26bfd0ac (6,588 in chips)
Seat 4: 7c5448c1 (72,700 in chips)
Seat 5: a75b7bb6 (17,282 in chips)
Seat 6: cd7e1bca (97,680 in chips)
Seat 7: fcdde401 (93,863 in chips)
Seat 8: 207e2b94 (112,955 in chips)
207e2b94: posts the ante 180
cd7e1bca: posts the ante 180
26bfd0ac: posts the ante 180
7c5448c1: posts the ante 180
de851319: posts the ante 180
fcdde401: posts the ante 180
a75b7bb6: posts the ante 180
Hero: posts the ante 180
26bfd0ac: posts small blind 600
7c5448c1: posts big blind 1,200
*** HOLE CARDS ***
Dealt to Hero [Jc 6d]
Dealt to de851319 
Dealt to 26bfd0ac 
Dealt to 7c5448c1 
Dealt to a75b7bb6 
Dealt to cd7e1bca 
Dealt to fcdde401 
Dealt to 207e2b94 
a75b7bb6: folds
cd7e1bca: raises 1,800 to 3,000
fcdde401: folds
207e2b94: folds
Hero: folds
de851319: folds
26bfd0ac: folds
7c5448c1: calls 1,800
*** FLOP *** [4s Js Ac]
7c5448c1: checks
cd7e1bca: bets 3,377
7c5448c1: folds
Uncalled bet (3,377) returned to cd7e1bca
*** SHOWDOWN ***
cd7e1bca collected 8,040 from pot
*** SUMMARY ***
Total pot 8,040 | Rake 0 | Jackpot 0 | Bingo 0 | Fortune 0 | Tax 0
Board [4s Js Ac]
Seat 1: Hero folded before Flop
Seat 2: de851319 (button) folded before Flop
Seat 3: 26bfd0ac (small blind) folded before Flop
Seat 4: 7c5448c1 (big blind) folded on the Flop
Seat 5: a75b7bb6 folded before Flop
Seat 6: cd7e1bca won (8,040)
Seat 7: fcdde401 folded before Flop
Seat 8: 207e2b94 folded before Flop


Poker Hand #TM3547542739: Tournament #156323098, Bounty Hunters $1.08 Hold'em No Limit - Level14(600/1,200) - 2024/08/04 00:20:09
Table '12' 8-max Seat #1 is the button
Seat 1: Hero (22,714 in chips)
Seat 2: de851319 (140,454 in chips)
Seat 3: 26bfd0ac (7,968 in chips)
Seat 4: 7c5448c1 (72,880 in chips)
Seat 5: a75b7bb6 (17,462 in chips)
Seat 6: cd7e1bca (97,860 in chips)
Seat 7: fcdde401 (94,043 in chips)
Seat 8: 207e2b94 (107,495 in chips)
207e2b94: posts the ante 180
cd7e1bca: posts the ante 180
26bfd0ac: posts the ante 180
7c5448c1: posts the ante 180
fcdde401: posts the ante 180
de851319: posts the ante 180
a75b7bb6: posts the ante 180
Hero: posts the ante 180
de851319: posts small blind 600
26bfd0ac: posts big blind 1,200
*** HOLE CARDS ***
Dealt to Hero [Kh 7d]
Dealt to de851319 
Dealt to 26bfd0ac 
Dealt to 7c5448c1 
Dealt to a75b7bb6 
Dealt to cd7e1bca 
Dealt to fcdde401 
Dealt to 207e2b94 
7c5448c1: folds
a75b7bb6: folds
cd7e1bca: folds
fcdde401: folds
207e2b94: raises 1,800 to 3,000
Hero: folds
de851319: calls 2,400
26bfd0ac: folds
*** FLOP *** [Ks 9d 8h]
de851319: checks
207e2b94: bets 6,480
de851319: folds
Uncalled bet (6,480) returned to 207e2b94
*** SHOWDOWN ***
207e2b94 collected 8,640 from pot
*** SUMMARY ***
Total pot 8,640 | Rake 0 | Jackpot 0 | Bingo 0 | Fortune 0 | Tax 0
Board [Ks 9d 8h]
Seat 1: Hero (button) folded before Flop
Seat 2: de851319 (small blind) folded on the Flop
Seat 3: 26bfd0ac (big blind) folded before Flop
Seat 4: 7c5448c1 folded before Flop
Seat 5: a75b7bb6 folded before Flop
Seat 6: cd7e1bca folded before Flop
Seat 7: fcdde401 folded before Flop
Seat 8: 207e2b94 won (8,640)


Poker Hand #TM3547542693: Tournament #156323098, Bounty Hunters $1.08 Hold'em No Limit - Level14(600/1,200) - 2024/08/04 00:19:09
Table '12' 8-max Seat #8 is the button
Seat 1: Hero (23,494 in chips)
Seat 2: de851319 (141,834 in chips)
Seat 3: 26bfd0ac (15,134 in chips)
Seat 4: 7c5448c1 (73,060 in chips)
Seat 6: cd7e1bca (98,040 in chips)
Seat 7: fcdde401 (94,223 in chips)
Seat 8: 207e2b94 (97,629 in chips)
207e2b94: posts the ante 180
cd7e1bca: posts the ante 180
26bfd0ac: posts the ante 180
7c5448c1: posts the ante 180
fcdde401: posts the ante 180
de851319: posts the ante 180
Hero: posts the ante 180
Hero: posts small blind 600
de851319: posts big blind 1,200
*** HOLE CARDS ***
Dealt to Hero [8s Jd]
Dealt to de851319 
Dealt to 26bfd0ac 
Dealt to 7c5448c1 
Dealt to cd7e1bca 
Dealt to fcdde401 
Dealt to 207e2b94 
26bfd0ac: calls 1,200
7c5448c1: folds
cd7e1bca: folds
fcdde401: folds
207e2b94: raises 2,400 to 3,600
Hero: folds
de851319: folds
26bfd0ac: calls 2,400
*** FLOP *** [Qh 6d 8d]
26bfd0ac: bets 3,386
207e2b94: calls 3,386
*** TURN *** [Qh 6d 8d] [As]
26bfd0ac: checks
207e2b94: checks
*** RIVER *** [Qh 6d 8d As] [6h]
26bfd0ac: checks
207e2b94: checks
26bfd0ac: shows [7c 7s] (Pair of Sevens and Pair of Sixes)
207e2b94: shows [Th Ts] (Pair of Tens and Pair of Sixes)
*** SHOWDOWN ***
207e2b94 collected 17,032 from pot
*** SUMMARY ***
Total pot 17,032 | Rake 0 | Jackpot 0 | Bingo 0 | Fortune 0 | Tax 0
Board [Qh 6d 8d As 6h]
Seat 1: Hero (small blind) folded before Flop
Seat 2: de851319 (big blind) folded before Flop
Seat 3: 26bfd0ac showed [7c 7s] and lost with Pair of Sevens and Pair of Sixes
Seat 4: 7c5448c1 folded before Flop
Seat 6: cd7e1bca folded before Flop
Seat 7: fcdde401 folded before Flop
Seat 8: 207e2b94 (button) showed [Th Ts] and won (17,032) with Pair of Tens and Pair of Sixes


Poker Hand #TM3547542668: Tournament #156323098, Bounty Hunters $1.08 Hold'em No Limit - Level14(600/1,200) - 2024/08/04 00:18:46
Table '12' 8-max Seat #6 is the button
Seat 1: Hero (24,874 in chips)
Seat 2: de851319 (142,014 in chips)
Seat 3: 26bfd0ac (15,314 in chips)
Seat 4: 7c5448c1 (73,240 in chips)
Seat 6: cd7e1bca (95,340 in chips)
Seat 8: 207e2b94 (98,409 in chips)
207e2b94: posts the ante 180
cd7e1bca: posts the ante 180
26bfd0ac: posts the ante 180
7c5448c1: posts the ante 180
de851319: posts the ante 180
Hero: posts the ante 180
207e2b94: posts small blind 600
Hero: posts big blind 1,200
*** HOLE CARDS ***
Dealt to Hero [Js 8h]
Dealt to de851319 
Dealt to 26bfd0ac 
Dealt to 7c5448c1 
Dealt to cd7e1bca 
Dealt to 207e2b94 
de851319: folds
26bfd0ac: folds
7c5448c1: folds
cd7e1bca: raises 1,800 to 3,000
207e2b94: folds
Hero: folds
Uncalled bet (1,800) returned to cd7e1bca
*** SHOWDOWN ***
cd7e1bca collected 4,080 from pot
*** SUMMARY ***
Total pot 4,080 | Rake 0 | Jackpot 0 | Bingo 0 | Fortune 0 | Tax 0
Seat 1: Hero (big blind) folded before Flop
Seat 2: de851319 folded before Flop
Seat 3: 26bfd0ac folded before Flop
Seat 4: 7c5448c1 folded before Flop
Seat 6: cd7e1bca (button) collected (4,080)
Seat 8: 207e2b94 (small blind) folded before Flop


Poker Hand #TM3547542631: Tournament #156323098, Bounty Hunters $1.08 Hold'em No Limit - Level14(600/1,200) - 2024/08/04 00:17:58
Table '12' 8-max Seat #5 is the button
Seat 1: Hero (25,054 in chips)
Seat 2: de851319 (60,312 in chips)
Seat 3: 26bfd0ac (15,494 in chips)
Seat 4: 7c5448c1 (73,420 in chips)
Seat 5: 8c9120dd (28,091 in chips)
Seat 6: cd7e1bca (96,120 in chips)
Seat 7: 6b116d4c (52,111 in chips)
Seat 8: 207e2b94 (98,589 in chips)
207e2b94: posts the ante 180
26bfd0ac: posts the ante 180
cd7e1bca: posts the ante 180
7c5448c1: posts the ante 180
6b116d4c: posts the ante 180
de851319: posts the ante 180
8c9120dd: posts the ante 180
Hero: posts the ante 180
cd7e1bca: posts small blind 600
6b116d4c: posts big blind 1,200
*** HOLE CARDS ***
Dealt to Hero [2s Td]
Dealt to de851319 
Dealt to 26bfd0ac 
Dealt to 7c5448c1 
Dealt to 8c9120dd 
Dealt to cd7e1bca 
Dealt to 6b116d4c 
Dealt to 207e2b94 
207e2b94: folds
Hero: folds
de851319: raises 1,200 to 2,400
26bfd0ac: folds
7c5448c1: folds
8c9120dd: raises 25,511 to 27,911 and is all-in
cd7e1bca: folds
6b116d4c: calls 26,711
de851319: raises 32,221 to 60,132 and is all-in
6b116d4c: calls 24,020 and is all-in
Uncalled bet (8,201) returned to de851319
de851319: shows [Kc Kh]
8c9120dd: shows [Ac Jc]
6b116d4c: shows [Qd Ad]
*** FLOP *** [5h 5s 6s]
*** TURN *** [5h 5s 6s] [9d]
*** RIVER *** [5h 5s 6s 9d] [7s]
*** SHOWDOWN ***
de851319 collected 85,773 from pot
de851319 collected 48,040 from pot
*** SUMMARY ***
Total pot 133,813 | Rake 0 | Jackpot 0 | Bingo 0 | Fortune 0 | Tax 0
Board [5h 5s 6s 9d 7s]
Seat 1: Hero folded before Flop
Seat 2: de851319 showed [Kc Kh] and won (133,813) with Pair of Kings and Pair of Fives
Seat 3: 26bfd0ac folded before Flop
Seat 4: 7c5448c1 folded before Flop
Seat 5: 8c9120dd (button) showed [Ac Jc] and lost with Pair of Fives
Seat 6: cd7e1bca (small blind) folded before Flop
Seat 7: 6b116d4c (big blind) showed [Qd Ad] and lost with Pair of Fives
Seat 8: 207e2b94 folded before Flop


Poker Hand #TM3547542594: Tournament #156323098, Bounty Hunters $1.08 Hold'em No Limit - Level14(600/1,200) - 2024/08/04 00:17:20
Table '12' 8-max Seat #4 is the button
Seat 1: Hero (27,634 in chips)
Seat 2: de851319 (60,492 in chips)
Seat 3: 26bfd0ac (15,674 in chips)
Seat 4: 7c5448c1 (73,600 in chips)
Seat 5: 8c9120dd (30,671 in chips)
Seat 6: cd7e1bca (97,500 in chips)
Seat 7: 6b116d4c (52,291 in chips)
Seat 8: 207e2b94 (91,329 in chips)
207e2b94: posts the ante 180
26bfd0ac: posts the ante 180
cd7e1bca: posts the ante 180
7c5448c1: posts the ante 180
6b116d4c: posts the ante 180
de851319: posts the ante 180
8c9120dd: posts the ante 180
Hero: posts the ante 180
8c9120dd: posts small blind 600
cd7e1bca: posts big blind 1,200
*** HOLE CARDS ***
Dealt to Hero [Ac Td]
Dealt to de851319 
Dealt to 26bfd0ac 
Dealt to 7c5448c1 
Dealt to 8c9120dd 
Dealt to cd7e1bca 
Dealt to 6b116d4c 
Dealt to 207e2b94 
6b116d4c: folds
207e2b94: raises 1,200 to 2,400
Hero: calls 2,400
de851319: folds
26bfd0ac: folds
7c5448c1: folds
8c9120dd: calls 1,800
cd7e1bca: folds
*** FLOP *** [6c Kd 2d]
8c9120dd: checks
207e2b94: bets 7,380
Hero: folds
8c9120dd: folds
Uncalled bet (7,380) returned to 207e2b94
*** SHOWDOWN ***
207e2b94 collected 9,840 from pot
*** SUMMARY ***
Total pot 9,840 | Rake 0 | Jackpot 0 | Bingo 0 | Fortune 0 | Tax 0
Board [6c Kd 2d]
Seat 1: Hero folded on the Flop
Seat 2: de851319 folded before Flop
Seat 3: 26bfd0ac folded before Flop
Seat 4: 7c5448c1 (button) folded before Flop
Seat 5: 8c9120dd (small blind) folded on the Flop
Seat 6: cd7e1bca (big blind) folded before Flop
Seat 7: 6b116d4c folded before Flop
Seat 8: 207e2b94 won (9,840)


Poker Hand #TM3547542574: Tournament #156323098, Bounty Hunters $1.08 Hold'em No Limit - Level14(600/1,200) - 2024/08/04 00:16:55
Table '12' 8-max Seat #3 is the button
Seat 1: Hero (27,814 in chips)
Seat 2: de851319 (60,672 in chips)
Seat 3: 26bfd0ac (15,854 in chips)
Seat 4: 7c5448c1 (76,180 in chips)
Seat 5: 8c9120dd (27,011 in chips)
Seat 6: cd7e1bca (97,680 in chips)
Seat 7: 6b116d4c (52,471 in chips)
Seat 8: 207e2b94 (91,509 in chips)
207e2b94: posts the ante 180
26bfd0ac: posts the ante 180
cd7e1bca: posts the ante 180
7c5448c1: posts the ante 180
6b116d4c: posts the ante 180
de851319: posts the ante 180
8c9120dd: posts the ante 180
Hero: posts the ante 180
7c5448c1: posts small blind 600
8c9120dd: posts big blind 1,200
*** HOLE CARDS ***
Dealt to Hero [Td 5d]
Dealt to de851319 
Dealt to 26bfd0ac 
Dealt to 7c5448c1 
Dealt to 8c9120dd 
Dealt to cd7e1bca 
Dealt to 6b116d4c 
Dealt to 207e2b94 
cd7e1bca: folds
6b116d4c: folds
207e2b94: folds
Hero: folds
de851319: folds
26bfd0ac: folds
7c5448c1: raises 1,200 to 2,400
8c9120dd: raises 24,431 to 26,831 and is all-in
7c5448c1: folds
Uncalled bet (24,431) returned to 8c9120dd
8c9120dd: shows [Jh]
*** SHOWDOWN ***
8c9120dd collected 6,240 from pot
*** SUMMARY ***
Total pot 6,240 | Rake 0 | Jackpot 0 | Bingo 0 | Fortune 0 | Tax 0
Seat 1: Hero folded before Flop
Seat 2: de851319 folded before Flop
Seat 3: 26bfd0ac (button) folded before Flop
Seat 4: 7c5448c1 (small blind) folded before Flop
Seat 5: 8c9120dd (big blind) showed [Jh] and collected (6,240)
Seat 6: cd7e1bca folded before Flop
Seat 7: 6b116d4c folded before Flop
Seat 8: 207e2b94 folded before Flop


Poker Hand #TM3547542538: Tournament #156323098, Bounty Hunters $1.08 Hold'em No Limit - Level14(600/1,200) - 2024/08/04 00:16:15
Table '12' 8-max Seat #2 is the button
Seat 1: Hero (27,994 in chips)
Seat 2: de851319 (60,852 in chips)
Seat 3: 26bfd0ac (16,634 in chips)
Seat 4: 7c5448c1 (81,810 in chips)
Seat 5: 8c9120dd (35,691 in chips)
Seat 6: cd7e1bca (97,860 in chips)
Seat 7: 6b116d4c (52,651 in chips)
Seat 8: 207e2b94 (75,699 in chips)
207e2b94: posts the ante 180
cd7e1bca: posts the ante 180
26bfd0ac: posts the ante 180
7c5448c1: posts the ante 180
6b116d4c: posts the ante 180
de851319: posts the ante 180
8c9120dd: posts the ante 180
Hero: posts the ante 180
26bfd0ac: posts small blind 600
7c5448c1: posts big blind 1,200
*** HOLE CARDS ***
Dealt to Hero [5c 2s]
Dealt to de851319 
Dealt to 26bfd0ac 
Dealt to 7c5448c1 
Dealt to 8c9120dd 
Dealt to cd7e1bca 
Dealt to 6b116d4c 
Dealt to 207e2b94 
8c9120dd: raises 1,200 to 2,400
cd7e1bca: folds
6b116d4c: folds
207e2b94: calls 2,400
Hero: folds
de851319: folds
26bfd0ac: folds
7c5448c1: calls 1,200
*** FLOP *** [6c Tc Kh]
7c5448c1: bets 3,050
8c9120dd: raises 3,050 to 6,100
207e2b94: raises 12,245 to 18,345
7c5448c1: folds
8c9120dd: folds
Uncalled bet (12,245) returned to 207e2b94
8c9120dd: shows [Qc]
*** SHOWDOWN ***
207e2b94 collected 24,490 from pot
*** SUMMARY ***
Total pot 24,490 | Rake 0 | Jackpot 0 | Bingo 0 | Fortune 0 | Tax 0
Board [6c Tc Kh]
Seat 1: Hero folded before Flop
Seat 2: de851319 (button) folded before Flop
Seat 3: 26bfd0ac (small blind) folded before Flop
Seat 4: 7c5448c1 (big blind) folded on the Flop
Seat 5: 8c9120dd folded on the Flop
Seat 6: cd7e1bca folded before Flop
Seat 7: 6b116d4c folded before Flop
Seat 8: 207e2b94 won (24,490)


Poker Hand #TM3547542491: Tournament #156323098, Bounty Hunters $1.08 Hold'em No Limit - Level14(600/1,200) - 2024/08/04 00:15:17
Table '12' 8-max Seat #1 is the button
Seat 1: Hero (28,174 in chips)
Seat 2: de851319 (63,672 in chips)
Seat 3: 26bfd0ac (18,014 in chips)
Seat 4: 7c5448c1 (81,990 in chips)
Seat 5: 8c9120dd (35,871 in chips)
Seat 6: cd7e1bca (98,040 in chips)
Seat 7: 6b116d4c (47,551 in chips)
Seat 8: 207e2b94 (75,879 in chips)
207e2b94: posts the ante 180
cd7e1bca: posts the ante 180
26bfd0ac: posts the ante 180
7c5448c1: posts the ante 180
6b116d4c: posts the ante 180
de851319: posts the ante 180
8c9120dd: posts the ante 180
Hero: posts the ante 180
de851319: posts small blind 600
26bfd0ac: posts big blind 1,200
*** HOLE CARDS ***
Dealt to Hero [9d Qs]
Dealt to de851319 
Dealt to 26bfd0ac 
Dealt to 7c5448c1 
Dealt to 8c9120dd 
Dealt to cd7e1bca 
Dealt to 6b116d4c 
Dealt to 207e2b94 
7c5448c1: folds
8c9120dd: folds
cd7e1bca: folds
6b116d4c: raises 1,440 to 2,640
207e2b94: folds
Hero: folds
de851319: calls 2,040
26bfd0ac: folds
*** FLOP *** [5d Th 8c]
de851319: checks
6b116d4c: checks
*** TURN *** [5d Th 8c] [Qh]
de851319: checks
6b116d4c: checks
*** RIVER *** [5d Th 8c Qh] [Jd]
de851319: checks
6b116d4c: bets 5,280
de851319: folds
Uncalled bet (5,280) returned to 6b116d4c
Hero: shows [9d] (Queens-High Straight)
*** SHOWDOWN ***
6b116d4c collected 7,920 from pot
*** SUMMARY ***
Total pot 7,920 | Rake 0 | Jackpot 0 | Bingo 0 | Fortune 0 | Tax 0
Board [5d Th 8c Qh Jd]
Seat 1: Hero (button) folded before Flop
Seat 2: de851319 (small blind) folded on the River
Seat 3: 26bfd0ac (big blind) folded before Flop
Seat 4: 7c5448c1 folded before Flop
Seat 5: 8c9120dd folded before Flop
Seat 6: cd7e1bca folded before Flop
Seat 7: 6b116d4c won (7,920)
Seat 8: 207e2b94 folded before Flop


Poker Hand #TM3547542449: Tournament #156323098, Bounty Hunters $1.08 Hold'em No Limit - Level14(600/1,200) - 2024/08/04 00:14:32
Table '12' 8-max Seat #8 is the button
Seat 1: Hero (28,954 in chips)
Seat 2: de851319 (65,052 in chips)
Seat 3: 26bfd0ac (18,194 in chips)
Seat 4: 7c5448c1 (39,555 in chips)
Seat 5: 8c9120dd (75,426 in chips)
Seat 6: cd7e1bca (98,220 in chips)
Seat 7: 6b116d4c (47,731 in chips)
Seat 8: 207e2b94 (76,059 in chips)
207e2b94: posts the ante 180
cd7e1bca: posts the ante 180
26bfd0ac: posts the ante 180
7c5448c1: posts the ante 180
6b116d4c: posts the ante 180
de851319: posts the ante 180
8c9120dd: posts the ante 180
Hero: posts the ante 180
Hero: posts small blind 600
de851319: posts big blind 1,200
*** HOLE CARDS ***
Dealt to Hero [8c Kc]
Dealt to de851319 
Dealt to 26bfd0ac 
Dealt to 7c5448c1 
Dealt to 8c9120dd 
Dealt to cd7e1bca 
Dealt to 6b116d4c 
Dealt to 207e2b94 
26bfd0ac: folds
7c5448c1: raises 2,400 to 3,600
8c9120dd: raises 71,646 to 75,246 and is all-in
cd7e1bca: folds
6b116d4c: folds
207e2b94: folds
Hero: folds
de851319: folds
7c5448c1: calls 35,775 and is all-in
Uncalled bet (35,871) returned to 8c9120dd
8c9120dd: shows [Ac Qh]
7c5448c1: shows [Qc Qd]
*** FLOP *** [8s Kh Ad]
*** TURN *** [8s Kh Ad] [6d]
*** RIVER *** [8s Kh Ad 6d] [Qs]
Hero: shows [8c Kc] (Pair of Kings and Pair of Eights)
*** SHOWDOWN ***
7c5448c1 collected 81,990 from pot
*** SUMMARY ***
Total pot 81,990 | Rake 0 | Jackpot 0 | Bingo 0 | Fortune 0 | Tax 0
Board [8s Kh Ad 6d Qs]
Seat 1: Hero (small blind) folded before Flop
Seat 2: de851319 (big blind) folded before Flop
Seat 3: 26bfd0ac folded before Flop
Seat 4: 7c5448c1 showed [Qc Qd] and won (81,990) with Three Queens
Seat 5: 8c9120dd showed [Ac Qh] and lost with Pair of Aces and Pair of Queens
Seat 6: cd7e1bca folded before Flop
Seat 7: 6b116d4c folded before Flop
Seat 8: 207e2b94 (button) folded before Flop


Poker Hand #TM3547542417: Tournament #156323098, Bounty Hunters $1.08 Hold'em No Limit - Level14(600/1,200) - 2024/08/04 00:13:56
Table '12' 8-max Seat #7 is the button
Seat 1: Hero (31,534 in chips)
Seat 2: de851319 (67,632 in chips)
Seat 3: 26bfd0ac (18,374 in chips)
Seat 4: 7c5448c1 (39,735 in chips)
Seat 5: 8c9120dd (78,006 in chips)
Seat 6: cd7e1bca (98,400 in chips)
Seat 7: 6b116d4c (47,911 in chips)
Seat 8: 207e2b94 (67,599 in chips)
207e2b94: posts the ante 180
cd7e1bca: posts the ante 180
26bfd0ac: posts the ante 180
7c5448c1: posts the ante 180
6b116d4c: posts the ante 180
de851319: posts the ante 180
8c9120dd: posts the ante 180
Hero: posts the ante 180
207e2b94: posts small blind 600
Hero: posts big blind 1,200
*** HOLE CARDS ***
Dealt to Hero [6d 2s]
Dealt to de851319 
Dealt to 26bfd0ac 
Dealt to 7c5448c1 
Dealt to 8c9120dd 
Dealt to cd7e1bca 
Dealt to 6b116d4c 
Dealt to 207e2b94 
de851319: raises 1,200 to 2,400
26bfd0ac: folds
7c5448c1: folds
8c9120dd: calls 2,400
cd7e1bca: folds
6b116d4c: folds
207e2b94: calls 1,800
Hero: calls 1,200
*** FLOP *** [7h Ac 2c]
207e2b94: checks
Hero: checks
de851319: checks
8c9120dd: checks
*** TURN *** [7h Ac 2c] [5c]
207e2b94: bets 8,280
Hero: folds
de851319: folds
8c9120dd: folds
Uncalled bet (8,280) returned to 207e2b94
*** SHOWDOWN ***
207e2b94 collected 11,040 from pot
*** SUMMARY ***
Total pot 11,040 | Rake 0 | Jackpot 0 | Bingo 0 | Fortune 0 | Tax 0
Board [7h Ac 2c 5c]
Seat 1: Hero (big blind) folded on the Turn
Seat 2: de851319 folded on the Turn
Seat 3: 26bfd0ac folded before Flop
Seat 4: 7c5448c1 folded before Flop
Seat 5: 8c9120dd folded on the Turn
Seat 6: cd7e1bca folded before Flop
Seat 7: 6b116d4c (button) folded before Flop
Seat 8: 207e2b94 (small blind) won (11,040)


Poker Hand #TM3547356799: Tournament #156323098, Bounty Hunters $1.08 Hold'em No Limit - Level13(500/1,000) - 2024/08/04 00:11:56
Table '31' 8-max Seat #1 is the button
Seat 1: ae4352d9 (8,535 in chips)
Seat 2: 13905b7c (9,765 in chips)
Seat 3: 692d5f90 (38,812 in chips)
Seat 4: Hero (31,684 in chips)
Seat 5: aa9a7b65 (41,850 in chips)
Seat 6: c7ea0f13 (19,420 in chips)
Seat 7: 21b67870 (16,300 in chips)
Seat 8: 67c11e53 (64,652 in chips)
67c11e53: posts the ante 150
692d5f90: posts the ante 150
c7ea0f13: posts the ante 150
21b67870: posts the ante 150
aa9a7b65: posts the ante 150
ae4352d9: posts the ante 150
Hero: posts the ante 150
13905b7c: posts the ante 150
13905b7c: posts small blind 500
692d5f90: posts big blind 1,000
*** HOLE CARDS ***
Dealt to ae4352d9 
Dealt to 13905b7c 
Dealt to 692d5f90 
Dealt to Hero [6h 8c]
Dealt to aa9a7b65 
Dealt to c7ea0f13 
Dealt to 21b67870 
Dealt to 67c11e53 
Hero: folds
aa9a7b65: raises 1,500 to 2,500
c7ea0f13: folds
21b67870: folds
67c11e53: calls 2,500
ae4352d9: raises 5,885 to 8,385 and is all-in
13905b7c: raises 1,230 to 9,615 and is all-in
692d5f90: folds
aa9a7b65: raises 32,085 to 41,700 and is all-in
67c11e53: folds
Uncalled bet (32,085) returned to aa9a7b65
aa9a7b65: shows [As Qc]
ae4352d9: shows [Qs Ac]
13905b7c: shows [7h 2d]
*** FLOP *** [6c 4d Ah]
*** TURN *** [6c 4d Ah] [4c]
*** RIVER *** [6c 4d Ah 4c] [8d]
Hero: shows [6h 8c] (Pair of Eights and Pair of Sixes)
*** SHOWDOWN ***
aa9a7b65 collected 14,928 from pot
ae4352d9 collected 14,927 from pot
aa9a7b65 collected 2,460 from pot
*** SUMMARY ***
Total pot 32,315 | Rake 0 | Jackpot 0 | Bingo 0 | Fortune 0 | Tax 0
Board [6c 4d Ah 4c 8d]
Seat 1: ae4352d9 (button) showed [Qs Ac] and won (14,927) with Pair of Aces and Pair of Fours
Seat 2: 13905b7c (small blind) showed [7h 2d] and lost with Pair of Fours
Seat 3: 692d5f90 (big blind) folded before Flop
Seat 4: Hero folded before Flop
Seat 5: aa9a7b65 showed [As Qc] and won (17,388) with Pair of Aces and Pair of Fours
Seat 6: c7ea0f13 folded before Flop
Seat 7: 21b67870 folded before Flop
Seat 8: 67c11e53 folded before Flop


Poker Hand #TM3547356761: Tournament #156323098, Bounty Hunters $1.08 Hold'em No Limit - Level13(500/1,000) - 2024/08/04 00:11:07
Table '31' 8-max Seat #8 is the button
Seat 1: ae4352d9 (9,185 in chips)
Seat 2: 13905b7c (17,215 in chips)
Seat 3: 692d5f90 (38,962 in chips)
Seat 4: Hero (31,834 in chips)
Seat 5: aa9a7b65 (42,000 in chips)
Seat 6: c7ea0f13 (19,570 in chips)
Seat 7: 21b67870 (7,450 in chips)
Seat 8: 67c11e53 (64,802 in chips)
67c11e53: posts the ante 150
692d5f90: posts the ante 150
c7ea0f13: posts the ante 150
21b67870: posts the ante 150
aa9a7b65: posts the ante 150
ae4352d9: posts the ante 150
Hero: posts the ante 150
13905b7c: posts the ante 150
ae4352d9: posts small blind 500
13905b7c: posts big blind 1,000
*** HOLE CARDS ***
Dealt to ae4352d9 
Dealt to 13905b7c 
Dealt to 692d5f90 
Dealt to Hero [6d 7d]
Dealt to aa9a7b65 
Dealt to c7ea0f13 
Dealt to 21b67870 
Dealt to 67c11e53 
692d5f90: folds
Hero: folds
aa9a7b65: folds
c7ea0f13: folds
21b67870: raises 6,300 to 7,300 and is all-in
67c11e53: folds
ae4352d9: folds
13905b7c: calls 6,300
21b67870: shows [As Jh]
13905b7c: shows [9d Td]
*** FLOP *** [Th Ac 6c]
*** TURN *** [Th Ac 6c] [Ah]
*** RIVER *** [Th Ac 6c Ah] [3d]
Hero: shows [6d 7d] (Pair of Aces and Pair of Sixes)
*** SHOWDOWN ***
21b67870 collected 16,300 from pot
*** SUMMARY ***
Total pot 16,300 | Rake 0 | Jackpot 0 | Bingo 0 | Fortune 0 | Tax 0
Board [Th Ac 6c Ah 3d]
Seat 1: ae4352d9 (small blind) folded before Flop
Seat 2: 13905b7c (big blind) showed [9d Td] and lost with Pair of Aces and Pair of Tens
Seat 3: 692d5f90 folded before Flop
Seat 4: Hero folded before Flop
Seat 5: aa9a7b65 folded before Flop
Seat 6: c7ea0f13 folded before Flop
Seat 7: 21b67870 showed [As Jh] and won (16,300) with Three Aces
Seat 8: 67c11e53 (button) folded before Flop


Poker Hand #TM3547356692: Tournament #156323098, Bounty Hunters $1.08 Hold'em No Limit - Level13(500/1,000) - 2024/08/04 00:09:39
Table '31' 8-max Seat #7 is the button
Seat 1: ae4352d9 (10,335 in chips)
Seat 2: 13905b7c (17,365 in chips)
Seat 3: 692d5f90 (39,112 in chips)
Seat 4: Hero (31,984 in chips)
Seat 5: aa9a7b65 (42,150 in chips)
Seat 6: c7ea0f13 (19,720 in chips)
Seat 7: 21b67870 (7,600 in chips)
Seat 8: 67c11e53 (62,752 in chips)
692d5f90: posts the ante 150
67c11e53: posts the ante 150
c7ea0f13: posts the ante 150
21b67870: posts the ante 150
aa9a7b65: posts the ante 150
ae4352d9: posts the ante 150
Hero: posts the ante 150
13905b7c: posts the ante 150
67c11e53: posts small blind 500
ae4352d9: posts big blind 1,000
*** HOLE CARDS ***
Dealt to ae4352d9 
Dealt to 13905b7c 
Dealt to 692d5f90 
Dealt to Hero [5d Jd]
Dealt to aa9a7b65 
Dealt to c7ea0f13 
Dealt to 21b67870 
Dealt to 67c11e53 
13905b7c: folds
692d5f90: folds
Hero: folds
aa9a7b65: folds
c7ea0f13: folds
21b67870: folds
67c11e53: calls 500
ae4352d9: checks
*** FLOP *** [Ks 2s Th]
67c11e53: checks
ae4352d9: checks
*** TURN *** [Ks 2s Th] [Ac]
67c11e53: checks
ae4352d9: checks
*** RIVER *** [Ks 2s Th Ac] [8h]
67c11e53: checks
ae4352d9: checks
67c11e53: shows [9d 8d] (Pair of Eights)
ae4352d9: shows [Jc 2h] (Pair of Twos)
*** SHOWDOWN ***
67c11e53 collected 3,200 from pot
*** SUMMARY ***
Total pot 3,200 | Rake 0 | Jackpot 0 | Bingo 0 | Fortune 0 | Tax 0
Board [Ks 2s Th Ac 8h]
Seat 1: ae4352d9 (big blind) showed [Jc 2h] and lost with Pair of Twos
Seat 2: 13905b7c folded before Flop
Seat 3: 692d5f90 folded before Flop
Seat 4: Hero folded before Flop
Seat 5: aa9a7b65 folded before Flop
Seat 6: c7ea0f13 folded before Flop
Seat 7: 21b67870 (button) folded before Flop
Seat 8: 67c11e53 (small blind) showed [9d 8d] and won (3,200) with Pair of Eights


Poker Hand #TM3547356627: Tournament #156323098, Bounty Hunters $1.08 Hold'em No Limit - Level13(500/1,000) - 2024/08/04 00:08:30
Table '31' 8-max Seat #6 is the button
Seat 1: ae4352d9 (10,485 in chips)
Seat 2: 13905b7c (17,515 in chips)
Seat 3: 692d5f90 (39,262 in chips)
Seat 4: Hero (32,134 in chips)
Seat 5: aa9a7b65 (47,150 in chips)
Seat 6: c7ea0f13 (19,870 in chips)
Seat 7: 21b67870 (8,250 in chips)
Seat 8: 67c11e53 (56,352 in chips)
692d5f90: posts the ante 150
67c11e53: posts the ante 150
c7ea0f13: posts the ante 150
aa9a7b65: posts the ante 150
21b67870: posts the ante 150
ae4352d9: posts the ante 150
Hero: posts the ante 150
13905b7c: posts the ante 150
21b67870: posts small blind 500
67c11e53: posts big blind 1,000
*** HOLE CARDS ***
Dealt to ae4352d9 
Dealt to 13905b7c 
Dealt to 692d5f90 
Dealt to Hero [3d Jc]
Dealt to aa9a7b65 
Dealt to c7ea0f13 
Dealt to 21b67870 
Dealt to 67c11e53 
ae4352d9: folds
13905b7c: folds
692d5f90: folds
Hero: folds
aa9a7b65: raises 1,000 to 2,000
c7ea0f13: folds
21b67870: folds
67c11e53: calls 1,000
*** FLOP *** [Ks 7s 5c]
67c11e53: checks
aa9a7b65: checks
*** TURN *** [Ks 7s 5c] [Kc]
67c11e53: checks
aa9a7b65: bets 2,850
67c11e53: calls 2,850
*** RIVER *** [Ks 7s 5c Kc] [Ac]
67c11e53: checks
aa9a7b65: checks
67c11e53: shows [7h Qd] (Pair of Kings and Pair of Sevens)
aa9a7b65: shows [6h 5h] (Pair of Kings and Pair of Fives)
*** SHOWDOWN ***
67c11e53 collected 11,400 from pot
*** SUMMARY ***
Total pot 11,400 | Rake 0 | Jackpot 0 | Bingo 0 | Fortune 0 | Tax 0
Board [Ks 7s 5c Kc Ac]
Seat 1: ae4352d9 folded before Flop
Seat 2: 13905b7c folded before Flop
Seat 3: 692d5f90 folded before Flop
Seat 4: Hero folded before Flop
Seat 5: aa9a7b65 showed [6h 5h] and lost with Pair of Kings and Pair of Fives
Seat 6: c7ea0f13 (button) folded before Flop
Seat 7: 21b67870 (small blind) folded before Flop
Seat 8: 67c11e53 (big blind) showed [7h Qd] and won (11,400) with Pair of Kings and Pair of Sevens


Poker Hand #TM3547356565: Tournament #156323098, Bounty Hunters $1.08 Hold'em No Limit - Level13(500/1,000) - 2024/08/04 00:07:16
Table '31' 8-max Seat #5 is the button
Seat 1: ae4352d9 (1,707 in chips)
Seat 2: 13905b7c (19,222 in chips)
Seat 3: 692d5f90 (40,969 in chips)
Seat 4: Hero (33,841 in chips)
Seat 5: aa9a7b65 (48,857 in chips)
Seat 6: c7ea0f13 (20,520 in chips)
Seat 7: 21b67870 (9,400 in chips)
Seat 8: 67c11e53 (56,502 in chips)
692d5f90: posts the ante 150
67c11e53: posts the ante 150
c7ea0f13: posts the ante 150
aa9a7b65: posts the ante 150
21b67870: posts the ante 150
ae4352d9: posts the ante 150
Hero: posts the ante 150
13905b7c: posts the ante 150
c7ea0f13: posts small blind 500
21b67870: posts big blind 1,000
*** HOLE CARDS ***
Dealt to ae4352d9 
Dealt to 13905b7c 
Dealt to 692d5f90 
Dealt to Hero [6h Js]
Dealt to aa9a7b65 
Dealt to c7ea0f13 
Dealt to 21b67870 
Dealt to 67c11e53 
67c11e53: folds
ae4352d9: raises 557 to 1,557 and is all-in
13905b7c: calls 1,557
692d5f90: calls 1,557
Hero: calls 1,557
aa9a7b65: raises 44,443 to 46,000
c7ea0f13: folds
21b67870: folds
13905b7c: folds
692d5f90: folds
Hero: folds
Uncalled bet (44,443) returned to aa9a7b65
aa9a7b65: shows [Kc 8h]
ae4352d9: shows [9d Qc]
*** FLOP *** [Tc 8s As]
*** TURN *** [Tc 8s As] [Qh]
*** RIVER *** [Tc 8s As Qh] [4c]
*** SHOWDOWN ***
ae4352d9 collected 10,485 from pot
*** SUMMARY ***
Total pot 10,485 | Rake 0 | Jackpot 0 | Bingo 0 | Fortune 0 | Tax 0
Board [Tc 8s As Qh 4c]
Seat 1: ae4352d9 showed [9d Qc] and won (10,485) with Pair of Queens
Seat 2: 13905b7c folded before Flop
Seat 3: 692d5f90 folded before Flop
Seat 4: Hero folded before Flop
Seat 5: aa9a7b65 (button) showed [Kc 8h] and lost with Pair of Eights
Seat 6: c7ea0f13 (small blind) folded before Flop
Seat 7: 21b67870 (big blind) folded before Flop
Seat 8: 67c11e53 folded before Flop


Poker Hand #TM3547356490: Tournament #156323098, Bounty Hunters $1.08 Hold'em No Limit - Level12(400/800) - 2024/08/04 00:05:56
Table '31' 8-max Seat #4 is the button
Seat 1: ae4352d9 (1,827 in chips)
Seat 2: 13905b7c (19,342 in chips)
Seat 3: 692d5f90 (41,089 in chips)
Seat 4: Hero (34,761 in chips)
Seat 5: aa9a7b65 (49,377 in chips)
Seat 6: c7ea0f13 (21,440 in chips)
Seat 7: 21b67870 (9,520 in chips)
Seat 8: 67c11e53 (53,662 in chips)
692d5f90: posts the ante 120
67c11e53: posts the ante 120
c7ea0f13: posts the ante 120
21b67870: posts the ante 120
aa9a7b65: posts the ante 120
ae4352d9: posts the ante 120
Hero: posts the ante 120
13905b7c: posts the ante 120
aa9a7b65: posts small blind 400
c7ea0f13: posts big blind 800
*** HOLE CARDS ***
Dealt to ae4352d9 
Dealt to 13905b7c 
Dealt to 692d5f90 
Dealt to Hero [5s Qs]
Dealt to aa9a7b65 
Dealt to c7ea0f13 
Dealt to 21b67870 
Dealt to 67c11e53 
21b67870: folds
67c11e53: calls 800
ae4352d9: folds
13905b7c: folds
692d5f90: folds
Hero: calls 800
aa9a7b65: folds
c7ea0f13: checks
*** FLOP *** [8c Kh 4h]
c7ea0f13: checks
67c11e53: checks
Hero: checks
*** TURN *** [8c Kh 4h] [Js]
c7ea0f13: checks
67c11e53: checks
Hero: checks
*** RIVER *** [8c Kh 4h Js] [9d]
c7ea0f13: checks
67c11e53: checks
Hero: checks
c7ea0f13: shows [3s Ad] (Ace-High)
67c11e53: shows [9s Th] (Pair of Nines)
Hero: shows [5s Qs] (King-High)
*** SHOWDOWN ***
67c11e53 collected 3,760 from pot
*** SUMMARY ***
Total pot 3,760 | Rake 0 | Jackpot 0 | Bingo 0 | Fortune 0 | Tax 0
Board [8c Kh 4h Js 9d]
Seat 1: ae4352d9 folded before Flop
Seat 2: 13905b7c folded before Flop
Seat 3: 692d5f90 folded before Flop
Seat 4: Hero (button) showed [5s Qs] and lost with King-High
Seat 5: aa9a7b65 (small blind) folded before Flop
Seat 6: c7ea0f13 (big blind) showed [3s Ad] and lost with Ace-High
Seat 7: 21b67870 folded before Flop
Seat 8: 67c11e53 showed [9s Th] and won (3,760) with Pair of Nines


Poker Hand #TM3547356451: Tournament #156323098, Bounty Hunters $1.08 Hold'em No Limit - Level12(400/800) - 2024/08/04 00:05:15
Table '31' 8-max Seat #3 is the button
Seat 1: ae4352d9 (1,947 in chips)
Seat 2: 13905b7c (19,462 in chips)
Seat 3: 692d5f90 (41,209 in chips)
Seat 4: Hero (33,121 in chips)
Seat 5: aa9a7b65 (50,297 in chips)
Seat 6: c7ea0f13 (21,560 in chips)
Seat 7: 21b67870 (9,640 in chips)
Seat 8: 67c11e53 (53,782 in chips)
692d5f90: posts the ante 120
67c11e53: posts the ante 120
c7ea0f13: posts the ante 120
21b67870: posts the ante 120
aa9a7b65: posts the ante 120
ae4352d9: posts the ante 120
13905b7c: posts the ante 120
Hero: posts the ante 120
Hero: posts small blind 400
aa9a7b65: posts big blind 800
*** HOLE CARDS ***
Dealt to ae4352d9 
Dealt to 13905b7c 
Dealt to 692d5f90 
Dealt to Hero [Jc Kc]
Dealt to aa9a7b65 
Dealt to c7ea0f13 
Dealt to 21b67870 
Dealt to 67c11e53 
c7ea0f13: folds
21b67870: folds
67c11e53: folds
ae4352d9: folds
13905b7c: folds
692d5f90: folds
Hero: raises 1,600 to 2,400
aa9a7b65: folds
Uncalled bet (1,600) returned to Hero
Hero: shows [Jc Kc]
*** SHOWDOWN ***
Hero collected 2,560 from pot
*** SUMMARY ***
Total pot 2,560 | Rake 0 | Jackpot 0 | Bingo 0 | Fortune 0 | Tax 0
Seat 1: ae4352d9 folded before Flop
Seat 2: 13905b7c folded before Flop
Seat 3: 692d5f90 (button) folded before Flop
Seat 4: Hero (small blind) showed [Jc Kc] and collected (2,560)
Seat 5: aa9a7b65 (big blind) folded before Flop
Seat 6: c7ea0f13 folded before Flop
Seat 7: 21b67870 folded before Flop
Seat 8: 67c11e53 folded before Flop


Poker Hand #TM3547356402: Tournament #156323098, Bounty Hunters $1.08 Hold'em No Limit - Level12(400/800) - 2024/08/04 00:04:21
Table '31' 8-max Seat #2 is the button
Seat 1: ae4352d9 (2,067 in chips)
Seat 2: 13905b7c (17,422 in chips)
Seat 3: 692d5f90 (41,729 in chips)
Seat 4: Hero (34,041 in chips)
Seat 5: aa9a7b65 (50,417 in chips)
Seat 6: c7ea0f13 (21,680 in chips)
Seat 7: 21b67870 (9,760 in chips)
Seat 8: 67c11e53 (53,902 in chips)
67c11e53: posts the ante 120
692d5f90: posts the ante 120
c7ea0f13: posts the ante 120
21b67870: posts the ante 120
aa9a7b65: posts the ante 120
ae4352d9: posts the ante 120
13905b7c: posts the ante 120
Hero: posts the ante 120
692d5f90: posts small blind 400
Hero: posts big blind 800
*** HOLE CARDS ***
Dealt to ae4352d9 
Dealt to 13905b7c 
Dealt to 692d5f90 
Dealt to Hero [8s 2d]
Dealt to aa9a7b65 
Dealt to c7ea0f13 
Dealt to 21b67870 
Dealt to 67c11e53 
aa9a7b65: folds
c7ea0f13: folds
21b67870: folds
67c11e53: folds
ae4352d9: folds
13905b7c: calls 800
692d5f90: folds
Hero: checks
*** FLOP *** [5d 4h Td]
Hero: checks
13905b7c: bets 800
Hero: folds
Uncalled bet (800) returned to 13905b7c
Hero: shows [8s 2d] (Ten-High)
*** SHOWDOWN ***
13905b7c collected 2,960 from pot
*** SUMMARY ***
Total pot 2,960 | Rake 0 | Jackpot 0 | Bingo 0 | Fortune 0 | Tax 0
Board [5d 4h Td]
Seat 1: ae4352d9 folded before Flop
Seat 2: 13905b7c (button) won (2,960)
Seat 3: 692d5f90 (small blind) folded before Flop
Seat 4: Hero (big blind) folded on the Flop
Seat 5: aa9a7b65 folded before Flop
Seat 6: c7ea0f13 folded before Flop
Seat 7: 21b67870 folded before Flop
Seat 8: 67c11e53 folded before Flop


Poker Hand #TM3547356351: Tournament #156323098, Bounty Hunters $1.08 Hold'em No Limit - Level12(400/800) - 2024/08/04 00:03:28
Table '31' 8-max Seat #1 is the button
Seat 1: ae4352d9 (2,187 in chips)
Seat 2: 13905b7c (17,942 in chips)
Seat 3: 692d5f90 (42,649 in chips)
Seat 4: Hero (43,921 in chips)
Seat 5: aa9a7b65 (50,537 in chips)
Seat 6: c7ea0f13 (9,880 in chips)
Seat 7: 21b67870 (9,880 in chips)
Seat 8: 67c11e53 (54,022 in chips)
67c11e53: posts the ante 120
692d5f90: posts the ante 120
c7ea0f13: posts the ante 120
21b67870: posts the ante 120
aa9a7b65: posts the ante 120
ae4352d9: posts the ante 120
Hero: posts the ante 120
13905b7c: posts the ante 120
13905b7c: posts small blind 400
692d5f90: posts big blind 800
*** HOLE CARDS ***
Dealt to ae4352d9 
Dealt to 13905b7c 
Dealt to 692d5f90 
Dealt to Hero [5s 5d]
Dealt to aa9a7b65 
Dealt to c7ea0f13 
Dealt to 21b67870 
Dealt to 67c11e53 
Hero: raises 800 to 1,600
aa9a7b65: folds
c7ea0f13: raises 8,160 to 9,760 and is all-in
21b67870: folds
67c11e53: folds
ae4352d9: folds
13905b7c: folds
692d5f90: folds
Hero: calls 8,160
c7ea0f13: shows [Th Ts]
Hero: shows [5s 5d]
*** FLOP *** [7h 5h Tc]
*** TURN *** [7h 5h Tc] [9c]
*** RIVER *** [7h 5h Tc 9c] [9s]
*** SHOWDOWN ***
c7ea0f13 collected 21,680 from pot
*** SUMMARY ***
Total pot 21,680 | Rake 0 | Jackpot 0 | Bingo 0 | Fortune 0 | Tax 0
Board [7h 5h Tc 9c 9s]
Seat 1: ae4352d9 (button) folded before Flop
Seat 2: 13905b7c (small blind) folded before Flop
Seat 3: 692d5f90 (big blind) folded before Flop
Seat 4: Hero showed [5s 5d] and lost with Fives Full over Nines
Seat 5: aa9a7b65 folded before Flop
Seat 6: c7ea0f13 showed [Th Ts] and won (21,680) with Tens Full over Nines
Seat 7: 21b67870 folded before Flop
Seat 8: 67c11e53 folded before Flop


Poker Hand #TM3547356287: Tournament #156323098, Bounty Hunters $1.08 Hold'em No Limit - Level12(400/800) - 2024/08/04 00:01:37
Table '31' 8-max Seat #8 is the button
Seat 1: ae4352d9 (10,398 in chips)
Seat 2: 13905b7c (8,211 in chips)
Seat 3: 692d5f90 (42,769 in chips)
Seat 4: Hero (44,041 in chips)
Seat 5: aa9a7b65 (50,657 in chips)
Seat 6: c7ea0f13 (10,000 in chips)
Seat 7: 21b67870 (10,000 in chips)
Seat 8: 67c11e53 (54,942 in chips)
67c11e53: posts the ante 120
692d5f90: posts the ante 120
c7ea0f13: posts the ante 120
21b67870: posts the ante 120
aa9a7b65: posts the ante 120
ae4352d9: posts the ante 120
Hero: posts the ante 120
13905b7c: posts the ante 120
ae4352d9: posts small blind 400
13905b7c: posts big blind 800
*** HOLE CARDS ***
Dealt to ae4352d9 
Dealt to 13905b7c 
Dealt to 692d5f90 
Dealt to Hero [Ac 7d]
Dealt to aa9a7b65 
Dealt to c7ea0f13 
Dealt to 21b67870 
Dealt to 67c11e53 
692d5f90: folds
Hero: folds
aa9a7b65: folds
c7ea0f13: folds
21b67870: folds
67c11e53: calls 800
ae4352d9: calls 400
13905b7c: checks
*** FLOP *** [8c Ah 5c]
ae4352d9: checks
13905b7c: bets 2,218
67c11e53: folds
ae4352d9: calls 2,218
*** TURN *** [8c Ah 5c] [2d]
ae4352d9: checks
13905b7c: checks
*** RIVER *** [8c Ah 5c 2d] [8d]
ae4352d9: bets 7,260 and is all-in
13905b7c: calls 5,073 and is all-in
Uncalled bet (2,187) returned to ae4352d9
ae4352d9: shows [6c Tc] (Pair of Eights)
13905b7c: shows [8h 3c] (Three Eights)
*** SHOWDOWN ***
13905b7c collected 17,942 from pot
*** SUMMARY ***
Total pot 17,942 | Rake 0 | Jackpot 0 | Bingo 0 | Fortune 0 | Tax 0
Board [8c Ah 5c 2d 8d]
Seat 1: ae4352d9 (small blind) showed [6c Tc] and lost with Pair of Eights
Seat 2: 13905b7c (big blind) showed [8h 3c] and won (17,942) with Three Eights
Seat 3: 692d5f90 folded before Flop
Seat 4: Hero folded before Flop
Seat 5: aa9a7b65 folded before Flop
Seat 6: c7ea0f13 folded before Flop
Seat 7: 21b67870 folded before Flop
Seat 8: 67c11e53 (button) folded on the Flop


Poker Hand #TM3547356152: Tournament #156323098, Bounty Hunters $1.08 Hold'em No Limit - Level11(350/700) - 2024/08/03 23:52:56
Table '31' 8-max Seat #7 is the button
Seat 1: ae4352d9 (16,798 in chips)
Seat 2: 13905b7c (8,311 in chips)
Seat 3: 692d5f90 (42,869 in chips)
Seat 4: Hero (44,141 in chips)
Seat 5: aa9a7b65 (50,757 in chips)
Seat 7: 7966af7 (9,566 in chips)
Seat 8: 67c11e53 (47,342 in chips)
692d5f90: posts the ante 100
67c11e53: posts the ante 100
aa9a7b65: posts the ante 100
ae4352d9: posts the ante 100
7966af7: posts the ante 100
Hero: posts the ante 100
13905b7c: posts the ante 100
67c11e53: posts small blind 350
ae4352d9: posts big blind 700
*** HOLE CARDS ***
Dealt to ae4352d9 
Dealt to 13905b7c 
Dealt to 692d5f90 
Dealt to Hero [Th 5c]
Dealt to aa9a7b65 
Dealt to 7966af7 
Dealt to 67c11e53 
13905b7c: folds
692d5f90: folds
Hero: folds
aa9a7b65: folds
7966af7: calls 700
67c11e53: calls 350
ae4352d9: checks
*** FLOP *** [2s 6s Qd]
67c11e53: checks
ae4352d9: checks
7966af7: checks
*** TURN *** [2s 6s Qd] [5h]
67c11e53: checks
ae4352d9: bets 1,400
7966af7: folds
67c11e53: raises 4,200 to 5,600
ae4352d9: calls 4,200
*** RIVER *** [2s 6s Qd 5h] [2c]
67c11e53: bets 10,500
ae4352d9: folds
Uncalled bet (10,500) returned to 67c11e53
*** SHOWDOWN ***
67c11e53 collected 14,000 from pot
*** SUMMARY ***
Total pot 14,000 | Rake 0 | Jackpot 0 | Bingo 0 | Fortune 0 | Tax 0
Board [2s 6s Qd 5h 2c]
Seat 1: ae4352d9 (big blind) folded on the River
Seat 2: 13905b7c folded before Flop
Seat 3: 692d5f90 folded before Flop
Seat 4: Hero folded before Flop
Seat 5: aa9a7b65 folded before Flop
Seat 7: 7966af7 (button) folded on the Turn
Seat 8: 67c11e53 (small blind) won (14,000)


Poker Hand #TM3547356070: Tournament #156323098, Bounty Hunters $1.08 Hold'em No Limit - Level11(350/700) - 2024/08/03 23:51:15
Table '31' 8-max Seat #6 is the button
Seat 1: ae4352d9 (16,898 in chips)
Seat 2: 13905b7c (8,411 in chips)
Seat 3: 692d5f90 (42,969 in chips)
Seat 4: Hero (44,941 in chips)
Seat 5: aa9a7b65 (37,827 in chips)
Seat 6: 6f5ef1a7 (10,580 in chips)
Seat 7: 7966af7 (10,016 in chips)
Seat 8: 67c11e53 (48,142 in chips)
692d5f90: posts the ante 100
67c11e53: posts the ante 100
6f5ef1a7: posts the ante 100
aa9a7b65: posts the ante 100
ae4352d9: posts the ante 100
Hero: posts the ante 100
13905b7c: posts the ante 100
7966af7: posts the ante 100
7966af7: posts small blind 350
67c11e53: posts big blind 700
*** HOLE CARDS ***
Dealt to ae4352d9 
Dealt to 13905b7c 
Dealt to 692d5f90 
Dealt to Hero [5h 7h]
Dealt to aa9a7b65 
Dealt to 6f5ef1a7 
Dealt to 7966af7 
Dealt to 67c11e53 
ae4352d9: folds
13905b7c: folds
692d5f90: folds
Hero: calls 700
aa9a7b65: raises 3,250 to 3,950
6f5ef1a7: calls 3,950
7966af7: folds
67c11e53: folds
Hero: folds
*** FLOP *** [6h Jh Ah]
aa9a7b65: bets 10,450
6f5ef1a7: calls 6,530 and is all-in
Uncalled bet (3,920) returned to aa9a7b65
aa9a7b65: shows [Ad Jd] (Pair of Aces and Pair of Jacks)
6f5ef1a7: shows [2s 2h] (Pair of Twos)
*** TURN *** [6h Jh Ah] [8d]
*** RIVER *** [6h Jh Ah 8d] [6d]
Hero: shows [5h 7h] (Ace High Flush)
*** SHOWDOWN ***
aa9a7b65 collected 23,510 from pot
*** SUMMARY ***
Total pot 23,510 | Rake 0 | Jackpot 0 | Bingo 0 | Fortune 0 | Tax 0
Board [6h Jh Ah 8d 6d]
Seat 1: ae4352d9 folded before Flop
Seat 2: 13905b7c folded before Flop
Seat 3: 692d5f90 folded before Flop
Seat 4: Hero folded before Flop
Seat 5: aa9a7b65 showed [Ad Jd] and won (23,510) with Pair of Aces and Pair of Jacks
Seat 6: 6f5ef1a7 (button) showed [2s 2h] and lost with Pair of Sixes and Pair of Twos
Seat 7: 7966af7 (small blind) folded before Flop
Seat 8: 67c11e53 (big blind) folded before Flop


Poker Hand #TM3547355959: Tournament #156323098, Bounty Hunters $1.08 Hold'em No Limit - Level11(350/700) - 2024/08/03 23:49:14
Table '31' 8-max Seat #5 is the button
Seat 1: ae4352d9 (16,998 in chips)
Seat 2: 13905b7c (8,511 in chips)
Seat 3: 692d5f90 (32,419 in chips)
Seat 4: Hero (45,741 in chips)
Seat 5: aa9a7b65 (37,927 in chips)
Seat 6: 6f5ef1a7 (17,030 in chips)
Seat 7: 7966af7 (10,816 in chips)
Seat 8: 67c11e53 (50,342 in chips)
692d5f90: posts the ante 100
67c11e53: posts the ante 100
6f5ef1a7: posts the ante 100
aa9a7b65: posts the ante 100
ae4352d9: posts the ante 100
Hero: posts the ante 100
13905b7c: posts the ante 100
7966af7: posts the ante 100
6f5ef1a7: posts small blind 350
7966af7: posts big blind 700
*** HOLE CARDS ***
Dealt to ae4352d9 
Dealt to 13905b7c 
Dealt to 692d5f90 
Dealt to Hero [7s 6h]
Dealt to aa9a7b65 
Dealt to 6f5ef1a7 
Dealt to 7966af7 
Dealt to 67c11e53 
67c11e53: calls 700
ae4352d9: folds
13905b7c: folds
692d5f90: calls 700
Hero: calls 700
aa9a7b65: folds
6f5ef1a7: calls 350
7966af7: checks
*** FLOP *** [2c Th 7h]
6f5ef1a7: checks
7966af7: checks
67c11e53: checks
692d5f90: bets 1,400
Hero: folds
6f5ef1a7: calls 1,400
7966af7: folds
67c11e53: calls 1,400
*** TURN *** [2c Th 7h] [As]
6f5ef1a7: checks
67c11e53: checks
692d5f90: checks
*** RIVER *** [2c Th 7h As] [8h]
6f5ef1a7: checks
67c11e53: checks
692d5f90: bets 4,250
6f5ef1a7: calls 4,250
67c11e53: folds
692d5f90: shows [Kh Qh] (King High Flush)
6f5ef1a7: shows [Ac 9d] (Pair of Aces)
*** SHOWDOWN ***
692d5f90 collected 17,000 from pot
*** SUMMARY ***
Total pot 17,000 | Rake 0 | Jackpot 0 | Bingo 0 | Fortune 0 | Tax 0
Board [2c Th 7h As 8h]
Seat 1: ae4352d9 folded before Flop
Seat 2: 13905b7c folded before Flop
Seat 3: 692d5f90 showed [Kh Qh] and won (17,000) with King High Flush
Seat 4: Hero folded on the Flop
Seat 5: aa9a7b65 (button) folded before Flop
Seat 6: 6f5ef1a7 (small blind) showed [Ac 9d] and lost with Pair of Aces
Seat 7: 7966af7 (big blind) folded on the Flop
Seat 8: 67c11e53 folded on the River


Poker Hand #TM3547355940: Tournament #156323098, Bounty Hunters $1.08 Hold'em No Limit - Level11(350/700) - 2024/08/03 23:48:53
Table '31' 8-max Seat #4 is the button
Seat 1: ae4352d9 (17,098 in chips)
Seat 2: 13905b7c (8,611 in chips)
Seat 3: 692d5f90 (32,519 in chips)
Seat 4: Hero (45,841 in chips)
Seat 5: aa9a7b65 (38,377 in chips)
Seat 6: 6f5ef1a7 (15,980 in chips)
Seat 7: 7966af7 (10,916 in chips)
Seat 8: 67c11e53 (50,442 in chips)
692d5f90: posts the ante 100
67c11e53: posts the ante 100
6f5ef1a7: posts the ante 100
aa9a7b65: posts the ante 100
ae4352d9: posts the ante 100
Hero: posts the ante 100
13905b7c: posts the ante 100
7966af7: posts the ante 100
aa9a7b65: posts small blind 350
6f5ef1a7: posts big blind 700
*** HOLE CARDS ***
Dealt to ae4352d9 
Dealt to 13905b7c 
Dealt to 692d5f90 
Dealt to Hero [Ks 5h]
Dealt to aa9a7b65 
Dealt to 6f5ef1a7 
Dealt to 7966af7 
Dealt to 67c11e53 
7966af7: folds
67c11e53: folds
ae4352d9: folds
13905b7c: folds
692d5f90: folds
Hero: folds
aa9a7b65: folds
Uncalled bet (350) returned to 6f5ef1a7
*** SHOWDOWN ***
6f5ef1a7 collected 1,500 from pot
*** SUMMARY ***
Total pot 1,500 | Rake 0 | Jackpot 0 | Bingo 0 | Fortune 0 | Tax 0
Seat 1: ae4352d9 folded before Flop
Seat 2: 13905b7c folded before Flop
Seat 3: 692d5f90 folded before Flop
Seat 4: Hero (button) folded before Flop
Seat 5: aa9a7b65 (small blind) folded before Flop
Seat 6: 6f5ef1a7 (big blind) collected (1,500)
Seat 7: 7966af7 folded before Flop
Seat 8: 67c11e53 folded before Flop


Poker Hand #TM3547355895: Tournament #156323098, Bounty Hunters $1.08 Hold'em No Limit - Level11(350/700) - 2024/08/03 23:48:07
Table '31' 8-max Seat #3 is the button
Seat 1: ae4352d9 (17,198 in chips)
Seat 2: 13905b7c (8,711 in chips)
Seat 3: 692d5f90 (23,846 in chips)
Seat 4: Hero (46,291 in chips)
Seat 5: aa9a7b65 (46,100 in chips)
Seat 6: 6f5ef1a7 (16,080 in chips)
Seat 7: 7966af7 (11,016 in chips)
Seat 8: 67c11e53 (50,542 in chips)
692d5f90: posts the ante 100
67c11e53: posts the ante 100
6f5ef1a7: posts the ante 100
aa9a7b65: posts the ante 100
ae4352d9: posts the ante 100
13905b7c: posts the ante 100
7966af7: posts the ante 100
Hero: posts the ante 100
Hero: posts small blind 350
aa9a7b65: posts big blind 700
*** HOLE CARDS ***
Dealt to ae4352d9 
Dealt to 13905b7c 
Dealt to 692d5f90 
Dealt to Hero [Qh 6d]
Dealt to aa9a7b65 
Dealt to 6f5ef1a7 
Dealt to 7966af7 
Dealt to 67c11e53 
6f5ef1a7: folds
7966af7: folds
67c11e53: folds
ae4352d9: folds
13905b7c: folds
692d5f90: raises 700 to 1,400
Hero: folds
aa9a7b65: raises 2,963 to 4,363
692d5f90: calls 2,963
*** FLOP *** [6c 2c 3d]
aa9a7b65: bets 3,260
692d5f90: raises 16,123 to 19,383 and is all-in
aa9a7b65: folds
Uncalled bet (16,123) returned to 692d5f90
*** SHOWDOWN ***
692d5f90 collected 16,396 from pot
*** SUMMARY ***
Total pot 16,396 | Rake 0 | Jackpot 0 | Bingo 0 | Fortune 0 | Tax 0
Board [6c 2c 3d]
Seat 1: ae4352d9 folded before Flop
Seat 2: 13905b7c folded before Flop
Seat 3: 692d5f90 (button) won (16,396)
Seat 4: Hero (small blind) folded before Flop
Seat 5: aa9a7b65 (big blind) folded on the Flop
Seat 6: 6f5ef1a7 folded before Flop
Seat 7: 7966af7 folded before Flop
Seat 8: 67c11e53 folded before Flop


Poker Hand #TM3547355871: Tournament #156323098, Bounty Hunters $1.08 Hold'em No Limit - Level11(350/700) - 2024/08/03 23:47:34
Table '31' 8-max Seat #2 is the button
Seat 1: ae4352d9 (17,298 in chips)
Seat 2: 13905b7c (8,811 in chips)
Seat 3: 692d5f90 (24,296 in chips)
Seat 4: Hero (47,791 in chips)
Seat 5: aa9a7b65 (42,250 in chips)
Seat 6: 6f5ef1a7 (17,580 in chips)
Seat 7: 7966af7 (11,116 in chips)
Seat 8: 67c11e53 (50,642 in chips)
67c11e53: posts the ante 100
692d5f90: posts the ante 100
6f5ef1a7: posts the ante 100
aa9a7b65: posts the ante 100
ae4352d9: posts the ante 100
13905b7c: posts the ante 100
7966af7: posts the ante 100
Hero: posts the ante 100
692d5f90: posts small blind 350
Hero: posts big blind 700
*** HOLE CARDS ***
Dealt to ae4352d9 
Dealt to 13905b7c 
Dealt to 692d5f90 
Dealt to Hero [5s 3s]
Dealt to aa9a7b65 
Dealt to 6f5ef1a7 
Dealt to 7966af7 
Dealt to 67c11e53 
aa9a7b65: raises 700 to 1,400
6f5ef1a7: calls 1,400
7966af7: folds
67c11e53: folds
ae4352d9: folds
13905b7c: folds
692d5f90: folds
Hero: calls 700
*** FLOP *** [Ts Ad 7h]
Hero: checks
aa9a7b65: bets 1,766
6f5ef1a7: folds
Hero: folds
Uncalled bet (1,766) returned to aa9a7b65
*** SHOWDOWN ***
aa9a7b65 collected 5,350 from pot
*** SUMMARY ***
Total pot 5,350 | Rake 0 | Jackpot 0 | Bingo 0 | Fortune 0 | Tax 0
Board [Ts Ad 7h]
Seat 1: ae4352d9 folded before Flop
Seat 2: 13905b7c (button) folded before Flop
Seat 3: 692d5f90 (small blind) folded before Flop
Seat 4: Hero (big blind) folded on the Flop
Seat 5: aa9a7b65 won (5,350)
Seat 6: 6f5ef1a7 folded on the Flop
Seat 7: 7966af7 folded before Flop
Seat 8: 67c11e53 folded before Flop


Poker Hand #TM3547355826: Tournament #156323098, Bounty Hunters $1.08 Hold'em No Limit - Level11(350/700) - 2024/08/03 23:46:59
Table '31' 8-max Seat #1 is the button
Seat 1: ae4352d9 (17,398 in chips)
Seat 2: 13905b7c (9,261 in chips)
Seat 3: 692d5f90 (25,096 in chips)
Seat 4: Hero (47,891 in chips)
Seat 5: aa9a7b65 (40,500 in chips)
Seat 6: 6f5ef1a7 (17,680 in chips)
Seat 7: 7966af7 (11,216 in chips)
Seat 8: 67c11e53 (50,742 in chips)
67c11e53: posts the ante 100
692d5f90: posts the ante 100
6f5ef1a7: posts the ante 100
aa9a7b65: posts the ante 100
ae4352d9: posts the ante 100
7966af7: posts the ante 100
Hero: posts the ante 100
13905b7c: posts the ante 100
13905b7c: posts small blind 350
692d5f90: posts big blind 700
*** HOLE CARDS ***
Dealt to ae4352d9 
Dealt to 13905b7c 
Dealt to 692d5f90 
Dealt to Hero [4c 5h]
Dealt to aa9a7b65 
Dealt to 6f5ef1a7 
Dealt to 7966af7 
Dealt to 67c11e53 
Hero: folds
aa9a7b65: raises 700 to 1,400
6f5ef1a7: folds
7966af7: folds
67c11e53: folds
ae4352d9: folds
13905b7c: folds
692d5f90: folds
Uncalled bet (700) returned to aa9a7b65
*** SHOWDOWN ***
aa9a7b65 collected 2,550 from pot
*** SUMMARY ***
Total pot 2,550 | Rake 0 | Jackpot 0 | Bingo 0 | Fortune 0 | Tax 0
Seat 1: ae4352d9 (button) folded before Flop
Seat 2: 13905b7c (small blind) folded before Flop
Seat 3: 692d5f90 (big blind) folded before Flop
Seat 4: Hero folded before Flop
Seat 5: aa9a7b65 collected (2,550)
Seat 6: 6f5ef1a7 folded before Flop
Seat 7: 7966af7 folded before Flop
Seat 8: 67c11e53 folded before Flop


Poker Hand #TM3547355743: Tournament #156323098, Bounty Hunters $1.08 Hold'em No Limit - Level10(300/600) - 2024/08/03 23:45:32
Table '31' 8-max Seat #8 is the button
Seat 1: ae4352d9 (17,788 in chips)
Seat 2: 13905b7c (9,951 in chips)
Seat 3: 692d5f90 (25,186 in chips)
Seat 4: Hero (47,981 in chips)
Seat 5: aa9a7b65 (19,575 in chips)
Seat 7: 7966af7 (11,306 in chips)
Seat 8: 67c11e53 (70,317 in chips)
67c11e53: posts the ante 90
692d5f90: posts the ante 90
aa9a7b65: posts the ante 90
ae4352d9: posts the ante 90
7966af7: posts the ante 90
Hero: posts the ante 90
13905b7c: posts the ante 90
ae4352d9: posts small blind 300
13905b7c: posts big blind 600
*** HOLE CARDS ***
Dealt to ae4352d9 
Dealt to 13905b7c 
Dealt to 692d5f90 
Dealt to Hero [4h 2d]
Dealt to aa9a7b65 
Dealt to 7966af7 
Dealt to 67c11e53 
692d5f90: folds
Hero: folds
aa9a7b65: raises 600 to 1,200
7966af7: folds
67c11e53: calls 1,200
ae4352d9: folds
13905b7c: folds
*** FLOP *** [4d As Qd]
aa9a7b65: bets 2,400
67c11e53: calls 2,400
*** TURN *** [4d As Qd] [8d]
aa9a7b65: bets 2,881
67c11e53: calls 2,881
*** RIVER *** [4d As Qd 8d] [Th]
aa9a7b65: bets 13,004 and is all-in
67c11e53: calls 13,004
aa9a7b65: shows [6d 7d] (Queen High Flush)
67c11e53: shows [Kd Qs] (Pair of Queens)
*** SHOWDOWN ***
aa9a7b65 collected 40,500 from pot
*** SUMMARY ***
Total pot 40,500 | Rake 0 | Jackpot 0 | Bingo 0 | Fortune 0 | Tax 0
Board [4d As Qd 8d Th]
Seat 1: ae4352d9 (small blind) folded before Flop
Seat 2: 13905b7c (big blind) folded before Flop
Seat 3: 692d5f90 folded before Flop
Seat 4: Hero folded before Flop
Seat 5: aa9a7b65 showed [6d 7d] and won (40,500) with Queen High Flush
Seat 7: 7966af7 folded before Flop
Seat 8: 67c11e53 (button) showed [Kd Qs] and lost with Pair of Queens


Poker Hand #TM3547355686: Tournament #156323098, Bounty Hunters $1.08 Hold'em No Limit - Level10(300/600) - 2024/08/03 23:44:34
Table '70' 8-max Seat #5 is the button
Seat 1: 1a1f7f68 (8,949 in chips)
Seat 2: dcb4e82c (38,121 in chips)
Seat 3: 95b2710a (95,342 in chips)
Seat 4: 85463779 (25,978 in chips)
Seat 5: Hero (48,071 in chips)
Seat 6: ed671234 (9,220 in chips)
Seat 7: 74784a16 (37,764 in chips)
Seat 8: 4365ec1 (13,621 in chips)
95b2710a: posts the ante 90
85463779: posts the ante 90
ed671234: posts the ante 90
4365ec1: posts the ante 90
74784a16: posts the ante 90
1a1f7f68: posts the ante 90
Hero: posts the ante 90
dcb4e82c: posts the ante 90
ed671234: posts small blind 300
74784a16: posts big blind 600
*** HOLE CARDS ***
Dealt to 1a1f7f68 
Dealt to dcb4e82c 
Dealt to 95b2710a 
Dealt to 85463779 
Dealt to Hero [8s Jh]
Dealt to ed671234 
Dealt to 74784a16 
Dealt to 4365ec1 
4365ec1: folds
1a1f7f68: raises 8,259 to 8,859 and is all-in
dcb4e82c: folds
95b2710a: folds
85463779: raises 17,029 to 25,888 and is all-in
Hero: folds
ed671234: calls 8,830 and is all-in
74784a16: folds
Uncalled bet (16,758) returned to 85463779
85463779: shows [Kc Ad]
ed671234: shows [8h Ts]
1a1f7f68: shows [Qd 4d]
*** FLOP *** [9d 5d 5h]
*** TURN *** [9d 5d 5h] [Kd]
*** RIVER *** [9d 5d 5h Kd] [2d]
*** SHOWDOWN ***
85463779 collected 27,897 from pot
85463779 collected 542 from pot
*** SUMMARY ***
Total pot 28,439 | Rake 0 | Jackpot 0 | Bingo 0 | Fortune 0 | Tax 0
Board [9d 5d 5h Kd 2d]
Seat 1: 1a1f7f68 showed [Qd 4d] and lost with King High Flush
Seat 2: dcb4e82c folded before Flop
Seat 3: 95b2710a folded before Flop
Seat 4: 85463779 showed [Kc Ad] and won (28,439) with Ace High Flush
Seat 5: Hero (button) folded before Flop
Seat 6: ed671234 (small blind) showed [8h Ts] and lost with Pair of Fives
Seat 7: 74784a16 (big blind) folded before Flop
Seat 8: 4365ec1 folded before Flop


Poker Hand #TM3547355667: Tournament #156323098, Bounty Hunters $1.08 Hold'em No Limit - Level10(300/600) - 2024/08/03 23:44:12
Table '70' 8-max Seat #4 is the button
Seat 1: 1a1f7f68 (9,039 in chips)
Seat 2: dcb4e82c (38,211 in chips)
Seat 3: 95b2710a (95,432 in chips)
Seat 4: 85463779 (26,068 in chips)
Seat 5: Hero (48,461 in chips)
Seat 6: ed671234 (9,910 in chips)
Seat 7: 74784a16 (36,234 in chips)
Seat 8: 4365ec1 (13,711 in chips)
95b2710a: posts the ante 90
85463779: posts the ante 90
ed671234: posts the ante 90
4365ec1: posts the ante 90
74784a16: posts the ante 90
1a1f7f68: posts the ante 90
dcb4e82c: posts the ante 90
Hero: posts the ante 90
Hero: posts small blind 300
ed671234: posts big blind 600
*** HOLE CARDS ***
Dealt to 1a1f7f68 
Dealt to dcb4e82c 
Dealt to 95b2710a 
Dealt to 85463779 
Dealt to Hero [8h Ad]
Dealt to ed671234 
Dealt to 74784a16 
Dealt to 4365ec1 
74784a16: raises 1,200 to 1,800
4365ec1: folds
1a1f7f68: folds
dcb4e82c: folds
95b2710a: folds
85463779: folds
Hero: folds
ed671234: folds
Uncalled bet (1,200) returned to 74784a16
*** SHOWDOWN ***
74784a16 collected 2,220 from pot
*** SUMMARY ***
Total pot 2,220 | Rake 0 | Jackpot 0 | Bingo 0 | Fortune 0 | Tax 0
Seat 1: 1a1f7f68 folded before Flop
Seat 2: dcb4e82c folded before Flop
Seat 3: 95b2710a folded before Flop
Seat 4: 85463779 (button) folded before Flop
Seat 5: Hero (small blind) folded before Flop
Seat 6: ed671234 (big blind) folded before Flop
Seat 7: 74784a16 collected (2,220)
Seat 8: 4365ec1 folded before Flop


Poker Hand #TM3547355615: Tournament #156323098, Bounty Hunters $1.08 Hold'em No Limit - Level10(300/600) - 2024/08/03 23:43:23
Table '70' 8-max Seat #3 is the button
Seat 1: 1a1f7f68 (9,129 in chips)
Seat 2: dcb4e82c (42,501 in chips)
Seat 3: 95b2710a (89,102 in chips)
Seat 4: 85463779 (26,458 in chips)
Seat 5: Hero (49,151 in chips)
Seat 6: ed671234 (10,000 in chips)
Seat 7: 74784a16 (36,924 in chips)
Seat 8: 4365ec1 (13,801 in chips)
95b2710a: posts the ante 90
85463779: posts the ante 90
ed671234: posts the ante 90
4365ec1: posts the ante 90
74784a16: posts the ante 90
1a1f7f68: posts the ante 90
dcb4e82c: posts the ante 90
Hero: posts the ante 90
85463779: posts small blind 300
Hero: posts big blind 600
*** HOLE CARDS ***
Dealt to 1a1f7f68 
Dealt to dcb4e82c 
Dealt to 95b2710a 
Dealt to 85463779 
Dealt to Hero [6d 2c]
Dealt to ed671234 
Dealt to 74784a16 
Dealt to 4365ec1 
ed671234: folds
74784a16: calls 600
4365ec1: folds
1a1f7f68: folds
dcb4e82c: raises 600 to 1,200
95b2710a: raises 3,000 to 4,200
85463779: folds
Hero: folds
74784a16: folds
dcb4e82c: calls 3,000
*** FLOP *** [5d 9d 4d]
dcb4e82c: checks
95b2710a: checks
*** TURN *** [5d 9d 4d] [2s]
dcb4e82c: checks
95b2710a: checks
*** RIVER *** [5d 9d 4d 2s] [5s]
dcb4e82c: checks
95b2710a: checks
dcb4e82c: shows [Ks Jh] (Pair of Fives)
95b2710a: shows [Qc Ah] (Pair of Fives)
*** SHOWDOWN ***
95b2710a collected 10,620 from pot
*** SUMMARY ***
Total pot 10,620 | Rake 0 | Jackpot 0 | Bingo 0 | Fortune 0 | Tax 0
Board [5d 9d 4d 2s 5s]
Seat 1: 1a1f7f68 folded before Flop
Seat 2: dcb4e82c showed [Ks Jh] and lost with Pair of Fives
Seat 3: 95b2710a (button) showed [Qc Ah] and won (10,620) with Pair of Fives
Seat 4: 85463779 (small blind) folded before Flop
Seat 5: Hero (big blind) folded before Flop
Seat 6: ed671234 folded before Flop
Seat 7: 74784a16 folded before Flop
Seat 8: 4365ec1 folded before Flop


Poker Hand #TM3547355566: Tournament #156323098, Bounty Hunters $1.08 Hold'em No Limit - Level10(300/600) - 2024/08/03 23:42:30
Table '70' 8-max Seat #2 is the button
Seat 1: 1a1f7f68 (9,219 in chips)
Seat 2: dcb4e82c (42,591 in chips)
Seat 3: 95b2710a (90,392 in chips)
Seat 4: 85463779 (27,148 in chips)
Seat 5: Hero (49,241 in chips)
Seat 7: 74784a16 (34,584 in chips)
Seat 8: 4365ec1 (13,891 in chips)
95b2710a: posts the ante 90
85463779: posts the ante 90
4365ec1: posts the ante 90
74784a16: posts the ante 90
1a1f7f68: posts the ante 90
dcb4e82c: posts the ante 90
Hero: posts the ante 90
95b2710a: posts small blind 300
85463779: posts big blind 600
*** HOLE CARDS ***
Dealt to 1a1f7f68 
Dealt to dcb4e82c 
Dealt to 95b2710a 
Dealt to 85463779 
Dealt to Hero [Qd 8h]
Dealt to 74784a16 
Dealt to 4365ec1 
Hero: folds
74784a16: raises 600 to 1,200
4365ec1: folds
1a1f7f68: folds
dcb4e82c: folds
95b2710a: calls 900
85463779: folds
*** FLOP *** [8s 7h Jd]
95b2710a: checks
74784a16: checks
*** TURN *** [8s 7h Jd] [9c]
95b2710a: checks
74784a16: bets 1,198
95b2710a: folds
Uncalled bet (1,198) returned to 74784a16
*** SHOWDOWN ***
74784a16 collected 3,630 from pot
*** SUMMARY ***
Total pot 3,630 | Rake 0 | Jackpot 0 | Bingo 0 | Fortune 0 | Tax 0
Board [8s 7h Jd 9c]
Seat 1: 1a1f7f68 folded before Flop
Seat 2: dcb4e82c (button) folded before Flop
Seat 3: 95b2710a (small blind) folded on the Turn
Seat 4: 85463779 (big blind) folded before Flop
Seat 5: Hero folded before Flop
Seat 7: 74784a16 won (3,630)
Seat 8: 4365ec1 folded before Flop


Poker Hand #TM3547355481: Tournament #156323098, Bounty Hunters $1.08 Hold'em No Limit - Level10(300/600) - 2024/08/03 23:41:03
Table '70' 8-max Seat #1 is the button
Seat 1: 1a1f7f68 (9,309 in chips)
Seat 2: dcb4e82c (43,881 in chips)
Seat 3: 95b2710a (82,545 in chips)
Seat 4: 85463779 (27,238 in chips)
Seat 5: Hero (49,331 in chips)
Seat 7: 74784a16 (40,781 in chips)
Seat 8: 4365ec1 (13,981 in chips)
95b2710a: posts the ante 90
85463779: posts the ante 90
4365ec1: posts the ante 90
74784a16: posts the ante 90
1a1f7f68: posts the ante 90
Hero: posts the ante 90
dcb4e82c: posts the ante 90
dcb4e82c: posts small blind 300
95b2710a: posts big blind 600
*** HOLE CARDS ***
Dealt to 1a1f7f68 
Dealt to dcb4e82c 
Dealt to 95b2710a 
Dealt to 85463779 
Dealt to Hero [4d Jh]
Dealt to 74784a16 
Dealt to 4365ec1 
85463779: folds
Hero: folds
74784a16: raises 600 to 1,200
4365ec1: folds
1a1f7f68: folds
dcb4e82c: calls 900
95b2710a: calls 600
*** FLOP *** [5c 8h 2c]
dcb4e82c: checks
95b2710a: checks
74784a16: bets 1,396
dcb4e82c: folds
95b2710a: calls 1,396
*** TURN *** [5c 8h 2c] [Ts]
95b2710a: checks
74784a16: checks
*** RIVER *** [5c 8h 2c Ts] [Ah]
95b2710a: checks
74784a16: bets 3,511
95b2710a: calls 3,511
74784a16: shows [Js Qc] (Ace-High)
95b2710a: shows [Ac 3d] (Pair of Aces)
*** SHOWDOWN ***
95b2710a collected 14,044 from pot
*** SUMMARY ***
Total pot 14,044 | Rake 0 | Jackpot 0 | Bingo 0 | Fortune 0 | Tax 0
Board [5c 8h 2c Ts Ah]
Seat 1: 1a1f7f68 (button) folded before Flop
Seat 2: dcb4e82c (small blind) folded on the Flop
Seat 3: 95b2710a (big blind) showed [Ac 3d] and won (14,044) with Pair of Aces
Seat 4: 85463779 folded before Flop
Seat 5: Hero folded before Flop
Seat 7: 74784a16 showed [Js Qc] and lost with Ace-High
Seat 8: 4365ec1 folded before Flop


Poker Hand #TM3547355385: Tournament #156323098, Bounty Hunters $1.08 Hold'em No Limit - Level10(300/600) - 2024/08/03 23:39:37
Table '70' 8-max Seat #8 is the button
Seat 1: 1a1f7f68 (9,699 in chips)
Seat 2: dcb4e82c (31,616 in chips)
Seat 3: 95b2710a (82,635 in chips)
Seat 4: 85463779 (27,328 in chips)
Seat 5: Hero (50,921 in chips)
Seat 6: f7f1a6ef (9,925 in chips)
Seat 7: 74784a16 (40,871 in chips)
Seat 8: 4365ec1 (14,071 in chips)
95b2710a: posts the ante 90
85463779: posts the ante 90
4365ec1: posts the ante 90
74784a16: posts the ante 90
f7f1a6ef: posts the ante 90
1a1f7f68: posts the ante 90
Hero: posts the ante 90
dcb4e82c: posts the ante 90
1a1f7f68: posts small blind 300
dcb4e82c: posts big blind 600
*** HOLE CARDS ***
Dealt to 1a1f7f68 
Dealt to dcb4e82c 
Dealt to 95b2710a 
Dealt to 85463779 
Dealt to Hero [Qs Td]
Dealt to f7f1a6ef 
Dealt to 74784a16 
Dealt to 4365ec1 
95b2710a: folds
85463779: folds
Hero: raises 900 to 1,500
f7f1a6ef: raises 8,335 to 9,835 and is all-in
74784a16: folds
4365ec1: folds
1a1f7f68: folds
dcb4e82c: raises 21,691 to 31,526 and is all-in
Hero: folds
Uncalled bet (21,691) returned to dcb4e82c
dcb4e82c: shows [Kc 6h]
f7f1a6ef: shows [8c 9c]
*** FLOP *** [7d 5c Qc]
*** TURN *** [7d 5c Qc] [Qd]
*** RIVER *** [7d 5c Qc Qd] [Ad]
Hero: shows [Qs] (Three Queens)
*** SHOWDOWN ***
dcb4e82c collected 22,190 from pot
*** SUMMARY ***
Total pot 22,190 | Rake 0 | Jackpot 0 | Bingo 0 | Fortune 0 | Tax 0
Board [7d 5c Qc Qd Ad]
Seat 1: 1a1f7f68 (small blind) folded before Flop
Seat 2: dcb4e82c (big blind) showed [Kc 6h] and won (22,190) with Pair of Queens
Seat 3: 95b2710a folded before Flop
Seat 4: 85463779 folded before Flop
Seat 5: Hero folded before Flop
Seat 6: f7f1a6ef showed [8c 9c] and lost with Pair of Queens
Seat 7: 74784a16 folded before Flop
Seat 8: 4365ec1 (button) folded before Flop


Poker Hand #TM3547355330: Tournament #156323098, Bounty Hunters $1.08 Hold'em No Limit - Level9(250/500) - 2024/08/03 23:38:33
Table '70' 8-max Seat #7 is the button
Seat 1: 1a1f7f68 (11,050 in chips)
Seat 2: dcb4e82c (32,967 in chips)
Seat 3: 95b2710a (82,710 in chips)
Seat 4: a75b7bb6 (14,541 in chips)
Seat 5: Hero (47,594 in chips)
Seat 6: f7f1a6ef (10,000 in chips)
Seat 7: 74784a16 (40,946 in chips)
Seat 8: 4365ec1 (14,396 in chips)
95b2710a: posts the ante 75
74784a16: posts the ante 75
4365ec1: posts the ante 75
f7f1a6ef: posts the ante 75
a75b7bb6: posts the ante 75
1a1f7f68: posts the ante 75
Hero: posts the ante 75
dcb4e82c: posts the ante 75
4365ec1: posts small blind 250
1a1f7f68: posts big blind 500
*** HOLE CARDS ***
Dealt to 1a1f7f68 
Dealt to dcb4e82c 
Dealt to 95b2710a 
Dealt to a75b7bb6 
Dealt to Hero [Ah Ts]
Dealt to f7f1a6ef 
Dealt to 74784a16 
Dealt to 4365ec1 
dcb4e82c: calls 500
95b2710a: folds
a75b7bb6: folds
Hero: raises 776 to 1,276
f7f1a6ef: folds
74784a16: folds
4365ec1: folds
1a1f7f68: calls 776
dcb4e82c: calls 776
*** FLOP *** [9s 5d Jd]
1a1f7f68: checks
dcb4e82c: checks
Hero: checks
*** TURN *** [9s 5d Jd] [Td]
1a1f7f68: checks
dcb4e82c: checks
Hero: checks
*** RIVER *** [9s 5d Jd Td] [8h]
1a1f7f68: checks
dcb4e82c: checks
Hero: checks
1a1f7f68: shows [Kc 5h] (Pair of Fives)
dcb4e82c: shows [4c Kh] (King-High)
Hero: shows [Ah Ts] (Pair of Tens)
*** SHOWDOWN ***
Hero collected 4,678 from pot
*** SUMMARY ***
Total pot 4,678 | Rake 0 | Jackpot 0 | Bingo 0 | Fortune 0 | Tax 0
Board [9s 5d Jd Td 8h]
Seat 1: 1a1f7f68 (big blind) showed [Kc 5h] and lost with Pair of Fives
Seat 2: dcb4e82c showed [4c Kh] and lost with King-High
Seat 3: 95b2710a folded before Flop
Seat 4: a75b7bb6 folded before Flop
Seat 5: Hero showed [Ah Ts] and won (4,678) with Pair of Tens
Seat 6: f7f1a6ef folded before Flop
Seat 7: 74784a16 (button) folded before Flop
Seat 8: 4365ec1 (small blind) folded before Flop


Poker Hand #TM3547355265: Tournament #156323098, Bounty Hunters $1.08 Hold'em No Limit - Level9(250/500) - 2024/08/03 23:37:40
Table '70' 8-max Seat #5 is the button
Seat 1: 1a1f7f68 (11,125 in chips)
Seat 2: dcb4e82c (20,327 in chips)
Seat 3: 95b2710a (94,225 in chips)
Seat 4: a75b7bb6 (14,616 in chips)
Seat 5: Hero (47,669 in chips)
Seat 7: 74784a16 (41,271 in chips)
Seat 8: 4365ec1 (14,971 in chips)
95b2710a: posts the ante 75
4365ec1: posts the ante 75
74784a16: posts the ante 75
a75b7bb6: posts the ante 75
1a1f7f68: posts the ante 75
Hero: posts the ante 75
dcb4e82c: posts the ante 75
74784a16: posts small blind 250
4365ec1: posts big blind 500
*** HOLE CARDS ***
Dealt to 1a1f7f68 
Dealt to dcb4e82c 
Dealt to 95b2710a 
Dealt to a75b7bb6 
Dealt to Hero [2h Ac]
Dealt to 74784a16 
Dealt to 4365ec1 
1a1f7f68: folds
dcb4e82c: raises 500 to 1,000
95b2710a: raises 2,000 to 3,000
a75b7bb6: folds
Hero: folds
74784a16: folds
4365ec1: folds
dcb4e82c: calls 2,000
*** FLOP *** [8s 8c 5s]
dcb4e82c: checks
95b2710a: bets 2,401
dcb4e82c: calls 2,401
*** TURN *** [8s 8c 5s] [2d]
dcb4e82c: checks
95b2710a: bets 6,039
dcb4e82c: calls 6,039
*** RIVER *** [8s 8c 5s 2d] [Js]
dcb4e82c: checks
95b2710a: checks
dcb4e82c: shows [Ts Qs] (Queen High Flush)
95b2710a: shows [Ks Ad] (Pair of Eights)
*** SHOWDOWN ***
dcb4e82c collected 24,155 from pot
*** SUMMARY ***
Total pot 24,155 | Rake 0 | Jackpot 0 | Bingo 0 | Fortune 0 | Tax 0
Board [8s 8c 5s 2d Js]
Seat 1: 1a1f7f68 folded before Flop
Seat 2: dcb4e82c showed [Ts Qs] and won (24,155) with Queen High Flush
Seat 3: 95b2710a showed [Ks Ad] and lost with Pair of Eights
Seat 4: a75b7bb6 folded before Flop
Seat 5: Hero (button) folded before Flop
Seat 7: 74784a16 (small blind) folded before Flop
Seat 8: 4365ec1 (big blind) folded before Flop


Poker Hand #TM3547355225: Tournament #156323098, Bounty Hunters $1.08 Hold'em No Limit - Level9(250/500) - 2024/08/03 23:37:00
Table '70' 8-max Seat #4 is the button
Seat 1: 1a1f7f68 (11,200 in chips)
Seat 2: dcb4e82c (20,402 in chips)
Seat 3: 95b2710a (95,300 in chips)
Seat 4: a75b7bb6 (14,691 in chips)
Seat 5: Hero (48,744 in chips)
Seat 7: 74784a16 (38,821 in chips)
Seat 8: 4365ec1 (15,046 in chips)
95b2710a: posts the ante 75
4365ec1: posts the ante 75
74784a16: posts the ante 75
a75b7bb6: posts the ante 75
1a1f7f68: posts the ante 75
dcb4e82c: posts the ante 75
Hero: posts the ante 75
Hero: posts small blind 250
74784a16: posts big blind 500
*** HOLE CARDS ***
Dealt to 1a1f7f68 
Dealt to dcb4e82c 
Dealt to 95b2710a 
Dealt to a75b7bb6 
Dealt to Hero [Ad Js]
Dealt to 74784a16 
Dealt to 4365ec1 
4365ec1: folds
1a1f7f68: folds
dcb4e82c: folds
95b2710a: raises 500 to 1,000
a75b7bb6: folds
Hero: calls 750
74784a16: calls 500
*** FLOP *** [5d Td 8c]
Hero: checks
74784a16: bets 1,763
95b2710a: folds
Hero: folds
Uncalled bet (1,763) returned to 74784a16
*** SHOWDOWN ***
74784a16 collected 3,525 from pot
*** SUMMARY ***
Total pot 3,525 | Rake 0 | Jackpot 0 | Bingo 0 | Fortune 0 | Tax 0
Board [5d Td 8c]
Seat 1: 1a1f7f68 folded before Flop
Seat 2: dcb4e82c folded before Flop
Seat 3: 95b2710a folded on the Flop
Seat 4: a75b7bb6 (button) folded before Flop
Seat 5: Hero (small blind) folded on the Flop
Seat 7: 74784a16 (big blind) won (3,525)
Seat 8: 4365ec1 folded before Flop


Poker Hand #TM3547355190: Tournament #156323098, Bounty Hunters $1.08 Hold'em No Limit - Level9(250/500) - 2024/08/03 23:36:32
Table '70' 8-max Seat #3 is the button
Seat 1: 1a1f7f68 (11,275 in chips)
Seat 2: dcb4e82c (20,477 in chips)
Seat 3: 95b2710a (95,375 in chips)
Seat 4: a75b7bb6 (15,016 in chips)
Seat 5: Hero (49,319 in chips)
Seat 6: af2d8da1 (36,210 in chips)
Seat 7: 74784a16 (38,896 in chips)
Seat 8: 4365ec1 (15,121 in chips)
af2d8da1: posts the ante 75
95b2710a: posts the ante 75
4365ec1: posts the ante 75
74784a16: posts the ante 75
a75b7bb6: posts the ante 75
1a1f7f68: posts the ante 75
dcb4e82c: posts the ante 75
Hero: posts the ante 75
a75b7bb6: posts small blind 250
Hero: posts big blind 500
*** HOLE CARDS ***
Dealt to 1a1f7f68 
Dealt to dcb4e82c 
Dealt to 95b2710a 
Dealt to a75b7bb6 
Dealt to Hero [4c Qc]
Dealt to af2d8da1 
Dealt to 74784a16 
Dealt to 4365ec1 
af2d8da1: raises 1,000 to 1,500
74784a16: folds
4365ec1: folds
1a1f7f68: folds
dcb4e82c: folds
95b2710a: folds
a75b7bb6: folds
Hero: folds
Uncalled bet (1,000) returned to af2d8da1
*** SHOWDOWN ***
af2d8da1 collected 1,850 from pot
*** SUMMARY ***
Total pot 1,850 | Rake 0 | Jackpot 0 | Bingo 0 | Fortune 0 | Tax 0
Seat 1: 1a1f7f68 folded before Flop
Seat 2: dcb4e82c folded before Flop
Seat 3: 95b2710a (button) folded before Flop
Seat 4: a75b7bb6 (small blind) folded before Flop
Seat 5: Hero (big blind) folded before Flop
Seat 6: af2d8da1 collected (1,850)
Seat 7: 74784a16 folded before Flop
Seat 8: 4365ec1 folded before Flop


Poker Hand #TM3547355159: Tournament #156323098, Bounty Hunters $1.08 Hold'em No Limit - Level9(250/500) - 2024/08/03 23:36:02
Table '70' 8-max Seat #2 is the button
Seat 1: 1a1f7f68 (10,000 in chips)
Seat 2: dcb4e82c (20,552 in chips)
Seat 3: 95b2710a (95,700 in chips)
Seat 4: a75b7bb6 (15,591 in chips)
Seat 5: Hero (49,394 in chips)
Seat 6: af2d8da1 (36,285 in chips)
Seat 7: 74784a16 (38,971 in chips)
Seat 8: 4365ec1 (15,196 in chips)
af2d8da1: posts the ante 75
95b2710a: posts the ante 75
4365ec1: posts the ante 75
74784a16: posts the ante 75
a75b7bb6: posts the ante 75
1a1f7f68: posts the ante 75
dcb4e82c: posts the ante 75
Hero: posts the ante 75
95b2710a: posts small blind 250
a75b7bb6: posts big blind 500
*** HOLE CARDS ***
Dealt to 1a1f7f68 
Dealt to dcb4e82c 
Dealt to 95b2710a 
Dealt to a75b7bb6 
Dealt to Hero [As 8h]
Dealt to af2d8da1 
Dealt to 74784a16 
Dealt to 4365ec1 
Hero: folds
af2d8da1: folds
74784a16: folds
4365ec1: folds
1a1f7f68: raises 650 to 1,150
dcb4e82c: folds
95b2710a: folds
a75b7bb6: folds
Uncalled bet (650) returned to 1a1f7f68
*** SHOWDOWN ***
1a1f7f68 collected 1,850 from pot
*** SUMMARY ***
Total pot 1,850 | Rake 0 | Jackpot 0 | Bingo 0 | Fortune 0 | Tax 0
Seat 1: 1a1f7f68 collected (1,850)
Seat 2: dcb4e82c (button) folded before Flop
Seat 3: 95b2710a (small blind) folded before Flop
Seat 4: a75b7bb6 (big blind) folded before Flop
Seat 5: Hero folded before Flop
Seat 6: af2d8da1 folded before Flop
Seat 7: 74784a16 folded before Flop
Seat 8: 4365ec1 folded before Flop


Poker Hand #TM3547355038: Tournament #156323098, Bounty Hunters $1.08 Hold'em No Limit - Level9(250/500) - 2024/08/03 23:34:10
Table '70' 8-max Seat #8 is the button
Seat 2: dcb4e82c (24,390 in chips)
Seat 3: 95b2710a (96,775 in chips)
Seat 4: a75b7bb6 (15,666 in chips)
Seat 5: Hero (50,469 in chips)
Seat 6: af2d8da1 (26,309 in chips)
Seat 7: 74784a16 (42,809 in chips)
Seat 8: 4365ec1 (15,271 in chips)
af2d8da1: posts the ante 75
95b2710a: posts the ante 75
4365ec1: posts the ante 75
74784a16: posts the ante 75
a75b7bb6: posts the ante 75
Hero: posts the ante 75
dcb4e82c: posts the ante 75
dcb4e82c: posts small blind 250
95b2710a: posts big blind 500
*** HOLE CARDS ***
Dealt to dcb4e82c 
Dealt to 95b2710a 
Dealt to a75b7bb6 
Dealt to Hero [3s Ac]
Dealt to af2d8da1 
Dealt to 74784a16 
Dealt to 4365ec1 
a75b7bb6: folds
Hero: raises 500 to 1,000
af2d8da1: calls 1,000
74784a16: calls 1,000
4365ec1: folds
dcb4e82c: calls 750
95b2710a: calls 500
*** FLOP *** [2c Qh 9d]
dcb4e82c: checks
95b2710a: checks
Hero: checks
af2d8da1: checks
74784a16: checks
*** TURN *** [2c Qh 9d] [4h]
dcb4e82c: bets 2,763
95b2710a: folds
Hero: folds
af2d8da1: calls 2,763
74784a16: calls 2,763
*** RIVER *** [2c Qh 9d 4h] [Kd]
dcb4e82c: checks
af2d8da1: bets 6,907
74784a16: folds
dcb4e82c: folds
Uncalled bet (6,907) returned to af2d8da1
*** SHOWDOWN ***
af2d8da1 collected 13,814 from pot
*** SUMMARY ***
Total pot 13,814 | Rake 0 | Jackpot 0 | Bingo 0 | Fortune 0 | Tax 0
Board [2c Qh 9d 4h Kd]
Seat 2: dcb4e82c (small blind) folded on the River
Seat 3: 95b2710a (big blind) folded on the Turn
Seat 4: a75b7bb6 folded before Flop
Seat 5: Hero folded on the Turn
Seat 6: af2d8da1 won (13,814)
Seat 7: 74784a16 folded on the River
Seat 8: 4365ec1 (button) folded before Flop


Poker Hand #TM3547354966: Tournament #156323098, Bounty Hunters $1.08 Hold'em No Limit - Level9(250/500) - 2024/08/03 23:32:56
Table '70' 8-max Seat #7 is the button
Seat 1: 69f15f89 (8,280 in chips)
Seat 2: dcb4e82c (24,465 in chips)
Seat 3: 95b2710a (98,850 in chips)
Seat 4: a75b7bb6 (15,741 in chips)
Seat 5: Hero (39,489 in chips)
Seat 6: af2d8da1 (26,384 in chips)
Seat 7: 74784a16 (42,884 in chips)
Seat 8: 4365ec1 (15,596 in chips)
af2d8da1: posts the ante 75
69f15f89: posts the ante 75
95b2710a: posts the ante 75
74784a16: posts the ante 75
4365ec1: posts the ante 75
a75b7bb6: posts the ante 75
Hero: posts the ante 75
dcb4e82c: posts the ante 75
4365ec1: posts small blind 250
69f15f89: posts big blind 500
*** HOLE CARDS ***
Dealt to 69f15f89 
Dealt to dcb4e82c 
Dealt to 95b2710a 
Dealt to a75b7bb6 
Dealt to Hero [5h 5s]
Dealt to af2d8da1 
Dealt to 74784a16 
Dealt to 4365ec1 
dcb4e82c: folds
95b2710a: raises 500 to 1,000
a75b7bb6: folds
Hero: raises 500 to 1,500
af2d8da1: folds
74784a16: folds
4365ec1: folds
69f15f89: raises 500 to 2,000
95b2710a: calls 1,000
Hero: calls 500
*** FLOP *** [4h 5d Kh]
69f15f89: bets 2,261
95b2710a: folds
Hero: calls 2,261
*** TURN *** [4h 5d Kh] [2s]
69f15f89: checks
Hero: bets 3,753
69f15f89: raises 191 to 3,944 and is all-in
Hero: calls 191
69f15f89: shows [Td Ks] (Pair of Kings)
Hero: shows [5h 5s] (Three Fives)
*** RIVER *** [4h 5d Kh 2s] [Qs]
*** SHOWDOWN ***
Hero collected 19,260 from pot
*** SUMMARY ***
Total pot 19,260 | Rake 0 | Jackpot 0 | Bingo 0 | Fortune 0 | Tax 0
Board [4h 5d Kh 2s Qs]
Seat 1: 69f15f89 (big blind) showed [Td Ks] and lost with Pair of Kings
Seat 2: dcb4e82c folded before Flop
Seat 3: 95b2710a folded on the Flop
Seat 4: a75b7bb6 folded before Flop
Seat 5: Hero showed [5h 5s] and won (19,260) with Three Fives
Seat 6: af2d8da1 folded before Flop
Seat 7: 74784a16 (button) folded before Flop
Seat 8: 4365ec1 (small blind) folded before Flop


Poker Hand #TM3547354880: Tournament #156323098, Bounty Hunters $1.08 Hold'em No Limit - Level8(200/400) - 2024/08/03 23:31:40
Table '70' 8-max Seat #6 is the button
Seat 1: 69f15f89 (9,540 in chips)
Seat 2: dcb4e82c (27,965 in chips)
Seat 3: 95b2710a (98,910 in chips)
Seat 4: a75b7bb6 (15,801 in chips)
Seat 5: Hero (39,549 in chips)
Seat 6: af2d8da1 (26,444 in chips)
Seat 7: 74784a16 (37,424 in chips)
Seat 8: 4365ec1 (16,056 in chips)
af2d8da1: posts the ante 60
69f15f89: posts the ante 60
95b2710a: posts the ante 60
4365ec1: posts the ante 60
74784a16: posts the ante 60
a75b7bb6: posts the ante 60
Hero: posts the ante 60
dcb4e82c: posts the ante 60
74784a16: posts small blind 200
4365ec1: posts big blind 400
*** HOLE CARDS ***
Dealt to 69f15f89 
Dealt to dcb4e82c 
Dealt to 95b2710a 
Dealt to a75b7bb6 
Dealt to Hero [7d As]
Dealt to af2d8da1 
Dealt to 74784a16 
Dealt to 4365ec1 
69f15f89: calls 400
dcb4e82c: raises 800 to 1,200
95b2710a: folds
a75b7bb6: folds
Hero: folds
af2d8da1: folds
74784a16: calls 1,000
4365ec1: folds
69f15f89: calls 800
*** FLOP *** [4c 8c Ad]
74784a16: checks
69f15f89: checks
dcb4e82c: checks
*** TURN *** [4c 8c Ad] [2s]
74784a16: bets 2,240
69f15f89: folds
dcb4e82c: calls 2,240
*** RIVER *** [4c 8c Ad 2s] [2h]
74784a16: bets 2,957
dcb4e82c: folds
Uncalled bet (2,957) returned to 74784a16
*** SHOWDOWN ***
74784a16 collected 8,960 from pot
*** SUMMARY ***
Total pot 8,960 | Rake 0 | Jackpot 0 | Bingo 0 | Fortune 0 | Tax 0
Board [4c 8c Ad 2s 2h]
Seat 1: 69f15f89 folded on the Turn
Seat 2: dcb4e82c folded on the River
Seat 3: 95b2710a folded before Flop
Seat 4: a75b7bb6 folded before Flop
Seat 5: Hero folded before Flop
Seat 6: af2d8da1 (button) folded before Flop
Seat 7: 74784a16 (small blind) won (8,960)
Seat 8: 4365ec1 (big blind) folded before Flop


Poker Hand #TM3547354817: Tournament #156323098, Bounty Hunters $1.08 Hold'em No Limit - Level8(200/400) - 2024/08/03 23:30:39
Table '70' 8-max Seat #5 is the button
Seat 1: 69f15f89 (10,000 in chips)
Seat 5: Hero (26,589 in chips)
Seat 6: af2d8da1 (28,604 in chips)
Seat 7: 74784a16 (47,704 in chips)
Seat 8: 4365ec1 (16,116 in chips)
69f15f89: posts the ante 60
af2d8da1: posts the ante 60
4365ec1: posts the ante 60
74784a16: posts the ante 60
Hero: posts the ante 60
af2d8da1: posts small blind 200
74784a16: posts big blind 400
*** HOLE CARDS ***
Dealt to 69f15f89 
Dealt to Hero [Qs Qh]
Dealt to af2d8da1 
Dealt to 74784a16 
Dealt to 4365ec1 
4365ec1: folds
69f15f89: calls 400
Hero: raises 1,700 to 2,100
af2d8da1: calls 1,900
74784a16: calls 1,700
69f15f89: folds
*** FLOP *** [Ad 7d Ah]
af2d8da1: checks
74784a16: checks
Hero: bets 3,500
af2d8da1: folds
74784a16: calls 3,500
*** TURN *** [Ad 7d Ah] [3c]
74784a16: checks
Hero: checks
*** RIVER *** [Ad 7d Ah 3c] [8c]
74784a16: bets 4,620
Hero: calls 4,620
74784a16: shows [Td Jd] (Pair of Aces)
Hero: shows [Qs Qh] (Pair of Aces and Pair of Queens)
*** SHOWDOWN ***
Hero collected 23,240 from pot
*** SUMMARY ***
Total pot 23,240 | Rake 0 | Jackpot 0 | Bingo 0 | Fortune 0 | Tax 0
Board [Ad 7d Ah 3c 8c]
Seat 1: 69f15f89 folded before Flop
Seat 5: Hero (button) showed [Qs Qh] and won (23,240) with Pair of Aces and Pair of Queens
Seat 6: af2d8da1 (small blind) folded on the Flop
Seat 7: 74784a16 (big blind) showed [Td Jd] and lost with Pair of Aces
Seat 8: 4365ec1 folded before Flop


Poker Hand #TM3547325382: Tournament #156323098, Bounty Hunters $1.08 Hold'em No Limit - Level8(200/400) - 2024/08/03 23:29:33
Table '2' 8-max Seat #8 is the button
Seat 1: cfd75398 (17,741 in chips)
Seat 2: 14627bc6 (38,922 in chips)
Seat 3: 3bcd4d55 (8,102 in chips)
Seat 4: d3e04f5d (27,009 in chips)
Seat 5: c392ea8c (17,305 in chips)
Seat 6: 8c9120dd (113,497 in chips)
Seat 7: Hero (24,969 in chips)
Seat 8: 92ef8cd8 (12,360 in chips)
92ef8cd8: posts the ante 60
cfd75398: posts the ante 60
c392ea8c: posts the ante 60
3bcd4d55: posts the ante 60
8c9120dd: posts the ante 60
14627bc6: posts the ante 60
d3e04f5d: posts the ante 60
Hero: posts the ante 60
cfd75398: posts small blind 200
14627bc6: posts big blind 400
*** HOLE CARDS ***
Dealt to cfd75398 
Dealt to 14627bc6 
Dealt to 3bcd4d55 
Dealt to d3e04f5d 
Dealt to c392ea8c 
Dealt to 8c9120dd 
Dealt to Hero [Ah Qs]
Dealt to 92ef8cd8 
3bcd4d55: folds
d3e04f5d: folds
c392ea8c: folds
8c9120dd: folds
Hero: raises 600 to 1,000
92ef8cd8: folds
cfd75398: folds
14627bc6: calls 600
*** FLOP *** [7d Ad 6d]
14627bc6: checks
Hero: bets 1,340
14627bc6: folds
Uncalled bet (1,340) returned to Hero
Hero: shows [Ah]
*** SHOWDOWN ***
Hero collected 2,680 from pot
*** SUMMARY ***
Total pot 2,680 | Rake 0 | Jackpot 0 | Bingo 0 | Fortune 0 | Tax 0
Board [7d Ad 6d]
Seat 1: cfd75398 (small blind) folded before Flop
Seat 2: 14627bc6 (big blind) folded on the Flop
Seat 3: 3bcd4d55 folded before Flop
Seat 4: d3e04f5d folded before Flop
Seat 5: c392ea8c folded before Flop
Seat 6: 8c9120dd folded before Flop
Seat 7: Hero showed [Ah] and won (2,680)
Seat 8: 92ef8cd8 (button) folded before Flop


Poker Hand #TM3547325293: Tournament #156323098, Bounty Hunters $1.08 Hold'em No Limit - Level8(200/400) - 2024/08/03 23:28:17
Table '2' 8-max Seat #7 is the button
Seat 1: cfd75398 (18,201 in chips)
Seat 2: 14627bc6 (40,982 in chips)
Seat 3: 3bcd4d55 (8,162 in chips)
Seat 4: d3e04f5d (27,069 in chips)
Seat 5: c392ea8c (17,365 in chips)
Seat 6: 8c9120dd (113,557 in chips)
Seat 7: Hero (25,029 in chips)
Seat 8: 92ef8cd8 (9,540 in chips)
92ef8cd8: posts the ante 60
cfd75398: posts the ante 60
c392ea8c: posts the ante 60
3bcd4d55: posts the ante 60
8c9120dd: posts the ante 60
14627bc6: posts the ante 60
d3e04f5d: posts the ante 60
Hero: posts the ante 60
92ef8cd8: posts small blind 200
cfd75398: posts big blind 400
*** HOLE CARDS ***
Dealt to cfd75398 
Dealt to 14627bc6 
Dealt to 3bcd4d55 
Dealt to d3e04f5d 
Dealt to c392ea8c 
Dealt to 8c9120dd 
Dealt to Hero [Th 2h]
Dealt to 92ef8cd8 
14627bc6: raises 800 to 1,200
3bcd4d55: folds
d3e04f5d: folds
c392ea8c: folds
8c9120dd: folds
Hero: folds
92ef8cd8: calls 1,000
cfd75398: folds
*** FLOP *** [4d Jh 9h]
92ef8cd8: checks
14627bc6: bets 800
92ef8cd8: raises 7,480 to 8,280 and is all-in
14627bc6: folds
Uncalled bet (7,480) returned to 92ef8cd8
92ef8cd8: shows [Ts Kh] (King-High)
*** SHOWDOWN ***
92ef8cd8 collected 4,880 from pot
*** SUMMARY ***
Total pot 4,880 | Rake 0 | Jackpot 0 | Bingo 0 | Fortune 0 | Tax 0
Board [4d Jh 9h]
Seat 1: cfd75398 (big blind) folded before Flop
Seat 2: 14627bc6 folded on the Flop
Seat 3: 3bcd4d55 folded before Flop
Seat 4: d3e04f5d folded before Flop
Seat 5: c392ea8c folded before Flop
Seat 6: 8c9120dd folded before Flop
Seat 7: Hero (button) folded before Flop
Seat 8: 92ef8cd8 (small blind) showed [Ts Kh] and won (4,880)


Poker Hand #TM3547325250: Tournament #156323098, Bounty Hunters $1.08 Hold'em No Limit - Level8(200/400) - 2024/08/03 23:27:37
Table '2' 8-max Seat #6 is the button
Seat 1: cfd75398 (18,261 in chips)
Seat 2: 14627bc6 (41,042 in chips)
Seat 3: 3bcd4d55 (8,222 in chips)
Seat 4: d3e04f5d (27,129 in chips)
Seat 5: c392ea8c (17,425 in chips)
Seat 6: 8c9120dd (112,537 in chips)
Seat 7: Hero (25,289 in chips)
Seat 8: 92ef8cd8 (10,000 in chips)
92ef8cd8: posts the ante 60
cfd75398: posts the ante 60
c392ea8c: posts the ante 60
3bcd4d55: posts the ante 60
8c9120dd: posts the ante 60
14627bc6: posts the ante 60
d3e04f5d: posts the ante 60
Hero: posts the ante 60
Hero: posts small blind 200
92ef8cd8: posts big blind 400
*** HOLE CARDS ***
Dealt to cfd75398 
Dealt to 14627bc6 
Dealt to 3bcd4d55 
Dealt to d3e04f5d 
Dealt to c392ea8c 
Dealt to 8c9120dd 
Dealt to Hero [Ts 5h]
Dealt to 92ef8cd8 
cfd75398: folds
14627bc6: folds
3bcd4d55: folds
d3e04f5d: folds
c392ea8c: folds
8c9120dd: raises 400 to 800
Hero: folds
92ef8cd8: folds
Uncalled bet (400) returned to 8c9120dd
92ef8cd8: shows [3h 6s]
*** SHOWDOWN ***
8c9120dd collected 1,480 from pot
*** SUMMARY ***
Total pot 1,480 | Rake 0 | Jackpot 0 | Bingo 0 | Fortune 0 | Tax 0
Seat 1: cfd75398 folded before Flop
Seat 2: 14627bc6 folded before Flop
Seat 3: 3bcd4d55 folded before Flop
Seat 4: d3e04f5d folded before Flop
Seat 5: c392ea8c folded before Flop
Seat 6: 8c9120dd (button) collected (1,480)
Seat 7: Hero (small blind) folded before Flop
Seat 8: 92ef8cd8 (big blind) folded before Flop


Poker Hand #TM3547325178: Tournament #156323098, Bounty Hunters $1.08 Hold'em No Limit - Level8(200/400) - 2024/08/03 23:26:33
Table '2' 8-max Seat #5 is the button
Seat 1: cfd75398 (18,321 in chips)
Seat 2: 14627bc6 (41,102 in chips)
Seat 3: 3bcd4d55 (8,282 in chips)
Seat 4: d3e04f5d (27,989 in chips)
Seat 5: c392ea8c (18,285 in chips)
Seat 6: 8c9120dd (99,700 in chips)
Seat 7: Hero (26,149 in chips)
Seat 8: f6c844be (10,077 in chips)
cfd75398: posts the ante 60
c392ea8c: posts the ante 60
3bcd4d55: posts the ante 60
f6c844be: posts the ante 60
14627bc6: posts the ante 60
8c9120dd: posts the ante 60
d3e04f5d: posts the ante 60
Hero: posts the ante 60
8c9120dd: posts small blind 200
Hero: posts big blind 400
*** HOLE CARDS ***
Dealt to cfd75398 
Dealt to 14627bc6 
Dealt to 3bcd4d55 
Dealt to d3e04f5d 
Dealt to c392ea8c 
Dealt to 8c9120dd 
Dealt to Hero [9s 4d]
Dealt to f6c844be 
f6c844be: raises 400 to 800
cfd75398: folds
14627bc6: folds
3bcd4d55: folds
d3e04f5d: calls 800
c392ea8c: calls 800
8c9120dd: calls 600
Hero: calls 400
*** FLOP *** [Kd Js 5d]
8c9120dd: checks
Hero: checks
f6c844be: checks
d3e04f5d: checks
c392ea8c: checks
*** TURN *** [Kd Js 5d] [3h]
8c9120dd: bets 3,360
Hero: folds
f6c844be: raises 5,857 to 9,217 and is all-in
d3e04f5d: folds
c392ea8c: folds
8c9120dd: calls 5,857
f6c844be: shows [4h 5s] (Pair of Fives)
8c9120dd: shows [Ks Jd] (Pair of Kings and Pair of Jacks)
*** RIVER *** [Kd Js 5d 3h] [Kc]
Hero: shows [9s] (Pair of Kings)
*** SHOWDOWN ***
8c9120dd collected 22,914 from pot
*** SUMMARY ***
Total pot 22,914 | Rake 0 | Jackpot 0 | Bingo 0 | Fortune 0 | Tax 0
Board [Kd Js 5d 3h Kc]
Seat 1: cfd75398 folded before Flop
Seat 2: 14627bc6 folded before Flop
Seat 3: 3bcd4d55 folded before Flop
Seat 4: d3e04f5d folded on the Turn
Seat 5: c392ea8c (button) folded on the Turn
Seat 6: 8c9120dd (small blind) showed [Ks Jd] and won (22,914) with Kings Full over Jacks
Seat 7: Hero (big blind) folded on the Turn
Seat 8: f6c844be showed [4h 5s] and lost with Pair of Kings and Pair of Fives


Poker Hand #TM3547325135: Tournament #156323098, Bounty Hunters $1.08 Hold'em No Limit - Level8(200/400) - 2024/08/03 23:25:56
Table '2' 8-max Seat #4 is the button
Seat 1: cfd75398 (16,101 in chips)
Seat 2: 14627bc6 (41,162 in chips)
Seat 3: 3bcd4d55 (9,142 in chips)
Seat 4: d3e04f5d (28,049 in chips)
Seat 5: c392ea8c (18,545 in chips)
Seat 6: 8c9120dd (100,560 in chips)
Seat 7: Hero (26,209 in chips)
Seat 8: f6c844be (10,137 in chips)
cfd75398: posts the ante 60
3bcd4d55: posts the ante 60
c392ea8c: posts the ante 60
f6c844be: posts the ante 60
14627bc6: posts the ante 60
8c9120dd: posts the ante 60
d3e04f5d: posts the ante 60
Hero: posts the ante 60
c392ea8c: posts small blind 200
8c9120dd: posts big blind 400
*** HOLE CARDS ***
Dealt to cfd75398 
Dealt to 14627bc6 
Dealt to 3bcd4d55 
Dealt to d3e04f5d 
Dealt to c392ea8c 
Dealt to 8c9120dd 
Dealt to Hero [Kh 2c]
Dealt to f6c844be 
Hero: folds
f6c844be: folds
cfd75398: raises 400 to 800
14627bc6: folds
3bcd4d55: calls 800
d3e04f5d: folds
c392ea8c: folds
8c9120dd: calls 400
*** FLOP *** [Kd Ks 7h]
8c9120dd: checks
cfd75398: bets 800
3bcd4d55: folds
8c9120dd: folds
Uncalled bet (800) returned to cfd75398
Hero: shows [Kh]
*** SHOWDOWN ***
cfd75398 collected 3,080 from pot
*** SUMMARY ***
Total pot 3,080 | Rake 0 | Jackpot 0 | Bingo 0 | Fortune 0 | Tax 0
Board [Kd Ks 7h]
Seat 1: cfd75398 won (3,080)
Seat 2: 14627bc6 folded before Flop
Seat 3: 3bcd4d55 folded on the Flop
Seat 4: d3e04f5d (button) folded before Flop
Seat 5: c392ea8c (small blind) folded before Flop
Seat 6: 8c9120dd (big blind) folded on the Flop
Seat 7: Hero folded before Flop
Seat 8: f6c844be folded before Flop


Poker Hand #TM3547325054: Tournament #156323098, Bounty Hunters $1.08 Hold'em No Limit - Level7(175/350) - 2024/08/03 23:24:46
Table '2' 8-max Seat #3 is the button
Seat 1: cfd75398 (16,151 in chips)
Seat 2: 14627bc6 (41,212 in chips)
Seat 3: 3bcd4d55 (9,192 in chips)
Seat 4: d3e04f5d (28,274 in chips)
Seat 5: c392ea8c (18,945 in chips)
Seat 6: 8c9120dd (99,272 in chips)
Seat 7: Hero (28,009 in chips)
Seat 8: f6c844be (8,850 in chips)
cfd75398: posts the ante 50
3bcd4d55: posts the ante 50
c392ea8c: posts the ante 50
f6c844be: posts the ante 50
14627bc6: posts the ante 50
8c9120dd: posts the ante 50
d3e04f5d: posts the ante 50
Hero: posts the ante 50
d3e04f5d: posts small blind 175
c392ea8c: posts big blind 350
*** HOLE CARDS ***
Dealt to cfd75398 
Dealt to 14627bc6 
Dealt to 3bcd4d55 
Dealt to d3e04f5d 
Dealt to c392ea8c 
Dealt to 8c9120dd 
Dealt to Hero [8h 9s]
Dealt to f6c844be 
8c9120dd: raises 700 to 1,050
Hero: calls 1,050
f6c844be: calls 1,050
cfd75398: folds
14627bc6: folds
3bcd4d55: folds
d3e04f5d: folds
c392ea8c: folds
*** FLOP *** [Jc 4h 3h]
8c9120dd: checks
Hero: checks
f6c844be: checks
*** TURN *** [Jc 4h 3h] [7d]
8c9120dd: bets 700
Hero: calls 700
f6c844be: calls 700
*** RIVER *** [Jc 4h 3h 7d] [7h]
8c9120dd: bets 6,175
Hero: folds
f6c844be: raises 875 to 7,050 and is all-in
8c9120dd: calls 875
f6c844be: shows [7c 8d] (Three Sevens)
8c9120dd: shows [8s 7s] (Three Sevens)
*** SHOWDOWN ***
f6c844be collected 10,137 from pot
8c9120dd collected 10,138 from pot
*** SUMMARY ***
Total pot 20,275 | Rake 0 | Jackpot 0 | Bingo 0 | Fortune 0 | Tax 0
Board [Jc 4h 3h 7d 7h]
Seat 1: cfd75398 folded before Flop
Seat 2: 14627bc6 folded before Flop
Seat 3: 3bcd4d55 (button) folded before Flop
Seat 4: d3e04f5d (small blind) folded before Flop
Seat 5: c392ea8c (big blind) folded before Flop
Seat 6: 8c9120dd showed [8s 7s] and won (10,138) with Three Sevens
Seat 7: Hero folded on the River
Seat 8: f6c844be showed [7c 8d] and won (10,137) with Three Sevens


Poker Hand #TM3547324989: Tournament #156323098, Bounty Hunters $1.08 Hold'em No Limit - Level7(175/350) - 2024/08/03 23:23:50
Table '2' 8-max Seat #2 is the button
Seat 1: cfd75398 (16,201 in chips)
Seat 2: 14627bc6 (41,262 in chips)
Seat 3: 3bcd4d55 (9,417 in chips)
Seat 4: d3e04f5d (28,674 in chips)
Seat 5: c392ea8c (18,995 in chips)
Seat 6: 8c9120dd (97,347 in chips)
Seat 7: Hero (28,059 in chips)
Seat 8: f6c844be (9,950 in chips)
cfd75398: posts the ante 50
c392ea8c: posts the ante 50
3bcd4d55: posts the ante 50
f6c844be: posts the ante 50
14627bc6: posts the ante 50
8c9120dd: posts the ante 50
d3e04f5d: posts the ante 50
Hero: posts the ante 50
3bcd4d55: posts small blind 175
d3e04f5d: posts big blind 350
*** HOLE CARDS ***
Dealt to cfd75398 
Dealt to 14627bc6 
Dealt to 3bcd4d55 
Dealt to d3e04f5d 
Dealt to c392ea8c 
Dealt to 8c9120dd 
Dealt to Hero [4h Jc]
Dealt to f6c844be 
c392ea8c: folds
8c9120dd: raises 700 to 1,050
Hero: folds
f6c844be: calls 1,050
cfd75398: folds
14627bc6: folds
3bcd4d55: folds
d3e04f5d: folds
*** FLOP *** [8s 4c Ks]
8c9120dd: checks
f6c844be: checks
*** TURN *** [8s 4c Ks] [6h]
8c9120dd: bets 1,050
f6c844be: folds
Uncalled bet (1,050) returned to 8c9120dd
*** SHOWDOWN ***
8c9120dd collected 3,025 from pot
*** SUMMARY ***
Total pot 3,025 | Rake 0 | Jackpot 0 | Bingo 0 | Fortune 0 | Tax 0
Board [8s 4c Ks 6h]
Seat 1: cfd75398 folded before Flop
Seat 2: 14627bc6 (button) folded before Flop
Seat 3: 3bcd4d55 (small blind) folded before Flop
Seat 4: d3e04f5d (big blind) folded before Flop
Seat 5: c392ea8c folded before Flop
Seat 6: 8c9120dd won (3,025)
Seat 7: Hero folded before Flop
Seat 8: f6c844be folded on the Turn


Poker Hand #TM3547324901: Tournament #156323098, Bounty Hunters $1.08 Hold'em No Limit - Level7(175/350) - 2024/08/03 23:22:46
Table '2' 8-max Seat #1 is the button
Seat 1: cfd75398 (16,251 in chips)
Seat 2: 14627bc6 (41,487 in chips)
Seat 3: 3bcd4d55 (10,167 in chips)
Seat 4: d3e04f5d (28,724 in chips)
Seat 5: c392ea8c (19,045 in chips)
Seat 6: 8c9120dd (96,122 in chips)
Seat 7: Hero (28,109 in chips)
Seat 8: f6c844be (10,000 in chips)
cfd75398: posts the ante 50
c392ea8c: posts the ante 50
3bcd4d55: posts the ante 50
f6c844be: posts the ante 50
8c9120dd: posts the ante 50
14627bc6: posts the ante 50
d3e04f5d: posts the ante 50
Hero: posts the ante 50
14627bc6: posts small blind 175
3bcd4d55: posts big blind 350
*** HOLE CARDS ***
Dealt to cfd75398 
Dealt to 14627bc6 
Dealt to 3bcd4d55 
Dealt to d3e04f5d 
Dealt to c392ea8c 
Dealt to 8c9120dd 
Dealt to Hero [Qc 3d]
Dealt to f6c844be 
d3e04f5d: folds
c392ea8c: folds
8c9120dd: raises 350 to 700
Hero: folds
f6c844be: folds
cfd75398: folds
14627bc6: folds
3bcd4d55: calls 350
*** FLOP *** [4c Ks Ah]
3bcd4d55: checks
8c9120dd: bets 988
3bcd4d55: folds
Uncalled bet (988) returned to 8c9120dd
f6c844be: shows [4d Kh] (Pair of Kings and Pair of Fours)
*** SHOWDOWN ***
8c9120dd collected 1,975 from pot
*** SUMMARY ***
Total pot 1,975 | Rake 0 | Jackpot 0 | Bingo 0 | Fortune 0 | Tax 0
Board [4c Ks Ah]
Seat 1: cfd75398 (button) folded before Flop
Seat 2: 14627bc6 (small blind) folded before Flop
Seat 3: 3bcd4d55 (big blind) folded on the Flop
Seat 4: d3e04f5d folded before Flop
Seat 5: c392ea8c folded before Flop
Seat 6: 8c9120dd won (1,975)
Seat 7: Hero folded before Flop
Seat 8: f6c844be folded before Flop


Poker Hand #TM3547324821: Tournament #156323098, Bounty Hunters $1.08 Hold'em No Limit - Level7(175/350) - 2024/08/03 23:21:35
Table '2' 8-max Seat #7 is the button
Seat 1: cfd75398 (16,476 in chips)
Seat 2: 14627bc6 (41,887 in chips)
Seat 3: 3bcd4d55 (10,217 in chips)
Seat 4: d3e04f5d (29,474 in chips)
Seat 5: c392ea8c (19,095 in chips)
Seat 6: 8c9120dd (91,285 in chips)
Seat 7: Hero (31,471 in chips)
cfd75398: posts the ante 50
c392ea8c: posts the ante 50
3bcd4d55: posts the ante 50
8c9120dd: posts the ante 50
14627bc6: posts the ante 50
d3e04f5d: posts the ante 50
Hero: posts the ante 50
cfd75398: posts small blind 175
14627bc6: posts big blind 350
*** HOLE CARDS ***
Dealt to cfd75398 
Dealt to 14627bc6 
Dealt to 3bcd4d55 
Dealt to d3e04f5d 
Dealt to c392ea8c 
Dealt to 8c9120dd 
Dealt to Hero [7h Td]
3bcd4d55: folds
d3e04f5d: raises 350 to 700
c392ea8c: folds
8c9120dd: calls 700
Hero: calls 700
cfd75398: folds
14627bc6: folds
*** FLOP *** [7d As 5d]
d3e04f5d: checks
8c9120dd: checks
Hero: bets 982
d3e04f5d: folds
8c9120dd: calls 982
*** TURN *** [7d As 5d] [3h]
8c9120dd: checks
Hero: bets 1,630
8c9120dd: calls 1,630
*** RIVER *** [7d As 5d 3h] [2d]
8c9120dd: checks
Hero: checks
8c9120dd: shows [5s 5h] (Three Fives)
Hero: shows [7h Td] (Pair of Sevens)
*** SHOWDOWN ***
8c9120dd collected 8,199 from pot
*** SUMMARY ***
Total pot 8,199 | Rake 0 | Jackpot 0 | Bingo 0 | Fortune 0 | Tax 0
Board [7d As 5d 3h 2d]
Seat 1: cfd75398 (small blind) folded before Flop
Seat 2: 14627bc6 (big blind) folded before Flop
Seat 3: 3bcd4d55 folded before Flop
Seat 4: d3e04f5d folded on the Flop
Seat 5: c392ea8c folded before Flop
Seat 6: 8c9120dd showed [5s 5h] and won (8,199) with Three Fives
Seat 7: Hero (button) showed [7h Td] and lost with Pair of Sevens


Poker Hand #TM3547324717: Tournament #156323098, Bounty Hunters $1.08 Hold'em No Limit - Level7(175/350) - 2024/08/03 23:19:57
Table '2' 8-max Seat #6 is the button
Seat 1: cfd75398 (16,876 in chips)
Seat 2: 14627bc6 (41,937 in chips)
Seat 3: 3bcd4d55 (10,267 in chips)
Seat 4: d3e04f5d (29,524 in chips)
Seat 5: c392ea8c (14,945 in chips)
Seat 6: 8c9120dd (93,085 in chips)
Seat 7: Hero (33,271 in chips)
cfd75398: posts the ante 50
c392ea8c: posts the ante 50
3bcd4d55: posts the ante 50
8c9120dd: posts the ante 50
14627bc6: posts the ante 50
d3e04f5d: posts the ante 50
Hero: posts the ante 50
Hero: posts small blind 175
cfd75398: posts big blind 350
*** HOLE CARDS ***
Dealt to cfd75398 
Dealt to 14627bc6 
Dealt to 3bcd4d55 
Dealt to d3e04f5d 
Dealt to c392ea8c 
Dealt to 8c9120dd 
Dealt to Hero [9d Kh]
14627bc6: folds
3bcd4d55: folds
d3e04f5d: folds
c392ea8c: raises 350 to 700
8c9120dd: calls 700
Hero: calls 525
cfd75398: folds
*** FLOP *** [6h Tc 9c]
Hero: checks
c392ea8c: checks
8c9120dd: checks
*** TURN *** [6h Tc 9c] [Qh]
Hero: checks
c392ea8c: checks
8c9120dd: bets 1,050
Hero: calls 1,050
c392ea8c: calls 1,050
*** RIVER *** [6h Tc 9c Qh] [Ad]
Hero: checks
c392ea8c: checks
8c9120dd: checks
Hero: shows [9d Kh] (Pair of Nines)
c392ea8c: shows [Ac 3c] (Pair of Aces)
8c9120dd: shows [6d 5d] (Pair of Sixes)
*** SHOWDOWN ***
c392ea8c collected 5,950 from pot
*** SUMMARY ***
Total pot 5,950 | Rake 0 | Jackpot 0 | Bingo 0 | Fortune 0 | Tax 0
Board [6h Tc 9c Qh Ad]
Seat 1: cfd75398 (big blind) folded before Flop
Seat 2: 14627bc6 folded before Flop
Seat 3: 3bcd4d55 folded before Flop
Seat 4: d3e04f5d folded before Flop
Seat 5: c392ea8c showed [Ac 3c] and won (5,950) with Pair of Aces
Seat 6: 8c9120dd (button) showed [6d 5d] and lost with Pair of Sixes
Seat 7: Hero (small blind) showed [9d Kh] and lost with Pair of Nines


Poker Hand #TM3547324622: Tournament #156323098, Bounty Hunters $1.08 Hold'em No Limit - Level7(175/350) - 2024/08/03 23:18:44
Table '2' 8-max Seat #5 is the button
Seat 1: cfd75398 (16,926 in chips)
Seat 2: 14627bc6 (41,987 in chips)
Seat 3: 3bcd4d55 (10,317 in chips)
Seat 4: d3e04f5d (29,574 in chips)
Seat 5: c392ea8c (14,995 in chips)
Seat 6: 8c9120dd (62,393 in chips)
Seat 7: Hero (33,671 in chips)
Seat 8: 4f506b4 (30,042 in chips)
cfd75398: posts the ante 50
c392ea8c: posts the ante 50
3bcd4d55: posts the ante 50
4f506b4: posts the ante 50
14627bc6: posts the ante 50
8c9120dd: posts the ante 50
d3e04f5d: posts the ante 50
Hero: posts the ante 50
8c9120dd: posts small blind 175
Hero: posts big blind 350
*** HOLE CARDS ***
Dealt to cfd75398 
Dealt to 14627bc6 
Dealt to 3bcd4d55 
Dealt to d3e04f5d 
Dealt to c392ea8c 
Dealt to 8c9120dd 
Dealt to Hero [4d 4s]
Dealt to 4f506b4 
4f506b4: raises 1,275 to 1,625
cfd75398: folds
14627bc6: folds
3bcd4d55: folds
d3e04f5d: folds
c392ea8c: folds
8c9120dd: raises 60,718 to 62,343 and is all-in
Hero: folds
4f506b4: calls 28,367 and is all-in
Uncalled bet (32,351) returned to 8c9120dd
8c9120dd: shows [Td Ts]
4f506b4: shows [4c Ac]
*** FLOP *** [2d 7h 5h]
*** TURN *** [2d 7h 5h] [6d]
*** RIVER *** [2d 7h 5h 6d] [4h]
Hero: shows [4d 4s] (Three Fours)
*** SHOWDOWN ***
8c9120dd collected 60,734 from pot
*** SUMMARY ***
Total pot 60,734 | Rake 0 | Jackpot 0 | Bingo 0 | Fortune 0 | Tax 0
Board [2d 7h 5h 6d 4h]
Seat 1: cfd75398 folded before Flop
Seat 2: 14627bc6 folded before Flop
Seat 3: 3bcd4d55 folded before Flop
Seat 4: d3e04f5d folded before Flop
Seat 5: c392ea8c (button) folded before Flop
Seat 6: 8c9120dd (small blind) showed [Td Ts] and won (60,734) with Pair of Tens
Seat 7: Hero (big blind) folded before Flop
Seat 8: 4f506b4 showed [4c Ac] and lost with Pair of Fours


Poker Hand #TM3547324551: Tournament #156323098, Bounty Hunters $1.08 Hold'em No Limit - Level6(150/300) - 2024/08/03 23:17:46
Table '2' 8-max Seat #4 is the button
Seat 1: cfd75398 (16,971 in chips)
Seat 2: 2a0eef47 (13,112 in chips)
Seat 3: 3bcd4d55 (10,362 in chips)
Seat 4: d3e04f5d (29,619 in chips)
Seat 5: c392ea8c (15,190 in chips)
Seat 6: 8c9120dd (48,861 in chips)
Seat 7: Hero (33,716 in chips)
Seat 8: 4f506b4 (30,087 in chips)
cfd75398: posts the ante 45
3bcd4d55: posts the ante 45
c392ea8c: posts the ante 45
2a0eef47: posts the ante 45
4f506b4: posts the ante 45
8c9120dd: posts the ante 45
d3e04f5d: posts the ante 45
Hero: posts the ante 45
c392ea8c: posts small blind 150
8c9120dd: posts big blind 300
*** HOLE CARDS ***
Dealt to cfd75398 
Dealt to 2a0eef47 
Dealt to 3bcd4d55 
Dealt to d3e04f5d 
Dealt to c392ea8c 
Dealt to 8c9120dd 
Dealt to Hero [4h 9d]
Dealt to 4f506b4 
Hero: folds
4f506b4: folds
cfd75398: folds
2a0eef47: raises 300 to 600
3bcd4d55: folds
d3e04f5d: folds
c392ea8c: folds
8c9120dd: calls 300
*** FLOP *** [Kh 5d 4d]
8c9120dd: checks
2a0eef47: bets 565
8c9120dd: raises 865 to 1,430
2a0eef47: calls 865
*** TURN *** [Kh 5d 4d] [Kd]
8c9120dd: checks
2a0eef47: bets 3,428
8c9120dd: raises 11,426 to 14,854
2a0eef47: calls 7,609 and is all-in
Uncalled bet (3,817) returned to 8c9120dd
8c9120dd: shows [2s Kc] (Three Kings)
2a0eef47: shows [Qh Qd] (Pair of Kings and Pair of Queens)
*** RIVER *** [Kh 5d 4d Kd] [5s]
*** SHOWDOWN ***
8c9120dd collected 26,644 from pot
*** SUMMARY ***
Total pot 26,644 | Rake 0 | Jackpot 0 | Bingo 0 | Fortune 0 | Tax 0
Board [Kh 5d 4d Kd 5s]
Seat 1: cfd75398 folded before Flop
Seat 2: 2a0eef47 showed [Qh Qd] and lost with Pair of Kings and Pair of Queens
Seat 3: 3bcd4d55 folded before Flop
Seat 4: d3e04f5d (button) folded before Flop
Seat 5: c392ea8c (small blind) folded before Flop
Seat 6: 8c9120dd (big blind) showed [2s Kc] and won (26,644) with Kings Full over Fives
Seat 7: Hero folded before Flop
Seat 8: 4f506b4 folded before Flop


Poker Hand #TM3547324466: Tournament #156323098, Bounty Hunters $1.08 Hold'em No Limit - Level6(150/300) - 2024/08/03 23:16:36
Table '2' 8-max Seat #3 is the button
Seat 1: cfd75398 (17,016 in chips)
Seat 2: 2a0eef47 (13,157 in chips)
Seat 3: 3bcd4d55 (10,407 in chips)
Seat 4: d3e04f5d (29,814 in chips)
Seat 5: c392ea8c (6,935 in chips)
Seat 6: 8c9120dd (48,906 in chips)
Seat 7: Hero (40,651 in chips)
Seat 8: 4f506b4 (31,032 in chips)
cfd75398: posts the ante 45
3bcd4d55: posts the ante 45
c392ea8c: posts the ante 45
2a0eef47: posts the ante 45
4f506b4: posts the ante 45
8c9120dd: posts the ante 45
d3e04f5d: posts the ante 45
Hero: posts the ante 45
d3e04f5d: posts small blind 150
c392ea8c: posts big blind 300
*** HOLE CARDS ***
Dealt to cfd75398 
Dealt to 2a0eef47 
Dealt to 3bcd4d55 
Dealt to d3e04f5d 
Dealt to c392ea8c 
Dealt to 8c9120dd 
Dealt to Hero [Qh Qs]
Dealt to 4f506b4 
8c9120dd: folds
Hero: raises 600 to 900
4f506b4: calls 900
cfd75398: folds
2a0eef47: folds
3bcd4d55: folds
d3e04f5d: folds
c392ea8c: calls 600
*** FLOP *** [Ah 9d 4h]
c392ea8c: checks
Hero: checks
4f506b4: checks
*** TURN *** [Ah 9d 4h] [2h]
c392ea8c: bets 1,605
Hero: calls 1,605
4f506b4: folds
*** RIVER *** [Ah 9d 4h 2h] [8d]
c392ea8c: bets 4,385 and is all-in
Hero: calls 4,385
c392ea8c: shows [9h Th] (Ace High Flush)
Hero: shows [Qh Qs] (Pair of Queens)
*** SHOWDOWN ***
c392ea8c collected 15,190 from pot
*** SUMMARY ***
Total pot 15,190 | Rake 0 | Jackpot 0 | Bingo 0 | Fortune 0 | Tax 0
Board [Ah 9d 4h 2h 8d]
Seat 1: cfd75398 folded before Flop
Seat 2: 2a0eef47 folded before Flop
Seat 3: 3bcd4d55 (button) folded before Flop
Seat 4: d3e04f5d (small blind) folded before Flop
Seat 5: c392ea8c (big blind) showed [9h Th] and won (15,190) with Ace High Flush
Seat 6: 8c9120dd folded before Flop
Seat 7: Hero showed [Qh Qs] and lost with Pair of Queens
Seat 8: 4f506b4 folded on the Turn


Poker Hand #TM3547324385: Tournament #156323098, Bounty Hunters $1.08 Hold'em No Limit - Level6(150/300) - 2024/08/03 23:15:26
Table '2' 8-max Seat #2 is the button
Seat 1: cfd75398 (17,061 in chips)
Seat 2: 2a0eef47 (13,202 in chips)
Seat 3: 3bcd4d55 (9,492 in chips)
Seat 4: d3e04f5d (30,159 in chips)
Seat 5: c392ea8c (6,980 in chips)
Seat 6: 8c9120dd (48,951 in chips)
Seat 7: Hero (40,696 in chips)
Seat 8: 4f506b4 (31,377 in chips)
cfd75398: posts the ante 45
c392ea8c: posts the ante 45
3bcd4d55: posts the ante 45
2a0eef47: posts the ante 45
4f506b4: posts the ante 45
8c9120dd: posts the ante 45
d3e04f5d: posts the ante 45
Hero: posts the ante 45
3bcd4d55: posts small blind 150
d3e04f5d: posts big blind 300
*** HOLE CARDS ***
Dealt to cfd75398 
Dealt to 2a0eef47 
Dealt to 3bcd4d55 
Dealt to d3e04f5d 
Dealt to c392ea8c 
Dealt to 8c9120dd 
Dealt to Hero [Ks 7c]
Dealt to 4f506b4 
c392ea8c: folds
8c9120dd: folds
Hero: folds
4f506b4: calls 300
cfd75398: folds
2a0eef47: folds
3bcd4d55: calls 150
d3e04f5d: checks
*** FLOP *** [6h Ts Kh]
3bcd4d55: checks
d3e04f5d: checks
4f506b4: checks
*** TURN *** [6h Ts Kh] [Kc]
3bcd4d55: checks
d3e04f5d: checks
4f506b4: checks
*** RIVER *** [6h Ts Kh Kc] [7d]
3bcd4d55: checks
d3e04f5d: checks
4f506b4: checks
3bcd4d55: shows [Ac 3s] (Pair of Kings)
d3e04f5d: shows [Qh 8s] (Pair of Kings)
4f506b4: shows [9d Js] (Pair of Kings)
*** SHOWDOWN ***
3bcd4d55 collected 1,260 from pot
*** SUMMARY ***
Total pot 1,260 | Rake 0 | Jackpot 0 | Bingo 0 | Fortune 0 | Tax 0
Board [6h Ts Kh Kc 7d]
Seat 1: cfd75398 folded before Flop
Seat 2: 2a0eef47 (button) folded before Flop
Seat 3: 3bcd4d55 (small blind) showed [Ac 3s] and won (1,260) with Pair of Kings
Seat 4: d3e04f5d (big blind) showed [Qh 8s] and lost with Pair of Kings
Seat 5: c392ea8c folded before Flop
Seat 6: 8c9120dd folded before Flop
Seat 7: Hero folded before Flop
Seat 8: 4f506b4 showed [9d Js] and lost with Pair of Kings


Poker Hand #TM3547324289: Tournament #156323098, Bounty Hunters $1.08 Hold'em No Limit - Level6(150/300) - 2024/08/03 23:14:15
Table '2' 8-max Seat #1 is the button
Seat 1: cfd75398 (17,106 in chips)
Seat 2: 2a0eef47 (13,397 in chips)
Seat 3: 3bcd4d55 (10,900 in chips)
Seat 4: d3e04f5d (30,204 in chips)
Seat 5: c392ea8c (7,025 in chips)
Seat 6: 8c9120dd (51,877 in chips)
Seat 7: Hero (35,987 in chips)
Seat 8: 4f506b4 (31,422 in chips)
cfd75398: posts the ante 45
c392ea8c: posts the ante 45
3bcd4d55: posts the ante 45
2a0eef47: posts the ante 45
4f506b4: posts the ante 45
8c9120dd: posts the ante 45
d3e04f5d: posts the ante 45
Hero: posts the ante 45
2a0eef47: posts small blind 150
3bcd4d55: posts big blind 300
*** HOLE CARDS ***
Dealt to cfd75398 
Dealt to 2a0eef47 
Dealt to 3bcd4d55 
Dealt to d3e04f5d 
Dealt to c392ea8c 
Dealt to 8c9120dd 
Dealt to Hero [Kd 8d]
Dealt to 4f506b4 
d3e04f5d: folds
c392ea8c: folds
8c9120dd: raises 300 to 600
Hero: calls 600
4f506b4: folds
cfd75398: folds
2a0eef47: folds
3bcd4d55: calls 300
*** FLOP *** [Th 9h Ks]
3bcd4d55: checks
8c9120dd: bets 763
Hero: calls 763
3bcd4d55: calls 763
*** TURN *** [Th 9h Ks] [Qs]
3bcd4d55: checks
8c9120dd: checks
Hero: checks
*** RIVER *** [Th 9h Ks Qs] [6c]
3bcd4d55: checks
8c9120dd: checks
Hero: bets 1,518
3bcd4d55: folds
8c9120dd: calls 1,518
Hero: shows [Kd 8d] (Pair of Kings)
8c9120dd: shows [Qd 4d] (Pair of Queens)
*** SHOWDOWN ***
Hero collected 7,635 from pot
*** SUMMARY ***
Total pot 7,635 | Rake 0 | Jackpot 0 | Bingo 0 | Fortune 0 | Tax 0
Board [Th 9h Ks Qs 6c]
Seat 1: cfd75398 (button) folded before Flop
Seat 2: 2a0eef47 (small blind) folded before Flop
Seat 3: 3bcd4d55 (big blind) folded on the River
Seat 4: d3e04f5d folded before Flop
Seat 5: c392ea8c folded before Flop
Seat 6: 8c9120dd showed [Qd 4d] and lost with Pair of Queens
Seat 7: Hero showed [Kd 8d] and won (7,635) with Pair of Kings
Seat 8: 4f506b4 folded before Flop


Poker Hand #TM3547324228: Tournament #156323098, Bounty Hunters $1.08 Hold'em No Limit - Level6(150/300) - 2024/08/03 23:13:26
Table '2' 8-max Seat #8 is the button
Seat 1: cfd75398 (17,301 in chips)
Seat 2: 2a0eef47 (12,332 in chips)
Seat 3: 3bcd4d55 (10,945 in chips)
Seat 4: d3e04f5d (30,249 in chips)
Seat 5: c392ea8c (7,670 in chips)
Seat 6: 8c9120dd (51,922 in chips)
Seat 7: Hero (36,032 in chips)
Seat 8: 4f506b4 (31,467 in chips)
cfd75398: posts the ante 45
c392ea8c: posts the ante 45
3bcd4d55: posts the ante 45
2a0eef47: posts the ante 45
4f506b4: posts the ante 45
8c9120dd: posts the ante 45
d3e04f5d: posts the ante 45
Hero: posts the ante 45
cfd75398: posts small blind 150
2a0eef47: posts big blind 300
*** HOLE CARDS ***
Dealt to cfd75398 
Dealt to 2a0eef47 
Dealt to 3bcd4d55 
Dealt to d3e04f5d 
Dealt to c392ea8c 
Dealt to 8c9120dd 
Dealt to Hero [7s Kc]
Dealt to 4f506b4 
3bcd4d55: folds
d3e04f5d: folds
c392ea8c: raises 300 to 600
8c9120dd: folds
Hero: folds
4f506b4: folds
cfd75398: folds
2a0eef47: calls 300
*** FLOP *** [3s 4c 5h]
2a0eef47: checks
c392ea8c: checks
*** TURN *** [3s 4c 5h] [6h]
2a0eef47: checks
c392ea8c: checks
*** RIVER *** [3s 4c 5h 6h] [9d]
2a0eef47: checks
c392ea8c: checks
2a0eef47: shows [Ad Jh] (Ace-High)
c392ea8c: shows [Qc Kd] (King-High)
*** SHOWDOWN ***
2a0eef47 collected 1,710 from pot
*** SUMMARY ***
Total pot 1,710 | Rake 0 | Jackpot 0 | Bingo 0 | Fortune 0 | Tax 0
Board [3s 4c 5h 6h 9d]
Seat 1: cfd75398 (small blind) folded before Flop
Seat 2: 2a0eef47 (big blind) showed [Ad Jh] and won (1,710) with Ace-High
Seat 3: 3bcd4d55 folded before Flop
Seat 4: d3e04f5d folded before Flop
Seat 5: c392ea8c showed [Qc Kd] and lost with King-High
Seat 6: 8c9120dd folded before Flop
Seat 7: Hero folded before Flop
Seat 8: 4f506b4 (button) folded before Flop


Poker Hand #TM3547324171: Tournament #156323098, Bounty Hunters $1.08 Hold'em No Limit - Level6(150/300) - 2024/08/03 23:12:35
Table '2' 8-max Seat #7 is the button
Seat 1: cfd75398 (17,646 in chips)
Seat 2: 2a0eef47 (12,377 in chips)
Seat 3: 3bcd4d55 (10,990 in chips)
Seat 4: d3e04f5d (31,824 in chips)
Seat 5: c392ea8c (7,715 in chips)
Seat 6: 8c9120dd (51,967 in chips)
Seat 7: Hero (36,077 in chips)
Seat 8: 4f506b4 (29,322 in chips)
cfd75398: posts the ante 45
c392ea8c: posts the ante 45
3bcd4d55: posts the ante 45
2a0eef47: posts the ante 45
4f506b4: posts the ante 45
8c9120dd: posts the ante 45
d3e04f5d: posts the ante 45
Hero: posts the ante 45
4f506b4: posts small blind 150
cfd75398: posts big blind 300
*** HOLE CARDS ***
Dealt to cfd75398 
Dealt to 2a0eef47 
Dealt to 3bcd4d55 
Dealt to d3e04f5d 
Dealt to c392ea8c 
Dealt to 8c9120dd 
Dealt to Hero [3s Td]
Dealt to 4f506b4 
2a0eef47: folds
3bcd4d55: folds
d3e04f5d: raises 300 to 600
c392ea8c: folds
8c9120dd: folds
Hero: folds
4f506b4: raises 930 to 1,530
cfd75398: folds
d3e04f5d: calls 930
*** FLOP *** [9h Jc Ah]
4f506b4: bets 3,720
d3e04f5d: folds
Uncalled bet (3,720) returned to 4f506b4
*** SHOWDOWN ***
4f506b4 collected 3,720 from pot
*** SUMMARY ***
Total pot 3,720 | Rake 0 | Jackpot 0 | Bingo 0 | Fortune 0 | Tax 0
Board [9h Jc Ah]
Seat 1: cfd75398 (big blind) folded before Flop
Seat 2: 2a0eef47 folded before Flop
Seat 3: 3bcd4d55 folded before Flop
Seat 4: d3e04f5d folded on the Flop
Seat 5: c392ea8c folded before Flop
Seat 6: 8c9120dd folded before Flop
Seat 7: Hero (button) folded before Flop
Seat 8: 4f506b4 (small blind) won (3,720)


Poker Hand #TM3547324109: Tournament #156323098, Bounty Hunters $1.08 Hold'em No Limit - Level6(150/300) - 2024/08/03 23:11:48
Table '2' 8-max Seat #5 is the button
Seat 1: cfd75398 (17,691 in chips)
Seat 2: 2a0eef47 (9,320 in chips)
Seat 3: 3bcd4d55 (11,035 in chips)
Seat 4: d3e04f5d (31,869 in chips)
Seat 5: c392ea8c (7,760 in chips)
Seat 7: Hero (36,722 in chips)
Seat 8: 4f506b4 (31,554 in chips)
cfd75398: posts the ante 45
c392ea8c: posts the ante 45
3bcd4d55: posts the ante 45
2a0eef47: posts the ante 45
4f506b4: posts the ante 45
d3e04f5d: posts the ante 45
Hero: posts the ante 45
Hero: posts small blind 150
4f506b4: posts big blind 300
*** HOLE CARDS ***
Dealt to cfd75398 
Dealt to 2a0eef47 
Dealt to 3bcd4d55 
Dealt to d3e04f5d 
Dealt to c392ea8c 
Dealt to Hero [6s 2d]
Dealt to 4f506b4 
cfd75398: folds
2a0eef47: raises 300 to 600
3bcd4d55: folds
d3e04f5d: folds
c392ea8c: folds
Hero: calls 450
4f506b4: calls 300
*** FLOP *** [Qc Ac 3s]
Hero: checks
4f506b4: checks
2a0eef47: bets 1,587
Hero: folds
4f506b4: calls 1,587
*** TURN *** [Qc Ac 3s] [5d]
4f506b4: checks
2a0eef47: bets 7,088 and is all-in
4f506b4: folds
Uncalled bet (7,088) returned to 2a0eef47
*** SHOWDOWN ***
2a0eef47 collected 5,289 from pot
*** SUMMARY ***
Total pot 5,289 | Rake 0 | Jackpot 0 | Bingo 0 | Fortune 0 | Tax 0
Board [Qc Ac 3s 5d]
Seat 1: cfd75398 folded before Flop
Seat 2: 2a0eef47 won (5,289)
Seat 3: 3bcd4d55 folded before Flop
Seat 4: d3e04f5d folded before Flop
Seat 5: c392ea8c (button) folded before Flop
Seat 7: Hero (small blind) folded on the Flop
Seat 8: 4f506b4 (big blind) folded on the Turn


Poker Hand #TM3547324038: Tournament #156323098, Bounty Hunters $1.08 Hold'em No Limit - Level5(125/250) - 2024/08/03 23:10:54
Table '2' 8-max Seat #4 is the button
Seat 1: cfd75398 (17,726 in chips)
Seat 2: 2a0eef47 (9,355 in chips)
Seat 3: 3bcd4d55 (11,070 in chips)
Seat 4: d3e04f5d (31,904 in chips)
Seat 5: c392ea8c (8,045 in chips)
Seat 7: Hero (38,003 in chips)
Seat 8: 4f506b4 (29,848 in chips)
cfd75398: posts the ante 35
3bcd4d55: posts the ante 35
c392ea8c: posts the ante 35
2a0eef47: posts the ante 35
4f506b4: posts the ante 35
d3e04f5d: posts the ante 35
Hero: posts the ante 35
c392ea8c: posts small blind 125
Hero: posts big blind 250
*** HOLE CARDS ***
Dealt to cfd75398 
Dealt to 2a0eef47 
Dealt to 3bcd4d55 
Dealt to d3e04f5d 
Dealt to c392ea8c 
Dealt to Hero [2d As]
Dealt to 4f506b4 
4f506b4: calls 250
cfd75398: folds
2a0eef47: folds
3bcd4d55: folds
d3e04f5d: folds
c392ea8c: calls 125
Hero: checks
*** FLOP *** [6d Ad 5s]
c392ea8c: checks
Hero: checks
4f506b4: checks
*** TURN *** [6d Ad 5s] [4c]
c392ea8c: checks
Hero: bets 498
4f506b4: raises 498 to 996
c392ea8c: folds
Hero: calls 498
*** RIVER *** [6d Ad 5s 4c] [Jc]
Hero: checks
4f506b4: bets 2,987
Hero: folds
Uncalled bet (2,987) returned to 4f506b4
Hero: shows [As] (Pair of Aces)
*** SHOWDOWN ***
4f506b4 collected 2,987 from pot
*** SUMMARY ***
Total pot 2,987 | Rake 0 | Jackpot 0 | Bingo 0 | Fortune 0 | Tax 0
Board [6d Ad 5s 4c Jc]
Seat 1: cfd75398 folded before Flop
Seat 2: 2a0eef47 folded before Flop
Seat 3: 3bcd4d55 folded before Flop
Seat 4: d3e04f5d (button) folded before Flop
Seat 5: c392ea8c (small blind) folded on the Turn
Seat 7: Hero (big blind) folded on the River
Seat 8: 4f506b4 won (2,987)


Poker Hand #TM3547323999: Tournament #156323098, Bounty Hunters $1.08 Hold'em No Limit - Level5(125/250) - 2024/08/03 23:10:22
Table '2' 8-max Seat #3 is the button
Seat 1: cfd75398 (17,761 in chips)
Seat 2: 2a0eef47 (9,390 in chips)
Seat 3: 3bcd4d55 (11,105 in chips)
Seat 4: d3e04f5d (32,064 in chips)
Seat 5: c392ea8c (8,330 in chips)
Seat 7: Hero (38,038 in chips)
Seat 8: 4f506b4 (29,263 in chips)
cfd75398: posts the ante 35
3bcd4d55: posts the ante 35
c392ea8c: posts the ante 35
2a0eef47: posts the ante 35
4f506b4: posts the ante 35
d3e04f5d: posts the ante 35
Hero: posts the ante 35
d3e04f5d: posts small blind 125
c392ea8c: posts big blind 250
*** HOLE CARDS ***
Dealt to cfd75398 
Dealt to 2a0eef47 
Dealt to 3bcd4d55 
Dealt to d3e04f5d 
Dealt to c392ea8c 
Dealt to Hero [Ks 5h]
Dealt to 4f506b4 
Hero: folds
4f506b4: raises 870 to 1,120
cfd75398: folds
2a0eef47: folds
3bcd4d55: folds
d3e04f5d: folds
c392ea8c: folds
Uncalled bet (870) returned to 4f506b4
*** SHOWDOWN ***
4f506b4 collected 870 from pot
*** SUMMARY ***
Total pot 870 | Rake 0 | Jackpot 0 | Bingo 0 | Fortune 0 | Tax 0
Seat 1: cfd75398 folded before Flop
Seat 2: 2a0eef47 folded before Flop
Seat 3: 3bcd4d55 (button) folded before Flop
Seat 4: d3e04f5d (small blind) folded before Flop
Seat 5: c392ea8c (big blind) folded before Flop
Seat 7: Hero folded before Flop
Seat 8: 4f506b4 collected (870)


Poker Hand #TM3547323923: Tournament #156323098, Bounty Hunters $1.08 Hold'em No Limit - Level5(125/250) - 2024/08/03 23:09:22
Table '2' 8-max Seat #2 is the button
Seat 1: cfd75398 (17,796 in chips)
Seat 2: 2a0eef47 (9,425 in chips)
Seat 3: 3bcd4d55 (11,265 in chips)
Seat 4: d3e04f5d (15,898 in chips)
Seat 5: c392ea8c (8,365 in chips)
Seat 6: 1daebb68 (15,831 in chips)
Seat 7: Hero (38,073 in chips)
Seat 8: 4f506b4 (29,298 in chips)
cfd75398: posts the ante 35
c392ea8c: posts the ante 35
3bcd4d55: posts the ante 35
2a0eef47: posts the ante 35
4f506b4: posts the ante 35
1daebb68: posts the ante 35
d3e04f5d: posts the ante 35
Hero: posts the ante 35
3bcd4d55: posts small blind 125
d3e04f5d: posts big blind 250
*** HOLE CARDS ***
Dealt to cfd75398 
Dealt to 2a0eef47 
Dealt to 3bcd4d55 
Dealt to d3e04f5d 
Dealt to c392ea8c 
Dealt to 1daebb68 
Dealt to Hero [3s Ad]
Dealt to 4f506b4 
c392ea8c: folds
1daebb68: raises 300 to 550
Hero: folds
4f506b4: folds
cfd75398: folds
2a0eef47: folds
3bcd4d55: folds
d3e04f5d: raises 700 to 1,250
1daebb68: calls 700
*** FLOP *** [Td 7c 5h]
d3e04f5d: bets 2,179
1daebb68: calls 2,179
*** TURN *** [Td 7c 5h] [5d]
d3e04f5d: bets 12,434 and is all-in
1daebb68: calls 12,367 and is all-in
Uncalled bet (67) returned to d3e04f5d
d3e04f5d: shows [Qd Qc] (Pair of Queens and Pair of Fives)
1daebb68: shows [Jd Js] (Pair of Jacks and Pair of Fives)
*** RIVER *** [Td 7c 5h 5d] [Qs]
*** SHOWDOWN ***
d3e04f5d collected 31,997 from pot
*** SUMMARY ***
Total pot 31,997 | Rake 0 | Jackpot 0 | Bingo 0 | Fortune 0 | Tax 0
Board [Td 7c 5h 5d Qs]
Seat 1: cfd75398 folded before Flop
Seat 2: 2a0eef47 (button) folded before Flop
Seat 3: 3bcd4d55 (small blind) folded before Flop
Seat 4: d3e04f5d (big blind) showed [Qd Qc] and won (31,997) with Queens Full over Fives
Seat 5: c392ea8c folded before Flop
Seat 6: 1daebb68 showed [Jd Js] and lost with Pair of Jacks and Pair of Fives
Seat 7: Hero folded before Flop
Seat 8: 4f506b4 folded before Flop


Poker Hand #TM3547323803: Tournament #156323098, Bounty Hunters $1.08 Hold'em No Limit - Level5(125/250) - 2024/08/03 23:07:46
Table '2' 8-max Seat #1 is the button
Seat 1: cfd75398 (16,301 in chips)
Seat 2: 2a0eef47 (9,585 in chips)
Seat 3: 3bcd4d55 (11,550 in chips)
Seat 4: d3e04f5d (15,933 in chips)
Seat 5: c392ea8c (8,400 in chips)
Seat 6: 1daebb68 (15,866 in chips)
Seat 7: Hero (38,108 in chips)
Seat 8: 4f506b4 (30,208 in chips)
cfd75398: posts the ante 35
c392ea8c: posts the ante 35
3bcd4d55: posts the ante 35
2a0eef47: posts the ante 35
4f506b4: posts the ante 35
1daebb68: posts the ante 35
d3e04f5d: posts the ante 35
Hero: posts the ante 35
2a0eef47: posts small blind 125
3bcd4d55: posts big blind 250
*** HOLE CARDS ***
Dealt to cfd75398 
Dealt to 2a0eef47 
Dealt to 3bcd4d55 
Dealt to d3e04f5d 
Dealt to c392ea8c 
Dealt to 1daebb68 
Dealt to Hero [Jh 5d]
Dealt to 4f506b4 
d3e04f5d: folds
c392ea8c: folds
1daebb68: folds
Hero: folds
4f506b4: calls 250
cfd75398: raises 625 to 875
2a0eef47: folds
3bcd4d55: folds
4f506b4: calls 625
*** FLOP *** [2c Js 4c]
4f506b4: checks
cfd75398: checks
*** TURN *** [2c Js 4c] [8c]
4f506b4: checks
cfd75398: checks
*** RIVER *** [2c Js 4c 8c] [5c]
4f506b4: checks
cfd75398: checks
4f506b4: shows [Ks 9d] (King-High)
cfd75398: shows [2d Qd] (Pair of Twos)
*** SHOWDOWN ***
cfd75398 collected 2,405 from pot
*** SUMMARY ***
Total pot 2,405 | Rake 0 | Jackpot 0 | Bingo 0 | Fortune 0 | Tax 0
Board [2c Js 4c 8c 5c]
Seat 1: cfd75398 (button) showed [2d Qd] and won (2,405) with Pair of Twos
Seat 2: 2a0eef47 (small blind) folded before Flop
Seat 3: 3bcd4d55 (big blind) folded before Flop
Seat 4: d3e04f5d folded before Flop
Seat 5: c392ea8c folded before Flop
Seat 6: 1daebb68 folded before Flop
Seat 7: Hero folded before Flop
Seat 8: 4f506b4 showed [Ks 9d] and lost with King-High


Poker Hand #TM3547323736: Tournament #156323098, Bounty Hunters $1.08 Hold'em No Limit - Level5(125/250) - 2024/08/03 23:07:01
Table '2' 8-max Seat #8 is the button
Seat 1: cfd75398 (16,461 in chips)
Seat 2: 2a0eef47 (9,870 in chips)
Seat 3: 3bcd4d55 (10,930 in chips)
Seat 4: d3e04f5d (15,968 in chips)
Seat 5: c392ea8c (8,435 in chips)
Seat 6: 1daebb68 (15,901 in chips)
Seat 7: Hero (38,143 in chips)
Seat 8: 4f506b4 (30,243 in chips)
cfd75398: posts the ante 35
c392ea8c: posts the ante 35
3bcd4d55: posts the ante 35
2a0eef47: posts the ante 35
4f506b4: posts the ante 35
1daebb68: posts the ante 35
d3e04f5d: posts the ante 35
Hero: posts the ante 35
cfd75398: posts small blind 125
2a0eef47: posts big blind 250
*** HOLE CARDS ***
Dealt to cfd75398 
Dealt to 2a0eef47 
Dealt to 3bcd4d55 
Dealt to d3e04f5d 
Dealt to c392ea8c 
Dealt to 1daebb68 
Dealt to Hero [3c 5h]
Dealt to 4f506b4 
3bcd4d55: calls 250
d3e04f5d: folds
c392ea8c: folds
1daebb68: folds
Hero: folds
4f506b4: folds
cfd75398: folds
2a0eef47: checks
*** FLOP *** [Ad Ac Kd]
2a0eef47: checks
3bcd4d55: bets 250
2a0eef47: folds
Uncalled bet (250) returned to 3bcd4d55
*** SHOWDOWN ***
3bcd4d55 collected 905 from pot
*** SUMMARY ***
Total pot 905 | Rake 0 | Jackpot 0 | Bingo 0 | Fortune 0 | Tax 0
Board [Ad Ac Kd]
Seat 1: cfd75398 (small blind) folded before Flop
Seat 2: 2a0eef47 (big blind) folded on the Flop
Seat 3: 3bcd4d55 won (905)
Seat 4: d3e04f5d folded before Flop
Seat 5: c392ea8c folded before Flop
Seat 6: 1daebb68 folded before Flop
Seat 7: Hero folded before Flop
Seat 8: 4f506b4 (button) folded before Flop


Poker Hand #TM3547323643: Tournament #156323098, Bounty Hunters $1.08 Hold'em No Limit - Level5(125/250) - 2024/08/03 23:05:48
Table '2' 8-max Seat #7 is the button
Seat 1: cfd75398 (17,119 in chips)
Seat 2: 2a0eef47 (9,905 in chips)
Seat 3: 3bcd4d55 (10,965 in chips)
Seat 4: d3e04f5d (16,003 in chips)
Seat 6: 1daebb68 (15,936 in chips)
Seat 7: Hero (38,178 in chips)
Seat 8: 4f506b4 (29,410 in chips)
cfd75398: posts the ante 35
3bcd4d55: posts the ante 35
2a0eef47: posts the ante 35
4f506b4: posts the ante 35
1daebb68: posts the ante 35
d3e04f5d: posts the ante 35
Hero: posts the ante 35
4f506b4: posts small blind 125
cfd75398: posts big blind 250
*** HOLE CARDS ***
Dealt to cfd75398 
Dealt to 2a0eef47 
Dealt to 3bcd4d55 
Dealt to d3e04f5d 
Dealt to 1daebb68 
Dealt to Hero [8c 4d]
Dealt to 4f506b4 
2a0eef47: folds
3bcd4d55: folds
d3e04f5d: folds
1daebb68: folds
Hero: folds
4f506b4: calls 125
cfd75398: checks
*** FLOP *** [Kd 8h 5d]
4f506b4: checks
cfd75398: checks
*** TURN *** [Kd 8h 5d] [7s]
4f506b4: checks
cfd75398: bets 373
4f506b4: calls 373
*** RIVER *** [Kd 8h 5d 7s] [6s]
4f506b4: bets 1,491
cfd75398: folds
Uncalled bet (1,491) returned to 4f506b4
*** SHOWDOWN ***
4f506b4 collected 1,491 from pot
*** SUMMARY ***
Total pot 1,491 | Rake 0 | Jackpot 0 | Bingo 0 | Fortune 0 | Tax 0
Board [Kd 8h 5d 7s 6s]
Seat 1: cfd75398 (big blind) folded on the River
Seat 2: 2a0eef47 folded before Flop
Seat 3: 3bcd4d55 folded before Flop
Seat 4: d3e04f5d folded before Flop
Seat 6: 1daebb68 folded before Flop
Seat 7: Hero (button) folded before Flop
Seat 8: 4f506b4 (small blind) won (1,491)


Poker Hand #TM3547323547: Tournament #156323098, Bounty Hunters $1.08 Hold'em No Limit - Level5(125/250) - 2024/08/03 23:04:37
Table '2' 8-max Seat #6 is the button
Seat 1: cfd75398 (18,201 in chips)
Seat 2: 2a0eef47 (9,940 in chips)
Seat 3: 3bcd4d55 (11,000 in chips)
Seat 4: d3e04f5d (16,038 in chips)
Seat 5: c0b3da59 (10,000 in chips)
Seat 6: 1daebb68 (15,971 in chips)
Seat 7: Hero (38,338 in chips)
Seat 8: 4f506b4 (18,028 in chips)
c0b3da59: posts the ante 35
cfd75398: posts the ante 35
3bcd4d55: posts the ante 35
2a0eef47: posts the ante 35
4f506b4: posts the ante 35
1daebb68: posts the ante 35
d3e04f5d: posts the ante 35
Hero: posts the ante 35
Hero: posts small blind 125
4f506b4: posts big blind 250
*** HOLE CARDS ***
Dealt to cfd75398 
Dealt to 2a0eef47 
Dealt to 3bcd4d55 
Dealt to d3e04f5d 
Dealt to c0b3da59 
Dealt to 1daebb68 
Dealt to Hero [Kc 9s]
Dealt to 4f506b4 
cfd75398: raises 250 to 500
2a0eef47: folds
3bcd4d55: folds
d3e04f5d: folds
c0b3da59: raises 547 to 1,047
1daebb68: folds
Hero: folds
4f506b4: calls 797
cfd75398: calls 547
*** FLOP *** [7h 4s 6h]
4f506b4: bets 1,773
cfd75398: folds
c0b3da59: raises 7,092 to 8,865
4f506b4: raises 7,092 to 15,957
c0b3da59: calls 53 and is all-in
Uncalled bet (7,039) returned to 4f506b4
4f506b4: shows [Jh 4h] (Pair of Fours)
c0b3da59: shows [8s 8c] (Pair of Eights)
*** TURN *** [7h 4s 6h] [Tc]
*** RIVER *** [7h 4s 6h Tc] [Qh]
*** SHOWDOWN ***
4f506b4 collected 21,382 from pot
*** SUMMARY ***
Total pot 21,382 | Rake 0 | Jackpot 0 | Bingo 0 | Fortune 0 | Tax 0
Board [7h 4s 6h Tc Qh]
Seat 1: cfd75398 folded on the Flop
Seat 2: 2a0eef47 folded before Flop
Seat 3: 3bcd4d55 folded before Flop
Seat 4: d3e04f5d folded before Flop
Seat 5: c0b3da59 showed [8s 8c] and lost with Pair of Eights
Seat 6: 1daebb68 (button) folded before Flop
Seat 7: Hero (small blind) folded before Flop
Seat 8: 4f506b4 (big blind) showed [Jh 4h] and won (21,382) with Queen High Flush


Poker Hand #TM3547323468: Tournament #156323098, Bounty Hunters $1.08 Hold'em No Limit - Level4(100/200) - 2024/08/03 23:03:30
Table '2' 8-max Seat #4 is the button
Seat 1: cfd75398 (18,231 in chips)
Seat 2: 2a0eef47 (9,970 in chips)
Seat 3: 3bcd4d55 (11,030 in chips)
Seat 4: d3e04f5d (18,218 in chips)
Seat 6: 1daebb68 (16,101 in chips)
Seat 7: Hero (35,908 in chips)
Seat 8: 4f506b4 (18,058 in chips)
cfd75398: posts the ante 30
3bcd4d55: posts the ante 30
2a0eef47: posts the ante 30
4f506b4: posts the ante 30
d3e04f5d: posts the ante 30
1daebb68: posts the ante 30
Hero: posts the ante 30
1daebb68: posts small blind 100
Hero: posts big blind 200
*** HOLE CARDS ***
Dealt to cfd75398 
Dealt to 2a0eef47 
Dealt to 3bcd4d55 
Dealt to d3e04f5d 
Dealt to 1daebb68 
Dealt to Hero [7s Ks]
Dealt to 4f506b4 
4f506b4: folds
cfd75398: folds
2a0eef47: folds
3bcd4d55: folds
d3e04f5d: raises 200 to 400
1daebb68: folds
Hero: calls 200
*** FLOP *** [9s 7h Ac]
Hero: checks
d3e04f5d: bets 367
Hero: calls 367
*** TURN *** [9s 7h Ac] [Kc]
Hero: checks
d3e04f5d: bets 1,383
Hero: raises 1,383 to 2,766
d3e04f5d: folds
Uncalled bet (1,383) returned to Hero
*** SHOWDOWN ***
Hero collected 4,610 from pot
*** SUMMARY ***
Total pot 4,610 | Rake 0 | Jackpot 0 | Bingo 0 | Fortune 0 | Tax 0
Board [9s 7h Ac Kc]
Seat 1: cfd75398 folded before Flop
Seat 2: 2a0eef47 folded before Flop
Seat 3: 3bcd4d55 folded before Flop
Seat 4: d3e04f5d (button) folded on the Turn
Seat 6: 1daebb68 (small blind) folded before Flop
Seat 7: Hero (big blind) won (4,610)
Seat 8: 4f506b4 folded before Flop


Poker Hand #TM3547323400: Tournament #156323098, Bounty Hunters $1.08 Hold'em No Limit - Level4(100/200) - 2024/08/03 23:02:30
Table '2' 8-max Seat #3 is the button
Seat 1: cfd75398 (19,371 in chips)
Seat 2: 2a0eef47 (10,000 in chips)
Seat 3: 3bcd4d55 (11,060 in chips)
Seat 4: d3e04f5d (18,348 in chips)
Seat 6: 1daebb68 (16,331 in chips)
Seat 7: Hero (36,138 in chips)
Seat 8: 4f506b4 (16,268 in chips)
cfd75398: posts the ante 30
3bcd4d55: posts the ante 30
2a0eef47: posts the ante 30
4f506b4: posts the ante 30
1daebb68: posts the ante 30
d3e04f5d: posts the ante 30
Hero: posts the ante 30
d3e04f5d: posts small blind 100
1daebb68: posts big blind 200
*** HOLE CARDS ***
Dealt to cfd75398 
Dealt to 2a0eef47 
Dealt to 3bcd4d55 
Dealt to d3e04f5d 
Dealt to 1daebb68 
Dealt to Hero [9h 3h]
Dealt to 4f506b4 
Hero: calls 200
4f506b4: raises 910 to 1,110
cfd75398: calls 1,110
2a0eef47: folds
3bcd4d55: folds
d3e04f5d: folds
1daebb68: folds
Hero: folds
*** FLOP *** [8d 3s 7s]
4f506b4: bets 967
cfd75398: folds
Uncalled bet (967) returned to 4f506b4
*** SHOWDOWN ***
4f506b4 collected 2,930 from pot
*** SUMMARY ***
Total pot 2,930 | Rake 0 | Jackpot 0 | Bingo 0 | Fortune 0 | Tax 0
Board [8d 3s 7s]
Seat 1: cfd75398 folded on the Flop
Seat 2: 2a0eef47 folded before Flop
Seat 3: 3bcd4d55 (button) folded before Flop
Seat 4: d3e04f5d (small blind) folded before Flop
Seat 6: 1daebb68 (big blind) folded before Flop
Seat 7: Hero folded before Flop
Seat 8: 4f506b4 won (2,930)


Poker Hand #TM3547323339: Tournament #156323098, Bounty Hunters $1.08 Hold'em No Limit - Level4(100/200) - 2024/08/03 23:01:15
Table '2' 8-max Seat #1 is the button
Seat 1: cfd75398 (19,401 in chips)
Seat 3: 3bcd4d55 (9,680 in chips)
Seat 4: d3e04f5d (18,578 in chips)
Seat 5: 7293f0b8 (8,675 in chips)
Seat 6: 1daebb68 (16,361 in chips)
Seat 7: Hero (36,668 in chips)
Seat 8: 4f506b4 (16,798 in chips)
7293f0b8: posts the ante 30
cfd75398: posts the ante 30
3bcd4d55: posts the ante 30
4f506b4: posts the ante 30
1daebb68: posts the ante 30
d3e04f5d: posts the ante 30
Hero: posts the ante 30
3bcd4d55: posts small blind 100
d3e04f5d: posts big blind 200
*** HOLE CARDS ***
Dealt to cfd75398 
Dealt to 3bcd4d55 
Dealt to d3e04f5d 
Dealt to 7293f0b8 
Dealt to 1daebb68 
Dealt to Hero [As 5d]
Dealt to 4f506b4 
7293f0b8: folds
1daebb68: folds
Hero: raises 300 to 500
4f506b4: calls 500
cfd75398: folds
3bcd4d55: calls 400
d3e04f5d: folds
*** FLOP *** [Jd 4d Kh]
3bcd4d55: checks
Hero: checks
4f506b4: checks
*** TURN *** [Jd 4d Kh] [3s]
3bcd4d55: checks
Hero: checks
4f506b4: checks
*** RIVER *** [Jd 4d Kh 3s] [Qh]
3bcd4d55: checks
Hero: checks
4f506b4: checks
3bcd4d55: shows [Ah Jh] (Pair of Jacks)
Hero: shows [As 5d] (Ace-High)
4f506b4: shows [6c 6d] (Pair of Sixes)
*** SHOWDOWN ***
3bcd4d55 collected 1,910 from pot
*** SUMMARY ***
Total pot 1,910 | Rake 0 | Jackpot 0 | Bingo 0 | Fortune 0 | Tax 0
Board [Jd 4d Kh 3s Qh]
Seat 1: cfd75398 (button) folded before Flop
Seat 3: 3bcd4d55 (small blind) showed [Ah Jh] and won (1,910) with Pair of Jacks
Seat 4: d3e04f5d (big blind) folded before Flop
Seat 5: 7293f0b8 folded before Flop
Seat 6: 1daebb68 folded before Flop
Seat 7: Hero showed [As 5d] and lost with Ace-High
Seat 8: 4f506b4 showed [6c 6d] and lost with Pair of Sixes


Poker Hand #TM3547323317: Tournament #156323098, Bounty Hunters $1.08 Hold'em No Limit - Level4(100/200) - 2024/08/03 22:54:57
Table '2' 8-max Seat #8 is the button
Seat 1: cfd75398 (19,531 in chips)
Seat 2: 372af7bb (8,751 in chips)
Seat 3: 3bcd4d55 (9,710 in chips)
Seat 4: d3e04f5d (18,608 in chips)
Seat 5: 7293f0b8 (8,705 in chips)
Seat 6: 475ee374 (7,290 in chips)
Seat 7: Hero (20,377 in chips)
Seat 8: 4f506b4 (16,828 in chips)
7293f0b8: posts the ante 30
cfd75398: posts the ante 30
3bcd4d55: posts the ante 30
4f506b4: posts the ante 30
475ee374: posts the ante 30
372af7bb: posts the ante 30
d3e04f5d: posts the ante 30
Hero: posts the ante 30
cfd75398: posts small blind 100
372af7bb: posts big blind 200
*** HOLE CARDS ***
Dealt to cfd75398 
Dealt to 372af7bb 
Dealt to 3bcd4d55 
Dealt to d3e04f5d 
Dealt to 7293f0b8 
Dealt to 475ee374 
Dealt to Hero [8h 7h]
Dealt to 4f506b4 
3bcd4d55: folds
d3e04f5d: folds
7293f0b8: folds
475ee374: raises 400 to 600
Hero: calls 600
4f506b4: folds
cfd75398: folds
372af7bb: calls 400
*** FLOP *** [2h 7c 3h]
372af7bb: bets 8,121 and is all-in
475ee374: calls 6,660 and is all-in
Hero: calls 8,121
372af7bb: shows [Kd 2d] (Pair of Twos)
475ee374: shows [9s 9c] (Pair of Nines)
Hero: shows [8h 7h] (Pair of Sevens)
*** TURN *** [2h 7c 3h] [9h]
*** RIVER *** [2h 7c 3h 9h] [Ts]
*** SHOWDOWN ***
Hero collected 22,120 from pot
Hero collected 2,922 from pot
*** SUMMARY ***
Total pot 25,042 | Rake 0 | Jackpot 0 | Bingo 0 | Fortune 0 | Tax 0
Board [2h 7c 3h 9h Ts]
Seat 1: cfd75398 (small blind) folded before Flop
Seat 2: 372af7bb (big blind) showed [Kd 2d] and lost with Pair of Twos
Seat 3: 3bcd4d55 folded before Flop
Seat 4: d3e04f5d folded before Flop
Seat 5: 7293f0b8 folded before Flop
Seat 6: 475ee374 showed [9s 9c] and lost with Three Nines
Seat 7: Hero showed [8h 7h] and won (25,042) with Nine High Flush
Seat 8: 4f506b4 (button) folded before Flop


Poker Hand #TM3547323270: Tournament #156323098, Bounty Hunters $1.08 Hold'em No Limit - Level4(100/200) - 2024/08/03 22:54:28
Table '2' 8-max Seat #7 is the button
Seat 1: cfd75398 (19,761 in chips)
Seat 2: 372af7bb (8,241 in chips)
Seat 3: 3bcd4d55 (9,740 in chips)
Seat 4: d3e04f5d (18,638 in chips)
Seat 5: 7293f0b8 (8,735 in chips)
Seat 6: 475ee374 (7,320 in chips)
Seat 7: Hero (20,407 in chips)
Seat 8: 4f506b4 (16,958 in chips)
7293f0b8: posts the ante 30
cfd75398: posts the ante 30
3bcd4d55: posts the ante 30
4f506b4: posts the ante 30
475ee374: posts the ante 30
372af7bb: posts the ante 30
d3e04f5d: posts the ante 30
Hero: posts the ante 30
4f506b4: posts small blind 100
cfd75398: posts big blind 200
*** HOLE CARDS ***
Dealt to cfd75398 
Dealt to 372af7bb 
Dealt to 3bcd4d55 
Dealt to d3e04f5d 
Dealt to 7293f0b8 
Dealt to 475ee374 
Dealt to Hero [7c As]
Dealt to 4f506b4 
372af7bb: raises 8,011 to 8,211 and is all-in
3bcd4d55: folds
d3e04f5d: folds
7293f0b8: folds
475ee374: folds
Hero: folds
4f506b4: folds
cfd75398: folds
Uncalled bet (8,011) returned to 372af7bb
*** SHOWDOWN ***
372af7bb collected 740 from pot
*** SUMMARY ***
Total pot 740 | Rake 0 | Jackpot 0 | Bingo 0 | Fortune 0 | Tax 0
Seat 1: cfd75398 (big blind) folded before Flop
Seat 2: 372af7bb collected (740)
Seat 3: 3bcd4d55 folded before Flop
Seat 4: d3e04f5d folded before Flop
Seat 5: 7293f0b8 folded before Flop
Seat 6: 475ee374 folded before Flop
Seat 7: Hero (button) folded before Flop
Seat 8: 4f506b4 (small blind) folded before Flop


Poker Hand #TM3547323188: Tournament #156323098, Bounty Hunters $1.08 Hold'em No Limit - Level4(100/200) - 2024/08/03 22:53:26
Table '2' 8-max Seat #6 is the button
Seat 1: cfd75398 (19,791 in chips)
Seat 2: 372af7bb (9,211 in chips)
Seat 3: 59767af1 (8,732 in chips)
Seat 4: d3e04f5d (18,668 in chips)
Seat 5: 7293f0b8 (8,765 in chips)
Seat 6: 475ee374 (7,350 in chips)
Seat 7: Hero (10,355 in chips)
Seat 8: 4f506b4 (17,188 in chips)
7293f0b8: posts the ante 30
cfd75398: posts the ante 30
59767af1: posts the ante 30
4f506b4: posts the ante 30
475ee374: posts the ante 30
372af7bb: posts the ante 30
d3e04f5d: posts the ante 30
Hero: posts the ante 30
Hero: posts small blind 100
4f506b4: posts big blind 200
*** HOLE CARDS ***
Dealt to cfd75398 
Dealt to 372af7bb 
Dealt to 59767af1 
Dealt to d3e04f5d 
Dealt to 7293f0b8 
Dealt to 475ee374 
Dealt to Hero [Tc Th]
Dealt to 4f506b4 
cfd75398: folds
372af7bb: raises 740 to 940
59767af1: calls 940
d3e04f5d: folds
7293f0b8: folds
475ee374: folds
Hero: raises 9,385 to 10,325 and is all-in
4f506b4: folds
372af7bb: folds
59767af1: calls 7,762 and is all-in
Uncalled bet (1,623) returned to Hero
Hero: shows [Tc Th]
59767af1: shows [Ah 7h]
*** FLOP *** [4d 4s 3d]
*** TURN *** [4d 4s 3d] [Qd]
*** RIVER *** [4d 4s 3d Qd] [Ts]
4f506b4: shows [6c 7c] (Pair of Fours)
*** SHOWDOWN ***
Hero collected 18,784 from pot
*** SUMMARY ***
Total pot 18,784 | Rake 0 | Jackpot 0 | Bingo 0 | Fortune 0 | Tax 0
Board [4d 4s 3d Qd Ts]
Seat 1: cfd75398 folded before Flop
Seat 2: 372af7bb folded before Flop
Seat 3: 59767af1 showed [Ah 7h] and lost with Pair of Fours
Seat 4: d3e04f5d folded before Flop
Seat 5: 7293f0b8 folded before Flop
Seat 6: 475ee374 (button) folded before Flop
Seat 7: Hero (small blind) showed [Tc Th] and won (18,784) with Tens Full over Fours
Seat 8: 4f506b4 (big blind) folded before Flop


Poker Hand #TM3547323151: Tournament #156323098, Bounty Hunters $1.08 Hold'em No Limit - Level4(100/200) - 2024/08/03 22:52:56
Table '2' 8-max Seat #5 is the button
Seat 1: cfd75398 (19,821 in chips)
Seat 2: 372af7bb (9,241 in chips)
Seat 3: 59767af1 (8,762 in chips)
Seat 4: d3e04f5d (18,698 in chips)
Seat 5: 7293f0b8 (8,795 in chips)
Seat 6: 475ee374 (7,580 in chips)
Seat 7: Hero (9,945 in chips)
Seat 8: 4f506b4 (17,218 in chips)
7293f0b8: posts the ante 30
cfd75398: posts the ante 30
59767af1: posts the ante 30
4f506b4: posts the ante 30
372af7bb: posts the ante 30
475ee374: posts the ante 30
d3e04f5d: posts the ante 30
Hero: posts the ante 30
475ee374: posts small blind 100
Hero: posts big blind 200
*** HOLE CARDS ***
Dealt to cfd75398 
Dealt to 372af7bb 
Dealt to 59767af1 
Dealt to d3e04f5d 
Dealt to 7293f0b8 
Dealt to 475ee374 
Dealt to Hero [Qs 7c]
Dealt to 4f506b4 
4f506b4: folds
cfd75398: folds
372af7bb: folds
59767af1: folds
d3e04f5d: folds
7293f0b8: folds
475ee374: calls 100
Hero: checks
*** FLOP *** [Qc 2d 6s]
475ee374: checks
Hero: bets 640
475ee374: folds
Uncalled bet (640) returned to Hero
Hero: shows [Qs]
*** SHOWDOWN ***
Hero collected 640 from pot
*** SUMMARY ***
Total pot 640 | Rake 0 | Jackpot 0 | Bingo 0 | Fortune 0 | Tax 0
Board [Qc 2d 6s]
Seat 1: cfd75398 folded before Flop
Seat 2: 372af7bb folded before Flop
Seat 3: 59767af1 folded before Flop
Seat 4: d3e04f5d folded before Flop
Seat 5: 7293f0b8 (button) folded before Flop
Seat 6: 475ee374 (small blind) folded on the Flop
Seat 7: Hero (big blind) showed [Qs] and won (640)
Seat 8: 4f506b4 folded before Flop


Poker Hand #TM3547323058: Tournament #156323098, Bounty Hunters $1.08 Hold'em No Limit - Level4(100/200) - 2024/08/03 22:51:43
Table '2' 8-max Seat #4 is the button
Seat 1: cfd75398 (20,551 in chips)
Seat 2: 372af7bb (9,271 in chips)
Seat 3: 59767af1 (10,812 in chips)
Seat 4: d3e04f5d (18,728 in chips)
Seat 5: 7293f0b8 (8,925 in chips)
Seat 6: 475ee374 (9,630 in chips)
Seat 7: Hero (9,975 in chips)
Seat 8: 4f506b4 (12,168 in chips)
7293f0b8: posts the ante 30
cfd75398: posts the ante 30
59767af1: posts the ante 30
4f506b4: posts the ante 30
372af7bb: posts the ante 30
475ee374: posts the ante 30
d3e04f5d: posts the ante 30
Hero: posts the ante 30
7293f0b8: posts small blind 100
475ee374: posts big blind 200
*** HOLE CARDS ***
Dealt to cfd75398 
Dealt to 372af7bb 
Dealt to 59767af1 
Dealt to d3e04f5d 
Dealt to 7293f0b8 
Dealt to 475ee374 
Dealt to Hero [Tc 4d]
Dealt to 4f506b4 
Hero: folds
4f506b4: calls 200
cfd75398: raises 500 to 700
372af7bb: folds
59767af1: calls 700
d3e04f5d: folds
7293f0b8: folds
475ee374: raises 1,320 to 2,020
4f506b4: calls 1,820
cfd75398: folds
59767af1: calls 1,320
*** FLOP *** [7c Kh 8h]
475ee374: checks
4f506b4: bets 7,100
59767af1: folds
475ee374: folds
Uncalled bet (7,100) returned to 4f506b4
*** SHOWDOWN ***
4f506b4 collected 7,100 from pot
*** SUMMARY ***
Total pot 7,100 | Rake 0 | Jackpot 0 | Bingo 0 | Fortune 0 | Tax 0
Board [7c Kh 8h]
Seat 1: cfd75398 folded before Flop
Seat 2: 372af7bb folded before Flop
Seat 3: 59767af1 folded on the Flop
Seat 4: d3e04f5d (button) folded before Flop
Seat 5: 7293f0b8 (small blind) folded before Flop
Seat 6: 475ee374 (big blind) folded on the Flop
Seat 7: Hero folded before Flop
Seat 8: 4f506b4 won (7,100)


Poker Hand #TM3547322989: Tournament #156323098, Bounty Hunters $1.08 Hold'em No Limit - Level3(80/160) - 2024/08/03 22:50:48
Table '2' 8-max Seat #3 is the button
Seat 1: cfd75398 (20,576 in chips)
Seat 2: 372af7bb (8,536 in chips)
Seat 3: 59767af1 (10,837 in chips)
Seat 4: d3e04f5d (18,833 in chips)
Seat 5: 7293f0b8 (9,110 in chips)
Seat 6: 475ee374 (9,975 in chips)
Seat 7: Hero (10,000 in chips)
Seat 8: 4f506b4 (12,193 in chips)
7293f0b8: posts the ante 25
cfd75398: posts the ante 25
59767af1: posts the ante 25
4f506b4: posts the ante 25
372af7bb: posts the ante 25
475ee374: posts the ante 25
d3e04f5d: posts the ante 25
Hero: posts the ante 25
d3e04f5d: posts small blind 80
7293f0b8: posts big blind 160
*** HOLE CARDS ***
Dealt to cfd75398 
Dealt to 372af7bb 
Dealt to 59767af1 
Dealt to d3e04f5d 
Dealt to 7293f0b8 
Dealt to 475ee374 
Dealt to Hero [9h 3d]
Dealt to 4f506b4 
475ee374: raises 160 to 320
Hero: folds
4f506b4: folds
cfd75398: folds
372af7bb: calls 320
59767af1: folds
d3e04f5d: folds
7293f0b8: folds
*** FLOP *** [Ts Td 2d]
475ee374: checks
372af7bb: checks
*** TURN *** [Ts Td 2d] [2c]
475ee374: checks
372af7bb: checks
*** RIVER *** [Ts Td 2d 2c] [6s]
475ee374: checks
372af7bb: checks
475ee374: shows [8h Ks] (Pair of Tens and Pair of Twos)
372af7bb: shows [8s Ad] (Pair of Tens and Pair of Twos)
*** SHOWDOWN ***
372af7bb collected 1,080 from pot
*** SUMMARY ***
Total pot 1,080 | Rake 0 | Jackpot 0 | Bingo 0 | Fortune 0 | Tax 0
Board [Ts Td 2d 2c 6s]
Seat 1: cfd75398 folded before Flop
Seat 2: 372af7bb showed [8s Ad] and won (1,080) with Pair of Tens and Pair of Twos
Seat 3: 59767af1 (button) folded before Flop
Seat 4: d3e04f5d (small blind) folded before Flop
Seat 5: 7293f0b8 (big blind) folded before Flop
Seat 6: 475ee374 showed [8h Ks] and lost with Pair of Tens and Pair of Twos
Seat 7: Hero folded before Flop
Seat 8: 4f506b4 folded before Flop


Poker Hand #TM3547322910: Tournament #156323098, Bounty Hunters $1.08 Hold'em No Limit - Level3(80/160) - 2024/08/03 22:49:53
Table '2' 8-max Seat #2 is the button
Seat 1: cfd75398 (21,225 in chips)
Seat 2: 372af7bb (8,561 in chips)
Seat 3: 59767af1 (10,942 in chips)
Seat 4: d3e04f5d (17,954 in chips)
Seat 5: 7293f0b8 (9,135 in chips)
Seat 6: 475ee374 (10,000 in chips)
Seat 7: Hero (10,025 in chips)
Seat 8: 4f506b4 (12,218 in chips)
7293f0b8: posts the ante 25
cfd75398: posts the ante 25
59767af1: posts the ante 25
4f506b4: posts the ante 25
372af7bb: posts the ante 25
475ee374: posts the ante 25
d3e04f5d: posts the ante 25
Hero: posts the ante 25
59767af1: posts small blind 80
d3e04f5d: posts big blind 160
*** HOLE CARDS ***
Dealt to cfd75398 
Dealt to 372af7bb 
Dealt to 59767af1 
Dealt to d3e04f5d 
Dealt to 7293f0b8 
Dealt to 475ee374 
Dealt to Hero [4h 9c]
Dealt to 4f506b4 
7293f0b8: folds
475ee374: folds
Hero: folds
4f506b4: folds
cfd75398: raises 160 to 320
372af7bb: folds
59767af1: folds
d3e04f5d: calls 160
*** FLOP *** [9h Qd Kh]
d3e04f5d: checks
cfd75398: bets 304
d3e04f5d: calls 304
*** TURN *** [9h Qd Kh] [Kd]
d3e04f5d: checks
cfd75398: checks
*** RIVER *** [9h Qd Kh Kd] [6h]
d3e04f5d: bets 1,146
cfd75398: folds
Uncalled bet (1,146) returned to d3e04f5d
*** SHOWDOWN ***
d3e04f5d collected 1,528 from pot
*** SUMMARY ***
Total pot 1,528 | Rake 0 | Jackpot 0 | Bingo 0 | Fortune 0 | Tax 0
Board [9h Qd Kh Kd 6h]
Seat 1: cfd75398 folded on the River
Seat 2: 372af7bb (button) folded before Flop
Seat 3: 59767af1 (small blind) folded before Flop
Seat 4: d3e04f5d (big blind) won (1,528)
Seat 5: 7293f0b8 folded before Flop
Seat 6: 475ee374 folded before Flop
Seat 7: Hero folded before Flop
Seat 8: 4f506b4 folded before Flop


Poker Hand #TM3547322821: Tournament #156323098, Bounty Hunters $1.08 Hold'em No Limit - Level3(80/160) - 2024/08/03 22:48:43
Table '2' 8-max Seat #1 is the button
Seat 1: cfd75398 (21,250 in chips)
Seat 2: 372af7bb (8,666 in chips)
Seat 3: 59767af1 (11,127 in chips)
Seat 4: d3e04f5d (17,979 in chips)
Seat 5: 7293f0b8 (9,160 in chips)
Seat 7: Hero (9,315 in chips)
Seat 8: 4f506b4 (12,563 in chips)
7293f0b8: posts the ante 25
cfd75398: posts the ante 25
59767af1: posts the ante 25
4f506b4: posts the ante 25
372af7bb: posts the ante 25
d3e04f5d: posts the ante 25
Hero: posts the ante 25
372af7bb: posts small blind 80
59767af1: posts big blind 160
*** HOLE CARDS ***
Dealt to cfd75398 
Dealt to 372af7bb 
Dealt to 59767af1 
Dealt to d3e04f5d 
Dealt to 7293f0b8 
Dealt to Hero [5c 6d]
Dealt to 4f506b4 
d3e04f5d: folds
7293f0b8: folds
Hero: raises 160 to 320
4f506b4: calls 320
cfd75398: folds
372af7bb: folds
59767af1: folds
*** FLOP *** [3h Jd Jh]
Hero: checks
4f506b4: checks
*** TURN *** [3h Jd Jh] [7d]
Hero: checks
4f506b4: checks
*** RIVER *** [3h Jd Jh 7d] [8d]
Hero: bets 528
4f506b4: folds
Uncalled bet (528) returned to Hero
*** SHOWDOWN ***
Hero collected 1,055 from pot
*** SUMMARY ***
Total pot 1,055 | Rake 0 | Jackpot 0 | Bingo 0 | Fortune 0 | Tax 0
Board [3h Jd Jh 7d 8d]
Seat 1: cfd75398 (button) folded before Flop
Seat 2: 372af7bb (small blind) folded before Flop
Seat 3: 59767af1 (big blind) folded before Flop
Seat 4: d3e04f5d folded before Flop
Seat 5: 7293f0b8 folded before Flop
Seat 7: Hero won (1,055)
Seat 8: 4f506b4 folded on the River


Poker Hand #TM3547322705: Tournament #156323098, Bounty Hunters $1.08 Hold'em No Limit - Level3(80/160) - 2024/08/03 22:47:15
Table '2' 8-max Seat #8 is the button
Seat 1: cfd75398 (21,355 in chips)
Seat 2: 372af7bb (12,726 in chips)
Seat 3: 59767af1 (11,695 in chips)
Seat 4: d3e04f5d (10,349 in chips)
Seat 5: 7293f0b8 (9,185 in chips)
Seat 6: 689b8f5 (568 in chips)
Seat 7: Hero (11,051 in chips)
Seat 8: 4f506b4 (13,131 in chips)
7293f0b8: posts the ante 25
cfd75398: posts the ante 25
59767af1: posts the ante 25
689b8f5: posts the ante 25
4f506b4: posts the ante 25
372af7bb: posts the ante 25
d3e04f5d: posts the ante 25
Hero: posts the ante 25
cfd75398: posts small blind 80
372af7bb: posts big blind 160
*** HOLE CARDS ***
Dealt to cfd75398 
Dealt to 372af7bb 
Dealt to 59767af1 
Dealt to d3e04f5d 
Dealt to 7293f0b8 
Dealt to 689b8f5 
Dealt to Hero [5s 4h]
Dealt to 4f506b4 
59767af1: raises 160 to 320
d3e04f5d: calls 320
7293f0b8: folds
689b8f5: raises 223 to 543 and is all-in
Hero: calls 543
4f506b4: calls 543
cfd75398: folds
372af7bb: calls 383
59767af1: calls 223
d3e04f5d: calls 223
*** FLOP *** [As 4c Td]
372af7bb: checks
59767af1: checks
d3e04f5d: checks
Hero: bets 1,168
4f506b4: folds
372af7bb: calls 1,168
59767af1: folds
d3e04f5d: calls 1,168
*** TURN *** [As 4c Td] [Jc]
372af7bb: checks
d3e04f5d: bets 2,324
Hero: folds
372af7bb: calls 2,324
*** RIVER *** [As 4c Td Jc] [7h]
372af7bb: checks
d3e04f5d: bets 6,289 and is all-in
372af7bb: folds
Uncalled bet (6,289) returned to d3e04f5d
d3e04f5d: shows [Jh Ac] (Pair of Aces and Pair of Jacks)
689b8f5: shows [Ts 6s] (Pair of Tens)
*** SHOWDOWN ***
d3e04f5d collected 3,538 from pot
d3e04f5d collected 8,152 from pot
*** SUMMARY ***
Total pot 11,690 | Rake 0 | Jackpot 0 | Bingo 0 | Fortune 0 | Tax 0
Board [As 4c Td Jc 7h]
Seat 1: cfd75398 (small blind) folded before Flop
Seat 2: 372af7bb (big blind) folded on the River
Seat 3: 59767af1 folded on the Flop
Seat 4: d3e04f5d showed [Jh Ac] and won (11,690) with Pair of Aces and Pair of Jacks
Seat 5: 7293f0b8 folded before Flop
Seat 6: 689b8f5 showed [Ts 6s] and lost with Pair of Tens
Seat 7: Hero folded on the Turn
Seat 8: 4f506b4 (button) folded on the Flop


Poker Hand #TM3547322625: Tournament #156323098, Bounty Hunters $1.08 Hold'em No Limit - Level3(80/160) - 2024/08/03 22:46:07
Table '2' 8-max Seat #7 is the button
Seat 1: cfd75398 (21,540 in chips)
Seat 2: 372af7bb (6,168 in chips)
Seat 3: 59767af1 (11,720 in chips)
Seat 4: d3e04f5d (10,374 in chips)
Seat 5: 7293f0b8 (9,210 in chips)
Seat 6: 689b8f5 (6,736 in chips)
Seat 7: Hero (11,076 in chips)
Seat 8: 4f506b4 (13,236 in chips)
7293f0b8: posts the ante 25
cfd75398: posts the ante 25
59767af1: posts the ante 25
689b8f5: posts the ante 25
4f506b4: posts the ante 25
372af7bb: posts the ante 25
d3e04f5d: posts the ante 25
Hero: posts the ante 25
4f506b4: posts small blind 80
cfd75398: posts big blind 160
*** HOLE CARDS ***
Dealt to cfd75398 
Dealt to 372af7bb 
Dealt to 59767af1 
Dealt to d3e04f5d 
Dealt to 7293f0b8 
Dealt to 689b8f5 
Dealt to Hero [Td 4s]
Dealt to 4f506b4 
372af7bb: raises 160 to 320
59767af1: folds
d3e04f5d: folds
7293f0b8: folds
689b8f5: calls 320
Hero: folds
4f506b4: folds
cfd75398: folds
*** FLOP *** [8s Qd 3d]
372af7bb: bets 756
689b8f5: calls 756
*** TURN *** [8s Qd 3d] [Kh]
372af7bb: bets 1,815
689b8f5: calls 1,815
*** RIVER *** [8s Qd 3d Kh] [3c]
372af7bb: bets 3,252 and is all-in
689b8f5: calls 3,252
372af7bb: shows [Qs Kd] (Pair of Kings and Pair of Queens)
689b8f5: shows [7d 8d] (Pair of Eights and Pair of Treys)
*** SHOWDOWN ***
372af7bb collected 12,726 from pot
*** SUMMARY ***
Total pot 12,726 | Rake 0 | Jackpot 0 | Bingo 0 | Fortune 0 | Tax 0
Board [8s Qd 3d Kh 3c]
Seat 1: cfd75398 (big blind) folded before Flop
Seat 2: 372af7bb showed [Qs Kd] and won (12,726) with Pair of Kings and Pair of Queens
Seat 3: 59767af1 folded before Flop
Seat 4: d3e04f5d folded before Flop
Seat 5: 7293f0b8 folded before Flop
Seat 6: 689b8f5 showed [7d 8d] and lost with Pair of Eights and Pair of Treys
Seat 7: Hero (button) folded before Flop
Seat 8: 4f506b4 (small blind) folded before Flop


Poker Hand #TM3547322548: Tournament #156323098, Bounty Hunters $1.08 Hold'em No Limit - Level3(80/160) - 2024/08/03 22:45:11
Table '2' 8-max Seat #6 is the button
Seat 1: cfd75398 (21,565 in chips)
Seat 2: 372af7bb (6,193 in chips)
Seat 3: 59767af1 (11,745 in chips)
Seat 4: d3e04f5d (10,719 in chips)
Seat 5: 7293f0b8 (9,235 in chips)
Seat 6: 689b8f5 (5,601 in chips)
Seat 7: Hero (11,421 in chips)
Seat 8: 4f506b4 (13,581 in chips)
7293f0b8: posts the ante 25
cfd75398: posts the ante 25
59767af1: posts the ante 25
689b8f5: posts the ante 25
4f506b4: posts the ante 25
372af7bb: posts the ante 25
d3e04f5d: posts the ante 25
Hero: posts the ante 25
Hero: posts small blind 80
4f506b4: posts big blind 160
*** HOLE CARDS ***
Dealt to cfd75398 
Dealt to 372af7bb 
Dealt to 59767af1 
Dealt to d3e04f5d 
Dealt to 7293f0b8 
Dealt to 689b8f5 
Dealt to Hero [Js 9c]
Dealt to 4f506b4 
cfd75398: folds
372af7bb: folds
59767af1: folds
d3e04f5d: raises 160 to 320
7293f0b8: folds
689b8f5: calls 320
Hero: calls 240
4f506b4: calls 160
*** FLOP *** [6c Kd 3d]
Hero: checks
4f506b4: checks
d3e04f5d: checks
689b8f5: bets 1,800
Hero: folds
4f506b4: folds
d3e04f5d: folds
Uncalled bet (1,800) returned to 689b8f5
*** SHOWDOWN ***
689b8f5 collected 1,480 from pot
*** SUMMARY ***
Total pot 1,480 | Rake 0 | Jackpot 0 | Bingo 0 | Fortune 0 | Tax 0
Board [6c Kd 3d]
Seat 1: cfd75398 folded before Flop
Seat 2: 372af7bb folded before Flop
Seat 3: 59767af1 folded before Flop
Seat 4: d3e04f5d folded on the Flop
Seat 5: 7293f0b8 folded before Flop
Seat 6: 689b8f5 (button) won (1,480)
Seat 7: Hero (small blind) folded on the Flop
Seat 8: 4f506b4 (big blind) folded on the Flop


Poker Hand #TM3547322491: Tournament #156323098, Bounty Hunters $1.08 Hold'em No Limit - Level3(80/160) - 2024/08/03 22:44:30
Table '2' 8-max Seat #5 is the button
Seat 1: cfd75398 (21,590 in chips)
Seat 2: 372af7bb (6,218 in chips)
Seat 3: 59767af1 (11,770 in chips)
Seat 4: d3e04f5d (10,744 in chips)
Seat 5: 7293f0b8 (9,260 in chips)
Seat 6: 689b8f5 (5,706 in chips)
Seat 7: Hero (11,606 in chips)
Seat 8: 4f506b4 (13,166 in chips)
7293f0b8: posts the ante 25
cfd75398: posts the ante 25
59767af1: posts the ante 25
689b8f5: posts the ante 25
4f506b4: posts the ante 25
372af7bb: posts the ante 25
d3e04f5d: posts the ante 25
Hero: posts the ante 25
689b8f5: posts small blind 80
Hero: posts big blind 160
*** HOLE CARDS ***
Dealt to cfd75398 
Dealt to 372af7bb 
Dealt to 59767af1 
Dealt to d3e04f5d 
Dealt to 7293f0b8 
Dealt to 689b8f5 
Dealt to Hero [8c 6d]
Dealt to 4f506b4 
4f506b4: raises 600 to 760
cfd75398: folds
372af7bb: folds
59767af1: folds
d3e04f5d: folds
7293f0b8: folds
689b8f5: folds
Hero: folds
Uncalled bet (600) returned to 4f506b4
*** SHOWDOWN ***
4f506b4 collected 600 from pot
*** SUMMARY ***
Total pot 600 | Rake 0 | Jackpot 0 | Bingo 0 | Fortune 0 | Tax 0
Seat 1: cfd75398 folded before Flop
Seat 2: 372af7bb folded before Flop
Seat 3: 59767af1 folded before Flop
Seat 4: d3e04f5d folded before Flop
Seat 5: 7293f0b8 (button) folded before Flop
Seat 6: 689b8f5 (small blind) folded before Flop
Seat 7: Hero (big blind) folded before Flop
Seat 8: 4f506b4 collected (600)


Poker Hand #TM3547322408: Tournament #156323098, Bounty Hunters $1.08 Hold'em No Limit - Level2(60/120) - 2024/08/03 22:43:24
Table '2' 8-max Seat #4 is the button
Seat 1: cfd75398 (21,608 in chips)
Seat 2: 372af7bb (9,934 in chips)
Seat 3: 59767af1 (11,788 in chips)
Seat 4: d3e04f5d (10,762 in chips)
Seat 5: 7293f0b8 (9,338 in chips)
Seat 6: 689b8f5 (5,844 in chips)
Seat 7: Hero (7,602 in chips)
Seat 8: 4f506b4 (13,184 in chips)
7293f0b8: posts the ante 18
cfd75398: posts the ante 18
59767af1: posts the ante 18
689b8f5: posts the ante 18
4f506b4: posts the ante 18
372af7bb: posts the ante 18
d3e04f5d: posts the ante 18
Hero: posts the ante 18
7293f0b8: posts small blind 60
689b8f5: posts big blind 120
*** HOLE CARDS ***
Dealt to cfd75398 
Dealt to 372af7bb 
Dealt to 59767af1 
Dealt to d3e04f5d 
Dealt to 7293f0b8 
Dealt to 689b8f5 
Dealt to Hero [Kh Jd]
Dealt to 4f506b4 
Hero: raises 120 to 240
4f506b4: folds
cfd75398: folds
372af7bb: raises 563 to 803
59767af1: folds
d3e04f5d: folds
7293f0b8: folds
689b8f5: folds
Hero: calls 563
*** FLOP *** [Jh Kc 7h]
Hero: checks
372af7bb: checks
*** TURN *** [Jh Kc 7h] [2d]
Hero: bets 965
372af7bb: calls 965
*** RIVER *** [Jh Kc 7h 2d] [7d]
Hero: bets 1,930
372af7bb: calls 1,930
Hero: shows [Kh Jd] (Pair of Kings and Pair of Jacks)
372af7bb: shows [Ah Qd] (Pair of Sevens)
*** SHOWDOWN ***
Hero collected 7,720 from pot
*** SUMMARY ***
Total pot 7,720 | Rake 0 | Jackpot 0 | Bingo 0 | Fortune 0 | Tax 0
Board [Jh Kc 7h 2d 7d]
Seat 1: cfd75398 folded before Flop
Seat 2: 372af7bb showed [Ah Qd] and lost with Pair of Sevens
Seat 3: 59767af1 folded before Flop
Seat 4: d3e04f5d (button) folded before Flop
Seat 5: 7293f0b8 (small blind) folded before Flop
Seat 6: 689b8f5 (big blind) folded before Flop
Seat 7: Hero showed [Kh Jd] and won (7,720) with Pair of Kings and Pair of Jacks
Seat 8: 4f506b4 folded before Flop


Poker Hand #TM3547322325: Tournament #156323098, Bounty Hunters $1.08 Hold'em No Limit - Level2(60/120) - 2024/08/03 22:42:27
Table '2' 8-max Seat #3 is the button
Seat 1: cfd75398 (21,626 in chips)
Seat 2: 372af7bb (10,432 in chips)
Seat 3: 59767af1 (11,806 in chips)
Seat 4: d3e04f5d (9,556 in chips)
Seat 5: 7293f0b8 (9,476 in chips)
Seat 6: 689b8f5 (5,862 in chips)
Seat 7: Hero (7,620 in chips)
Seat 8: 4f506b4 (13,682 in chips)
7293f0b8: posts the ante 18
cfd75398: posts the ante 18
59767af1: posts the ante 18
689b8f5: posts the ante 18
4f506b4: posts the ante 18
372af7bb: posts the ante 18
d3e04f5d: posts the ante 18
Hero: posts the ante 18
d3e04f5d: posts small blind 60
7293f0b8: posts big blind 120
*** HOLE CARDS ***
Dealt to cfd75398 
Dealt to 372af7bb 
Dealt to 59767af1 
Dealt to d3e04f5d 
Dealt to 7293f0b8 
Dealt to 689b8f5 
Dealt to Hero [Kh 5d]
Dealt to 4f506b4 
689b8f5: folds
Hero: folds
4f506b4: calls 120
cfd75398: folds
372af7bb: calls 120
59767af1: folds
d3e04f5d: raises 360 to 480
7293f0b8: folds
4f506b4: calls 360
372af7bb: calls 360
*** FLOP *** [Kc 3d 2h]
d3e04f5d: bets 563
4f506b4: folds
372af7bb: folds
Uncalled bet (563) returned to d3e04f5d
*** SHOWDOWN ***
d3e04f5d collected 1,704 from pot
*** SUMMARY ***
Total pot 1,704 | Rake 0 | Jackpot 0 | Bingo 0 | Fortune 0 | Tax 0
Board [Kc 3d 2h]
Seat 1: cfd75398 folded before Flop
Seat 2: 372af7bb folded on the Flop
Seat 3: 59767af1 (button) folded before Flop
Seat 4: d3e04f5d (small blind) won (1,704)
Seat 5: 7293f0b8 (big blind) folded before Flop
Seat 6: 689b8f5 folded before Flop
Seat 7: Hero folded before Flop
Seat 8: 4f506b4 folded on the Flop


Poker Hand #TM3547322240: Tournament #156323098, Bounty Hunters $1.08 Hold'em No Limit - Level2(60/120) - 2024/08/03 22:41:22
Table '2' 8-max Seat #2 is the button
Seat 1: cfd75398 (22,004 in chips)
Seat 2: 372af7bb (10,690 in chips)
Seat 3: 59767af1 (11,884 in chips)
Seat 4: d3e04f5d (9,934 in chips)
Seat 5: 7293f0b8 (9,494 in chips)
Seat 6: 689b8f5 (4,716 in chips)
Seat 7: Hero (7,638 in chips)
Seat 8: 4f506b4 (13,700 in chips)
7293f0b8: posts the ante 18
cfd75398: posts the ante 18
59767af1: posts the ante 18
689b8f5: posts the ante 18
4f506b4: posts the ante 18
372af7bb: posts the ante 18
d3e04f5d: posts the ante 18
Hero: posts the ante 18
59767af1: posts small blind 60
d3e04f5d: posts big blind 120
*** HOLE CARDS ***
Dealt to cfd75398 
Dealt to 372af7bb 
Dealt to 59767af1 
Dealt to d3e04f5d 
Dealt to 7293f0b8 
Dealt to 689b8f5 
Dealt to Hero [2h 4d]
Dealt to 4f506b4 
7293f0b8: folds
689b8f5: raises 120 to 240
Hero: folds
4f506b4: folds
cfd75398: calls 240
372af7bb: calls 240
59767af1: folds
d3e04f5d: calls 120
*** FLOP *** [7d 2s Qd]
d3e04f5d: checks
689b8f5: bets 120
cfd75398: calls 120
372af7bb: folds
d3e04f5d: calls 120
*** TURN *** [7d 2s Qd] [Jh]
d3e04f5d: checks
689b8f5: bets 1,884
cfd75398: folds
d3e04f5d: folds
Uncalled bet (1,884) returned to 689b8f5
*** SHOWDOWN ***
689b8f5 collected 1,524 from pot
*** SUMMARY ***
Total pot 1,524 | Rake 0 | Jackpot 0 | Bingo 0 | Fortune 0 | Tax 0
Board [7d 2s Qd Jh]
Seat 1: cfd75398 folded on the Turn
Seat 2: 372af7bb (button) folded on the Flop
Seat 3: 59767af1 (small blind) folded before Flop
Seat 4: d3e04f5d (big blind) folded on the Turn
Seat 5: 7293f0b8 folded before Flop
Seat 6: 689b8f5 won (1,524)
Seat 7: Hero folded before Flop
Seat 8: 4f506b4 folded before Flop


Poker Hand #TM3547322116: Tournament #156323098, Bounty Hunters $1.08 Hold'em No Limit - Level2(60/120) - 2024/08/03 22:40:01
Table '2' 8-max Seat #1 is the button
Seat 1: cfd75398 (22,022 in chips)
Seat 2: 372af7bb (5,051 in chips)
Seat 3: 59767af1 (12,142 in chips)
Seat 4: d3e04f5d (9,952 in chips)
Seat 5: 7293f0b8 (9,512 in chips)
Seat 6: 689b8f5 (9,767 in chips)
Seat 7: Hero (7,656 in chips)
Seat 8: 4f506b4 (13,958 in chips)
7293f0b8: posts the ante 18
cfd75398: posts the ante 18
59767af1: posts the ante 18
689b8f5: posts the ante 18
4f506b4: posts the ante 18
372af7bb: posts the ante 18
d3e04f5d: posts the ante 18
Hero: posts the ante 18
372af7bb: posts small blind 60
59767af1: posts big blind 120
*** HOLE CARDS ***
Dealt to cfd75398 
Dealt to 372af7bb 
Dealt to 59767af1 
Dealt to d3e04f5d 
Dealt to 7293f0b8 
Dealt to 689b8f5 
Dealt to Hero [6s 8c]
Dealt to 4f506b4 
d3e04f5d: folds
7293f0b8: folds
689b8f5: raises 120 to 240
Hero: folds
4f506b4: calls 240
cfd75398: folds
372af7bb: calls 180
59767af1: calls 120
*** FLOP *** [2d Td 7h]
372af7bb: checks
59767af1: checks
689b8f5: bets 1,344
4f506b4: folds
372af7bb: raises 3,449 to 4,793 and is all-in
59767af1: folds
689b8f5: calls 3,449
372af7bb: shows [7d 8d] (Pair of Sevens)
689b8f5: shows [Ah 8h] (Ace-High)
*** TURN *** [2d Td 7h] [4s]
*** RIVER *** [2d Td 7h 4s] [4c]
*** SHOWDOWN ***
372af7bb collected 10,690 from pot
*** SUMMARY ***
Total pot 10,690 | Rake 0 | Jackpot 0 | Bingo 0 | Fortune 0 | Tax 0
Board [2d Td 7h 4s 4c]
Seat 1: cfd75398 (button) folded before Flop
Seat 2: 372af7bb (small blind) showed [7d 8d] and won (10,690) with Pair of Sevens and Pair of Fours
Seat 3: 59767af1 (big blind) folded on the Flop
Seat 4: d3e04f5d folded before Flop
Seat 5: 7293f0b8 folded before Flop
Seat 6: 689b8f5 showed [Ah 8h] and lost with Pair of Fours
Seat 7: Hero folded before Flop
Seat 8: 4f506b4 folded on the Flop


Poker Hand #TM3547321992: Tournament #156323098, Bounty Hunters $1.08 Hold'em No Limit - Level2(60/120) - 2024/08/03 22:38:30
Table '2' 8-max Seat #8 is the button
Seat 1: cfd75398 (22,100 in chips)
Seat 2: 372af7bb (9,950 in chips)
Seat 3: 59767af1 (12,160 in chips)
Seat 4: d3e04f5d (9,970 in chips)
Seat 5: 7293f0b8 (9,530 in chips)
Seat 6: 689b8f5 (9,785 in chips)
Seat 7: Hero (8,316 in chips)
Seat 8: 4f506b4 (8,249 in chips)
7293f0b8: posts the ante 18
cfd75398: posts the ante 18
59767af1: posts the ante 18
689b8f5: posts the ante 18
4f506b4: posts the ante 18
372af7bb: posts the ante 18
d3e04f5d: posts the ante 18
Hero: posts the ante 18
cfd75398: posts small blind 60
372af7bb: posts big blind 120
*** HOLE CARDS ***
Dealt to cfd75398 
Dealt to 372af7bb 
Dealt to 59767af1 
Dealt to d3e04f5d 
Dealt to 7293f0b8 
Dealt to 689b8f5 
Dealt to Hero [2h 2s]
Dealt to 4f506b4 
59767af1: folds
d3e04f5d: folds
7293f0b8: folds
689b8f5: folds
Hero: raises 120 to 240
4f506b4: raises 402 to 642
cfd75398: folds
372af7bb: calls 522
Hero: calls 402
*** FLOP *** [Jh Ks Qd]
372af7bb: checks
Hero: checks
4f506b4: bets 703
372af7bb: calls 703
Hero: folds
*** TURN *** [Jh Ks Qd] [4d]
372af7bb: checks
4f506b4: checks
*** RIVER *** [Jh Ks Qd 4d] [6d]
372af7bb: checks
4f506b4: bets 3,536
372af7bb: calls 3,536
4f506b4: shows [Jd Td] (Queen High Flush)
372af7bb: shows [Tc Kc] (Pair of Kings)
*** SHOWDOWN ***
4f506b4 collected 10,608 from pot
*** SUMMARY ***
Total pot 10,608 | Rake 0 | Jackpot 0 | Bingo 0 | Fortune 0 | Tax 0
Board [Jh Ks Qd 4d 6d]
Seat 1: cfd75398 (small blind) folded before Flop
Seat 2: 372af7bb (big blind) showed [Tc Kc] and lost with Pair of Kings
Seat 3: 59767af1 folded before Flop
Seat 4: d3e04f5d folded before Flop
Seat 5: 7293f0b8 folded before Flop
Seat 6: 689b8f5 folded before Flop
Seat 7: Hero folded on the Flop
Seat 8: 4f506b4 (button) showed [Jd Td] and won (10,608) with Queen High Flush


Poker Hand #TM3547321825: Tournament #156323098, Bounty Hunters $1.08 Hold'em No Limit - Level1(50/100) - 2024/08/03 22:36:35
Table '2' 8-max Seat #7 is the button
Seat 1: cfd75398 (22,215 in chips)
Seat 2: 372af7bb (9,965 in chips)
Seat 3: 59767af1 (10,205 in chips)
Seat 4: d3e04f5d (9,985 in chips)
Seat 5: 7293f0b8 (9,545 in chips)
Seat 6: 689b8f5 (10,000 in chips)
Seat 7: Hero (8,531 in chips)
Seat 8: 4f506b4 (9,614 in chips)
7293f0b8: posts the ante 15
cfd75398: posts the ante 15
59767af1: posts the ante 15
689b8f5: posts the ante 15
4f506b4: posts the ante 15
372af7bb: posts the ante 15
d3e04f5d: posts the ante 15
Hero: posts the ante 15
4f506b4: posts small blind 50
cfd75398: posts big blind 100
*** HOLE CARDS ***
Dealt to cfd75398 
Dealt to 372af7bb 
Dealt to 59767af1 
Dealt to d3e04f5d 
Dealt to 7293f0b8 
Dealt to 689b8f5 
Dealt to Hero [5c 3c]
Dealt to 4f506b4 
372af7bb: folds
59767af1: raises 100 to 200
d3e04f5d: folds
7293f0b8: folds
689b8f5: calls 200
Hero: calls 200
4f506b4: calls 150
cfd75398: folds
*** FLOP *** [9s Qd 4s]
4f506b4: checks
59767af1: bets 300
689b8f5: folds
Hero: folds
4f506b4: calls 300
*** TURN *** [9s Qd 4s] [5h]
4f506b4: checks
59767af1: bets 850
4f506b4: calls 850
*** RIVER *** [9s Qd 4s 5h] [As]
4f506b4: checks
59767af1: bets 2,150
4f506b4: folds
Uncalled bet (2,150) returned to 59767af1
*** SHOWDOWN ***
59767af1 collected 3,320 from pot
*** SUMMARY ***
Total pot 3,320 | Rake 0 | Jackpot 0 | Bingo 0 | Fortune 0 | Tax 0
Board [9s Qd 4s 5h As]
Seat 1: cfd75398 (big blind) folded before Flop
Seat 2: 372af7bb folded before Flop
Seat 3: 59767af1 won (3,320)
Seat 4: d3e04f5d folded before Flop
Seat 5: 7293f0b8 folded before Flop
Seat 6: 689b8f5 folded on the Flop
Seat 7: Hero (button) folded on the Flop
Seat 8: 4f506b4 (small blind) folded on the River


Poker Hand #TM3547321732: Tournament #156323098, Bounty Hunters $1.08 Hold'em No Limit - Level1(50/100) - 2024/08/03 22:35:28
Table '2' 8-max Seat #5 is the button
Seat 1: cfd75398 (22,230 in chips)
Seat 2: 372af7bb (9,980 in chips)
Seat 3: 59767af1 (10,220 in chips)
Seat 4: d3e04f5d (10,000 in chips)
Seat 5: 7293f0b8 (9,560 in chips)
Seat 7: Hero (9,190 in chips)
Seat 8: 4f506b4 (8,880 in chips)
7293f0b8: posts the ante 15
cfd75398: posts the ante 15
59767af1: posts the ante 15
4f506b4: posts the ante 15
372af7bb: posts the ante 15
d3e04f5d: posts the ante 15
Hero: posts the ante 15
Hero: posts small blind 50
4f506b4: posts big blind 100
*** HOLE CARDS ***
Dealt to cfd75398 
Dealt to 372af7bb 
Dealt to 59767af1 
Dealt to d3e04f5d 
Dealt to 7293f0b8 
Dealt to Hero [Qc 9s]
Dealt to 4f506b4 
cfd75398: folds
372af7bb: folds
59767af1: folds
d3e04f5d: folds
7293f0b8: folds
Hero: raises 100 to 200
4f506b4: calls 100
*** FLOP *** [4c 7s 3d]
Hero: bets 167
4f506b4: calls 167
*** TURN *** [4c 7s 3d] [7h]
Hero: bets 277
4f506b4: calls 277
*** RIVER *** [4c 7s 3d 7h] [Ad]
Hero: checks
4f506b4: bets 1,393
Hero: folds
Uncalled bet (1,393) returned to 4f506b4
*** SHOWDOWN ***
4f506b4 collected 1,393 from pot
*** SUMMARY ***
Total pot 1,393 | Rake 0 | Jackpot 0 | Bingo 0 | Fortune 0 | Tax 0
Board [4c 7s 3d 7h Ad]
Seat 1: cfd75398 folded before Flop
Seat 2: 372af7bb folded before Flop
Seat 3: 59767af1 folded before Flop
Seat 4: d3e04f5d folded before Flop
Seat 5: 7293f0b8 (button) folded before Flop
Seat 7: Hero (small blind) folded on the River
Seat 8: 4f506b4 (big blind) won (1,393)


Poker Hand #TM3547321706: Tournament #156323098, Bounty Hunters $1.08 Hold'em No Limit - Level1(50/100) - 2024/08/03 22:35:10
Table '2' 8-max Seat #3 is the button
Seat 1: cfd75398 (22,245 in chips)
Seat 2: 372af7bb (9,995 in chips)
Seat 3: 59767af1 (9,995 in chips)
Seat 5: 7293f0b8 (9,625 in chips)
Seat 7: Hero (9,305 in chips)
Seat 8: 4f506b4 (8,895 in chips)
7293f0b8: posts the ante 15
cfd75398: posts the ante 15
59767af1: posts the ante 15
4f506b4: posts the ante 15
372af7bb: posts the ante 15
Hero: posts the ante 15
7293f0b8: posts small blind 50
Hero: posts big blind 100
*** HOLE CARDS ***
Dealt to cfd75398 
Dealt to 372af7bb 
Dealt to 59767af1 
Dealt to 7293f0b8 
Dealt to Hero [9d 4h]
Dealt to 4f506b4 
4f506b4: folds
cfd75398: folds
372af7bb: folds
59767af1: raises 100 to 200
7293f0b8: folds
Hero: folds
Uncalled bet (100) returned to 59767af1
*** SHOWDOWN ***
59767af1 collected 340 from pot
*** SUMMARY ***
Total pot 340 | Rake 0 | Jackpot 0 | Bingo 0 | Fortune 0 | Tax 0
Seat 1: cfd75398 folded before Flop
Seat 2: 372af7bb folded before Flop
Seat 3: 59767af1 (button) collected (340)
Seat 5: 7293f0b8 (small blind) folded before Flop
Seat 7: Hero (big blind) folded before Flop
Seat 8: 4f506b4 folded before Flop


Poker Hand #TM3547321591: Tournament #156323098, Bounty Hunters $1.08 Hold'em No Limit - Level1(50/100) - 2024/08/03 22:33:47
Table '2' 8-max Seat #2 is the button
Seat 1: cfd75398 (11,860 in chips)
Seat 2: 372af7bb (10,010 in chips)
Seat 3: 59767af1 (10,060 in chips)
Seat 5: 7293f0b8 (9,740 in chips)
Seat 6: 2d97c72 (9,940 in chips)
Seat 7: Hero (9,540 in chips)
Seat 8: 4f506b4 (8,910 in chips)
7293f0b8: posts the ante 15
cfd75398: posts the ante 15
59767af1: posts the ante 15
4f506b4: posts the ante 15
2d97c72: posts the ante 15
372af7bb: posts the ante 15
Hero: posts the ante 15
59767af1: posts small blind 50
7293f0b8: posts big blind 100
*** HOLE CARDS ***
Dealt to cfd75398 
Dealt to 372af7bb 
Dealt to 59767af1 
Dealt to 7293f0b8 
Dealt to 2d97c72 
Dealt to Hero [2c 2h]
Dealt to 4f506b4 
2d97c72: raises 120 to 220
Hero: calls 220
4f506b4: folds
cfd75398: raises 680 to 900
372af7bb: folds
59767af1: folds
7293f0b8: folds
2d97c72: raises 1,200 to 2,100
Hero: folds
cfd75398: calls 1,200
*** FLOP *** [6c 8h 3s]
2d97c72: bets 2,400
cfd75398: raises 2,400 to 4,800
2d97c72: raises 3,025 to 7,825 and is all-in
cfd75398: calls 3,025
2d97c72: shows [Ks Kd] (Pair of Kings)
cfd75398: shows [As Ad] (Pair of Aces)
*** TURN *** [6c 8h 3s] [7s]
*** RIVER *** [6c 8h 3s 7s] [5h]
*** SHOWDOWN ***
cfd75398 collected 20,325 from pot
*** SUMMARY ***
Total pot 20,325 | Rake 0 | Jackpot 0 | Bingo 0 | Fortune 0 | Tax 0
Board [6c 8h 3s 7s 5h]
Seat 1: cfd75398 showed [As Ad] and won (20,325) with Pair of Aces
Seat 2: 372af7bb (button) folded before Flop
Seat 3: 59767af1 (small blind) folded before Flop
Seat 5: 7293f0b8 (big blind) folded before Flop
Seat 6: 2d97c72 showed [Ks Kd] and lost with Pair of Kings
Seat 7: Hero folded before Flop
Seat 8: 4f506b4 folded before Flop


Poker Hand #TM3547321470: Tournament #156323098, Bounty Hunters $1.08 Hold'em No Limit - Level1(50/100) - 2024/08/03 22:32:26
Table '2' 8-max Seat #1 is the button
Seat 1: cfd75398 (11,875 in chips)
Seat 2: 372af7bb (10,125 in chips)
Seat 3: 59767af1 (9,755 in chips)
Seat 4: 214e9831 (9,955 in chips)
Seat 5: 7293f0b8 (9,755 in chips)
Seat 6: 2d97c72 (9,955 in chips)
Seat 7: Hero (9,555 in chips)
Seat 8: 4f506b4 (9,025 in chips)
7293f0b8: posts the ante 15
cfd75398: posts the ante 15
59767af1: posts the ante 15
214e9831: posts the ante 15
4f506b4: posts the ante 15
2d97c72: posts the ante 15
372af7bb: posts the ante 15
Hero: posts the ante 15
372af7bb: posts small blind 50
59767af1: posts big blind 100
*** HOLE CARDS ***
Dealt to cfd75398 
Dealt to 372af7bb 
Dealt to 59767af1 
Dealt to 214e9831 
Dealt to 7293f0b8 
Dealt to 2d97c72 
Dealt to Hero [6s 9c]
Dealt to 4f506b4 
214e9831: folds
7293f0b8: folds
2d97c72: folds
Hero: folds
4f506b4: calls 100
cfd75398: folds
372af7bb: calls 50
59767af1: checks
*** FLOP *** [9d 5h As]
372af7bb: checks
59767af1: checks
4f506b4: checks
*** TURN *** [9d 5h As] [Qh]
372af7bb: checks
59767af1: checks
4f506b4: checks
*** RIVER *** [9d 5h As Qh] [5c]
372af7bb: checks
59767af1: bets 150
4f506b4: folds
372af7bb: folds
Uncalled bet (150) returned to 59767af1
*** SHOWDOWN ***
59767af1 collected 420 from pot
*** SUMMARY ***
Total pot 420 | Rake 0 | Jackpot 0 | Bingo 0 | Fortune 0 | Tax 0
Board [9d 5h As Qh 5c]
Seat 1: cfd75398 (button) folded before Flop
Seat 2: 372af7bb (small blind) folded on the River
Seat 3: 59767af1 (big blind) won (420)
Seat 4: 214e9831 folded before Flop
Seat 5: 7293f0b8 folded before Flop
Seat 6: 2d97c72 folded before Flop
Seat 7: Hero folded before Flop
Seat 8: 4f506b4 folded on the River


Poker Hand #TM3547321377: Tournament #156323098, Bounty Hunters $1.08 Hold'em No Limit - Level1(50/100) - 2024/08/03 22:31:23
Table '2' 8-max Seat #8 is the button
Seat 1: cfd75398 (9,870 in chips)
Seat 2: 372af7bb (10,240 in chips)
Seat 3: 59767af1 (9,970 in chips)
Seat 4: 214e9831 (9,970 in chips)
Seat 5: 7293f0b8 (9,770 in chips)
Seat 6: 2d97c72 (9,970 in chips)
Seat 7: Hero (9,770 in chips)
Seat 8: 4f506b4 (10,440 in chips)
7293f0b8: posts the ante 15
cfd75398: posts the ante 15
59767af1: posts the ante 15
214e9831: posts the ante 15
4f506b4: posts the ante 15
2d97c72: posts the ante 15
372af7bb: posts the ante 15
Hero: posts the ante 15
cfd75398: posts small blind 50
372af7bb: posts big blind 100
*** HOLE CARDS ***
Dealt to cfd75398 
Dealt to 372af7bb 
Dealt to 59767af1 
Dealt to 214e9831 
Dealt to 7293f0b8 
Dealt to 2d97c72 
Dealt to Hero [Qc Jd]
Dealt to 4f506b4 
59767af1: raises 100 to 200
214e9831: folds
7293f0b8: folds
2d97c72: folds
Hero: calls 200
4f506b4: calls 200
cfd75398: raises 1,200 to 1,400
372af7bb: folds
59767af1: folds
Hero: folds
4f506b4: calls 1,200
*** FLOP *** [Jc 8c 2d]
cfd75398: bets 1,129
4f506b4: folds
Uncalled bet (1,129) returned to cfd75398
*** SHOWDOWN ***
cfd75398 collected 3,420 from pot
*** SUMMARY ***
Total pot 3,420 | Rake 0 | Jackpot 0 | Bingo 0 | Fortune 0 | Tax 0
Board [Jc 8c 2d]
Seat 1: cfd75398 (small blind) won (3,420)
Seat 2: 372af7bb (big blind) folded before Flop
Seat 3: 59767af1 folded before Flop
Seat 4: 214e9831 folded before Flop
Seat 5: 7293f0b8 folded before Flop
Seat 6: 2d97c72 folded before Flop
Seat 7: Hero folded before Flop
Seat 8: 4f506b4 (button) folded on the Flop


Poker Hand #TM3547321330: Tournament #156323098, Bounty Hunters $1.08 Hold'em No Limit - Level1(50/100) - 2024/08/03 22:30:50
Table '2' 8-max Seat #7 is the button
Seat 1: cfd75398 (9,985 in chips)
Seat 2: 372af7bb (9,985 in chips)
Seat 3: 59767af1 (9,985 in chips)
Seat 4: 214e9831 (9,985 in chips)
Seat 5: 7293f0b8 (9,785 in chips)
Seat 6: 2d97c72 (9,985 in chips)
Seat 7: Hero (9,785 in chips)
Seat 8: 4f506b4 (10,505 in chips)
7293f0b8: posts the ante 15
cfd75398: posts the ante 15
59767af1: posts the ante 15
214e9831: posts the ante 15
4f506b4: posts the ante 15
2d97c72: posts the ante 15
372af7bb: posts the ante 15
Hero: posts the ante 15
4f506b4: posts small blind 50
cfd75398: posts big blind 100
*** HOLE CARDS ***
Dealt to cfd75398 
Dealt to 372af7bb 
Dealt to 59767af1 
Dealt to 214e9831 
Dealt to 7293f0b8 
Dealt to 2d97c72 
Dealt to Hero [9d Jh]
Dealt to 4f506b4 
372af7bb: raises 100 to 200
59767af1: folds
214e9831: folds
7293f0b8: folds
2d97c72: folds
Hero: folds
4f506b4: folds
cfd75398: folds
Uncalled bet (100) returned to 372af7bb
*** SHOWDOWN ***
372af7bb collected 370 from pot
*** SUMMARY ***
Total pot 370 | Rake 0 | Jackpot 0 | Bingo 0 | Fortune 0 | Tax 0
Seat 1: cfd75398 (big blind) folded before Flop
Seat 2: 372af7bb collected (370)
Seat 3: 59767af1 folded before Flop
Seat 4: 214e9831 folded before Flop
Seat 5: 7293f0b8 folded before Flop
Seat 6: 2d97c72 folded before Flop
Seat 7: Hero (button) folded before Flop
Seat 8: 4f506b4 (small blind) folded before Flop


Poker Hand #TM3547321260: Tournament #156323098, Bounty Hunters $1.08 Hold'em No Limit - Level1(50/100) - 2024/08/03 22:30:02
Table '2' 8-max Seat #6 is the button
Seat 1: cfd75398 (10,000 in chips)
Seat 2: 372af7bb (10,000 in chips)
Seat 3: 59767af1 (10,000 in chips)
Seat 4: 214e9831 (10,000 in chips)
Seat 5: 7293f0b8 (10,000 in chips)
Seat 6: 2d97c72 (10,000 in chips)
Seat 7: Hero (10,000 in chips)
Seat 8: 4f506b4 (10,000 in chips)
7293f0b8: posts the ante 15
cfd75398: posts the ante 15
59767af1: posts the ante 15
214e9831: posts the ante 15
4f506b4: posts the ante 15
2d97c72: posts the ante 15
372af7bb: posts the ante 15
Hero: posts the ante 15
Hero: posts small blind 50
4f506b4: posts big blind 100
*** HOLE CARDS ***
Dealt to cfd75398 
Dealt to 372af7bb 
Dealt to 59767af1 
Dealt to 214e9831 
Dealt to 7293f0b8 
Dealt to 2d97c72 
Dealt to Hero [Ad 7s]
Dealt to 4f506b4 
cfd75398: folds
372af7bb: folds
59767af1: folds
214e9831: folds
7293f0b8: raises 100 to 200
2d97c72: folds
Hero: calls 150
4f506b4: raises 720 to 920
7293f0b8: folds
Hero: folds
Uncalled bet (720) returned to 4f506b4
*** SHOWDOWN ***
4f506b4 collected 720 from pot
*** SUMMARY ***
Total pot 720 | Rake 0 | Jackpot 0 | Bingo 0 | Fortune 0 | Tax 0
Seat 1: cfd75398 folded before Flop
Seat 2: 372af7bb folded before Flop
Seat 3: 59767af1 folded before Flop
Seat 4: 214e9831 folded before Flop
Seat 5: 7293f0b8 folded before Flop
Seat 6: 2d97c72 (button) folded before Flop
Seat 7: Hero (small blind) folded before Flop
Seat 8: 4f506b4 (big blind) collected (720)


