Poker Hand #TM3558271047: Tournament #156882940, Bounty Hunters Special $3.20 Hold'em No Limit - Level6(150/300) - 2024/08/07 11:29:44
Table '66' 8-max Seat #4 is the button
Seat 1: 3127cf67 (9,955 in chips)
Seat 2: 33e83bfb (20,428 in chips)
Seat 3: de681094 (24,029 in chips)
Seat 4: Hero (6,649 in chips)
Seat 5: 8dffcf83 (15,183 in chips)
Seat 6: a59fbcc (26,336 in chips)
Seat 7: fd34e284 (33,462 in chips)
Seat 8: 63283e02 (8,630 in chips)
8dffcf83: posts the ante 45
33e83bfb: posts the ante 45
de681094: posts the ante 45
fd34e284: posts the ante 45
Hero: posts the ante 45
a59fbcc: posts the ante 45
3127cf67: posts the ante 45
63283e02: posts the ante 45
8dffcf83: posts small blind 150
a59fbcc: posts big blind 300
*** HOLE CARDS ***
Dealt to 3127cf67 
Dealt to 33e83bfb 
Dealt to de681094 
Dealt to Hero [5s 5h]
Dealt to 8dffcf83 
Dealt to a59fbcc 
Dealt to fd34e284 
Dealt to 63283e02 
fd34e284: calls 300
63283e02: calls 300
3127cf67: folds
33e83bfb: raises 900 to 1,200
de681094: calls 1,200
Hero: raises 5,404 to 6,604 and is all-in
8dffcf83: folds
a59fbcc: folds
fd34e284: calls 6,304
63283e02: raises 1,981 to 8,585 and is all-in
33e83bfb: raises 11,798 to 20,383 and is all-in
de681094: folds
fd34e284: calls 13,779
33e83bfb: shows [Jd Jc]
Hero: shows [5s 5h]
fd34e284: shows [Kc Jh]
63283e02: shows [Kh Qd]
*** FLOP *** [7d Tc 4h]
*** TURN *** [7d Tc 4h] [9d]
*** RIVER *** [7d Tc 4h 9d] [7s]
de681094: shows [Qh Ad] (Pair of Sevens)
*** SHOWDOWN ***
33e83bfb collected 28,426 from pot
33e83bfb collected 5,943 from pot
33e83bfb collected 23,596 from pot
*** SUMMARY ***
Total pot 57,965 | Rake 0 | Jackpot 0 | Bingo 0 | Fortune 0 | Tax 0
Board [7d Tc 4h 9d 7s]
Seat 1: 3127cf67 folded before Flop
Seat 2: 33e83bfb showed [Jd Jc] and won (57,965) with Pair of Jacks and Pair of Sevens
Seat 3: de681094 folded before Flop
Seat 4: Hero (button) showed [5s 5h] and lost with Pair of Sevens and Pair of Fives
Seat 5: 8dffcf83 (small blind) folded before Flop
Seat 6: a59fbcc (big blind) folded before Flop
Seat 7: fd34e284 showed [Kc Jh] and lost with Pair of Sevens
Seat 8: 63283e02 showed [Kh Qd] and lost with Pair of Sevens


Poker Hand #TM3558270993: Tournament #156882940, Bounty Hunters Special $3.20 Hold'em No Limit - Level6(150/300) - 2024/08/07 11:28:17
Table '66' 8-max Seat #3 is the button
Seat 1: 3127cf67 (10,000 in chips)
Seat 2: 33e83bfb (21,103 in chips)
Seat 3: de681094 (17,775 in chips)
Seat 4: Hero (6,844 in chips)
Seat 5: 8dffcf83 (15,528 in chips)
Seat 6: a59fbcc (26,381 in chips)
Seat 7: fd34e284 (38,366 in chips)
Seat 8: 63283e02 (8,675 in chips)
8dffcf83: posts the ante 45
33e83bfb: posts the ante 45
de681094: posts the ante 45
fd34e284: posts the ante 45
a59fbcc: posts the ante 45
Hero: posts the ante 45
3127cf67: posts the ante 45
63283e02: posts the ante 45
Hero: posts small blind 150
8dffcf83: posts big blind 300
*** HOLE CARDS ***
Dealt to 3127cf67 
Dealt to 33e83bfb 
Dealt to de681094 
Dealt to Hero [4c Kc]
Dealt to 8dffcf83 
Dealt to a59fbcc 
Dealt to fd34e284 
Dealt to 63283e02 
a59fbcc: folds
fd34e284: raises 330 to 630
63283e02: folds
3127cf67: folds
33e83bfb: calls 630
de681094: raises 1,830 to 2,460
Hero: folds
8dffcf83: folds
fd34e284: calls 1,830
33e83bfb: folds
*** FLOP *** [9h 8c 3h]
fd34e284: checks
de681094: bets 2,399
fd34e284: calls 2,399
*** TURN *** [9h 8c 3h] [Kh]
fd34e284: checks
de681094: bets 12,871 and is all-in
fd34e284: folds
Uncalled bet (12,871) returned to de681094
*** SHOWDOWN ***
de681094 collected 11,158 from pot
*** SUMMARY ***
Total pot 11,158 | Rake 0 | Jackpot 0 | Bingo 0 | Fortune 0 | Tax 0
Board [9h 8c 3h Kh]
Seat 1: 3127cf67 folded before Flop
Seat 2: 33e83bfb folded before Flop
Seat 3: de681094 (button) won (11,158)
Seat 4: Hero (small blind) folded before Flop
Seat 5: 8dffcf83 (big blind) folded before Flop
Seat 6: a59fbcc folded before Flop
Seat 7: fd34e284 folded on the Turn
Seat 8: 63283e02 folded before Flop


Poker Hand #TM3558270966: Tournament #156882940, Bounty Hunters Special $3.20 Hold'em No Limit - Level6(150/300) - 2024/08/07 11:27:42
Table '66' 8-max Seat #2 is the button
Seat 2: 33e83bfb (21,148 in chips)
Seat 3: de681094 (17,970 in chips)
Seat 4: Hero (7,189 in chips)
Seat 5: 8dffcf83 (15,573 in chips)
Seat 6: a59fbcc (26,426 in chips)
Seat 7: fd34e284 (38,411 in chips)
Seat 8: 63283e02 (7,955 in chips)
8dffcf83: posts the ante 45
33e83bfb: posts the ante 45
de681094: posts the ante 45
fd34e284: posts the ante 45
a59fbcc: posts the ante 45
Hero: posts the ante 45
63283e02: posts the ante 45
de681094: posts small blind 150
Hero: posts big blind 300
*** HOLE CARDS ***
Dealt to 33e83bfb 
Dealt to de681094 
Dealt to Hero [Jd 6d]
Dealt to 8dffcf83 
Dealt to a59fbcc 
Dealt to fd34e284 
Dealt to 63283e02 
8dffcf83: folds
a59fbcc: folds
fd34e284: folds
63283e02: raises 300 to 600
33e83bfb: folds
de681094: folds
Hero: folds
Uncalled bet (300) returned to 63283e02
*** SHOWDOWN ***
63283e02 collected 1,065 from pot
*** SUMMARY ***
Total pot 1,065 | Rake 0 | Jackpot 0 | Bingo 0 | Fortune 0 | Tax 0
Seat 2: 33e83bfb (button) folded before Flop
Seat 3: de681094 (small blind) folded before Flop
Seat 4: Hero (big blind) folded before Flop
Seat 5: 8dffcf83 folded before Flop
Seat 6: a59fbcc folded before Flop
Seat 7: fd34e284 folded before Flop
Seat 8: 63283e02 collected (1,065)


Poker Hand #TM3558270929: Tournament #156882940, Bounty Hunters Special $3.20 Hold'em No Limit - Level6(150/300) - 2024/08/07 11:26:48
Table '66' 8-max Seat #8 is the button
Seat 2: 33e83bfb (17,872 in chips)
Seat 3: de681094 (18,315 in chips)
Seat 4: Hero (9,940 in chips)
Seat 5: 8dffcf83 (15,618 in chips)
Seat 6: a59fbcc (26,471 in chips)
Seat 7: fd34e284 (38,456 in chips)
Seat 8: 63283e02 (8,000 in chips)
8dffcf83: posts the ante 45
33e83bfb: posts the ante 45
de681094: posts the ante 45
fd34e284: posts the ante 45
a59fbcc: posts the ante 45
Hero: posts the ante 45
63283e02: posts the ante 45
33e83bfb: posts small blind 150
de681094: posts big blind 300
*** HOLE CARDS ***
Dealt to 33e83bfb 
Dealt to de681094 
Dealt to Hero [9c Ad]
Dealt to 8dffcf83 
Dealt to a59fbcc 
Dealt to fd34e284 
Dealt to 63283e02 
Hero: raises 300 to 600
8dffcf83: folds
a59fbcc: folds
fd34e284: folds
63283e02: folds
33e83bfb: calls 450
de681094: folds
*** FLOP *** [Qc Tc 9h]
33e83bfb: checks
Hero: bets 599
33e83bfb: calls 599
*** TURN *** [Qc Tc 9h] [7c]
33e83bfb: checks
Hero: bets 1,507
33e83bfb: calls 1,507
*** RIVER *** [Qc Tc 9h 7c] [6c]
33e83bfb: checks
Hero: checks
33e83bfb: shows [Qs Ac] (Ace High Flush)
Hero: shows [9c Ad] (Queen High Flush)
*** SHOWDOWN ***
33e83bfb collected 6,027 from pot
*** SUMMARY ***
Total pot 6,027 | Rake 0 | Jackpot 0 | Bingo 0 | Fortune 0 | Tax 0
Board [Qc Tc 9h 7c 6c]
Seat 2: 33e83bfb (small blind) showed [Qs Ac] and won (6,027) with Ace High Flush
Seat 3: de681094 (big blind) folded before Flop
Seat 4: Hero showed [9c Ad] and lost with Queen High Flush
Seat 5: 8dffcf83 folded before Flop
Seat 6: a59fbcc folded before Flop
Seat 7: fd34e284 folded before Flop
Seat 8: 63283e02 (button) folded before Flop


Poker Hand #TM3558270888: Tournament #156882940, Bounty Hunters Special $3.20 Hold'em No Limit - Level5(125/250) - 2024/08/07 11:25:46
Table '66' 8-max Seat #7 is the button
Seat 1: e4ed9462 (7,430 in chips)
Seat 2: 33e83bfb (17,907 in chips)
Seat 3: de681094 (10,550 in chips)
Seat 4: Hero (9,975 in chips)
Seat 5: 8dffcf83 (15,653 in chips)
Seat 6: a59fbcc (26,506 in chips)
Seat 7: fd34e284 (38,491 in chips)
Seat 8: 63283e02 (8,160 in chips)
e4ed9462: posts the ante 35
8dffcf83: posts the ante 35
33e83bfb: posts the ante 35
de681094: posts the ante 35
fd34e284: posts the ante 35
a59fbcc: posts the ante 35
Hero: posts the ante 35
63283e02: posts the ante 35
63283e02: posts small blind 125
e4ed9462: posts big blind 250
*** HOLE CARDS ***
Dealt to e4ed9462 
Dealt to 33e83bfb 
Dealt to de681094 
Dealt to Hero [3h 9d]
Dealt to 8dffcf83 
Dealt to a59fbcc 
Dealt to fd34e284 
Dealt to 63283e02 
33e83bfb: folds
de681094: raises 250 to 500
Hero: folds
8dffcf83: folds
a59fbcc: folds
fd34e284: folds
63283e02: folds
e4ed9462: calls 250
*** FLOP *** [6h 9c 3s]
e4ed9462: checks
de681094: bets 464
e4ed9462: calls 464
*** TURN *** [6h 9c 3s] [Qc]
e4ed9462: checks
de681094: bets 1,417
e4ed9462: calls 1,417
*** RIVER *** [6h 9c 3s Qc] [5s]
e4ed9462: checks
de681094: bets 6,500
e4ed9462: calls 5,014 and is all-in
Uncalled bet (1,486) returned to de681094
de681094: shows [Qd Th] (Pair of Queens)
e4ed9462: shows [Js 9s] (Pair of Nines)
*** SHOWDOWN ***
de681094 collected 15,195 from pot
*** SUMMARY ***
Total pot 15,195 | Rake 0 | Jackpot 0 | Bingo 0 | Fortune 0 | Tax 0
Board [6h 9c 3s Qc 5s]
Seat 1: e4ed9462 (big blind) showed [Js 9s] and lost with Pair of Nines
Seat 2: 33e83bfb folded before Flop
Seat 3: de681094 showed [Qd Th] and won (15,195) with Pair of Queens
Seat 4: Hero folded before Flop
Seat 5: 8dffcf83 folded before Flop
Seat 6: a59fbcc folded before Flop
Seat 7: fd34e284 (button) folded before Flop
Seat 8: 63283e02 (small blind) folded before Flop


Poker Hand #TM3558270869: Tournament #156882940, Bounty Hunters Special $3.20 Hold'em No Limit - Level5(125/250) - 2024/08/07 11:25:12
Table '66' 8-max Seat #6 is the button
Seat 1: e4ed9462 (7,465 in chips)
Seat 2: 33e83bfb (17,942 in chips)
Seat 3: de681094 (10,585 in chips)
Seat 4: Hero (9,355 in chips)
Seat 5: 8dffcf83 (15,688 in chips)
Seat 6: a59fbcc (26,541 in chips)
Seat 7: fd34e284 (38,651 in chips)
Seat 8: 63283e02 (8,445 in chips)
e4ed9462: posts the ante 35
8dffcf83: posts the ante 35
33e83bfb: posts the ante 35
de681094: posts the ante 35
fd34e284: posts the ante 35
a59fbcc: posts the ante 35
Hero: posts the ante 35
63283e02: posts the ante 35
fd34e284: posts small blind 125
63283e02: posts big blind 250
*** HOLE CARDS ***
Dealt to e4ed9462 
Dealt to 33e83bfb 
Dealt to de681094 
Dealt to Hero [9s Ks]
Dealt to 8dffcf83 
Dealt to a59fbcc 
Dealt to fd34e284 
Dealt to 63283e02 
e4ed9462: folds
33e83bfb: folds
de681094: folds
Hero: raises 375 to 625
8dffcf83: folds
a59fbcc: folds
fd34e284: folds
63283e02: folds
Uncalled bet (375) returned to Hero
*** SHOWDOWN ***
Hero collected 905 from pot
*** SUMMARY ***
Total pot 905 | Rake 0 | Jackpot 0 | Bingo 0 | Fortune 0 | Tax 0
Seat 1: e4ed9462 folded before Flop
Seat 2: 33e83bfb folded before Flop
Seat 3: de681094 folded before Flop
Seat 4: Hero collected (905)
Seat 5: 8dffcf83 folded before Flop
Seat 6: a59fbcc (button) folded before Flop
Seat 7: fd34e284 (small blind) folded before Flop
Seat 8: 63283e02 (big blind) folded before Flop


Poker Hand #TM3558270843: Tournament #156882940, Bounty Hunters Special $3.20 Hold'em No Limit - Level5(125/250) - 2024/08/07 11:24:31
Table '66' 8-max Seat #5 is the button
Seat 1: e4ed9462 (7,500 in chips)
Seat 2: 33e83bfb (18,227 in chips)
Seat 3: de681094 (10,620 in chips)
Seat 4: Hero (9,390 in chips)
Seat 5: 8dffcf83 (15,723 in chips)
Seat 6: a59fbcc (25,796 in chips)
Seat 7: fd34e284 (38,936 in chips)
Seat 8: 63283e02 (8,480 in chips)
e4ed9462: posts the ante 35
8dffcf83: posts the ante 35
33e83bfb: posts the ante 35
de681094: posts the ante 35
fd34e284: posts the ante 35
Hero: posts the ante 35
a59fbcc: posts the ante 35
63283e02: posts the ante 35
a59fbcc: posts small blind 125
fd34e284: posts big blind 250
*** HOLE CARDS ***
Dealt to e4ed9462 
Dealt to 33e83bfb 
Dealt to de681094 
Dealt to Hero [9s 6c]
Dealt to 8dffcf83 
Dealt to a59fbcc 
Dealt to fd34e284 
Dealt to 63283e02 
63283e02: folds
e4ed9462: folds
33e83bfb: calls 250
de681094: folds
Hero: folds
8dffcf83: folds
a59fbcc: raises 1,030 to 1,280
fd34e284: folds
33e83bfb: folds
Uncalled bet (1,030) returned to a59fbcc
*** SHOWDOWN ***
a59fbcc collected 1,030 from pot
*** SUMMARY ***
Total pot 1,030 | Rake 0 | Jackpot 0 | Bingo 0 | Fortune 0 | Tax 0
Seat 1: e4ed9462 folded before Flop
Seat 2: 33e83bfb folded before Flop
Seat 3: de681094 folded before Flop
Seat 4: Hero folded before Flop
Seat 5: 8dffcf83 (button) folded before Flop
Seat 6: a59fbcc (small blind) collected (1,030)
Seat 7: fd34e284 (big blind) folded before Flop
Seat 8: 63283e02 folded before Flop


Poker Hand #TM3558270822: Tournament #156882940, Bounty Hunters Special $3.20 Hold'em No Limit - Level5(125/250) - 2024/08/07 11:24:06
Table '66' 8-max Seat #4 is the button
Seat 1: e4ed9462 (7,535 in chips)
Seat 2: 33e83bfb (18,262 in chips)
Seat 3: de681094 (10,000 in chips)
Seat 4: Hero (9,425 in chips)
Seat 5: 8dffcf83 (15,883 in chips)
Seat 6: a59fbcc (26,081 in chips)
Seat 7: fd34e284 (38,971 in chips)
Seat 8: 63283e02 (8,515 in chips)
e4ed9462: posts the ante 35
8dffcf83: posts the ante 35
33e83bfb: posts the ante 35
de681094: posts the ante 35
fd34e284: posts the ante 35
Hero: posts the ante 35
a59fbcc: posts the ante 35
63283e02: posts the ante 35
8dffcf83: posts small blind 125
a59fbcc: posts big blind 250
*** HOLE CARDS ***
Dealt to e4ed9462 
Dealt to 33e83bfb 
Dealt to de681094 
Dealt to Hero [6c Qs]
Dealt to 8dffcf83 
Dealt to a59fbcc 
Dealt to fd34e284 
Dealt to 63283e02 
fd34e284: folds
63283e02: folds
e4ed9462: folds
33e83bfb: folds
de681094: raises 250 to 500
Hero: folds
8dffcf83: folds
a59fbcc: folds
Uncalled bet (250) returned to de681094
*** SHOWDOWN ***
de681094 collected 905 from pot
*** SUMMARY ***
Total pot 905 | Rake 0 | Jackpot 0 | Bingo 0 | Fortune 0 | Tax 0
Seat 1: e4ed9462 folded before Flop
Seat 2: 33e83bfb folded before Flop
Seat 3: de681094 collected (905)
Seat 4: Hero (button) folded before Flop
Seat 5: 8dffcf83 (small blind) folded before Flop
Seat 6: a59fbcc (big blind) folded before Flop
Seat 7: fd34e284 folded before Flop
Seat 8: 63283e02 folded before Flop


Poker Hand #TM3558270786: Tournament #156882940, Bounty Hunters Special $3.20 Hold'em No Limit - Level5(125/250) - 2024/08/07 11:23:08
Table '66' 8-max Seat #2 is the button
Seat 1: e4ed9462 (7,570 in chips)
Seat 2: 33e83bfb (16,367 in chips)
Seat 4: Hero (9,585 in chips)
Seat 5: 8dffcf83 (16,168 in chips)
Seat 6: a59fbcc (27,426 in chips)
Seat 7: fd34e284 (39,006 in chips)
Seat 8: 63283e02 (8,550 in chips)
e4ed9462: posts the ante 35
8dffcf83: posts the ante 35
33e83bfb: posts the ante 35
fd34e284: posts the ante 35
a59fbcc: posts the ante 35
Hero: posts the ante 35
63283e02: posts the ante 35
Hero: posts small blind 125
8dffcf83: posts big blind 250
*** HOLE CARDS ***
Dealt to e4ed9462 
Dealt to 33e83bfb 
Dealt to Hero [Ks 8h]
Dealt to 8dffcf83 
Dealt to a59fbcc 
Dealt to fd34e284 
Dealt to 63283e02 
a59fbcc: raises 250 to 500
fd34e284: folds
63283e02: folds
e4ed9462: folds
33e83bfb: calls 500
Hero: folds
8dffcf83: folds
*** FLOP *** [9s Ad 9c]
a59fbcc: checks
33e83bfb: bets 810
a59fbcc: calls 810
*** TURN *** [9s Ad 9c] [Kd]
a59fbcc: checks
33e83bfb: bets 2,430
a59fbcc: folds
Uncalled bet (2,430) returned to 33e83bfb
*** SHOWDOWN ***
33e83bfb collected 3,240 from pot
*** SUMMARY ***
Total pot 3,240 | Rake 0 | Jackpot 0 | Bingo 0 | Fortune 0 | Tax 0
Board [9s Ad 9c Kd]
Seat 1: e4ed9462 folded before Flop
Seat 2: 33e83bfb (button) won (3,240)
Seat 4: Hero (small blind) folded before Flop
Seat 5: 8dffcf83 (big blind) folded before Flop
Seat 6: a59fbcc folded on the Turn
Seat 7: fd34e284 folded before Flop
Seat 8: 63283e02 folded before Flop


Poker Hand #TM3558270759: Tournament #156882940, Bounty Hunters Special $3.20 Hold'em No Limit - Level5(125/250) - 2024/08/07 11:22:30
Table '66' 8-max Seat #1 is the button
Seat 1: e4ed9462 (8,130 in chips)
Seat 2: 33e83bfb (16,527 in chips)
Seat 4: Hero (10,145 in chips)
Seat 5: 8dffcf83 (14,783 in chips)
Seat 6: a59fbcc (27,461 in chips)
Seat 7: fd34e284 (39,041 in chips)
Seat 8: 63283e02 (8,585 in chips)
e4ed9462: posts the ante 35
8dffcf83: posts the ante 35
33e83bfb: posts the ante 35
fd34e284: posts the ante 35
a59fbcc: posts the ante 35
Hero: posts the ante 35
63283e02: posts the ante 35
33e83bfb: posts small blind 125
Hero: posts big blind 250
*** HOLE CARDS ***
Dealt to e4ed9462 
Dealt to 33e83bfb 
Dealt to Hero [Ah Td]
Dealt to 8dffcf83 
Dealt to a59fbcc 
Dealt to fd34e284 
Dealt to 63283e02 
8dffcf83: raises 275 to 525
a59fbcc: folds
fd34e284: folds
63283e02: folds
e4ed9462: calls 525
33e83bfb: folds
Hero: calls 275
*** FLOP *** [Jc 6d 4s]
Hero: checks
8dffcf83: bets 642
e4ed9462: folds
Hero: folds
Uncalled bet (642) returned to 8dffcf83
*** SHOWDOWN ***
8dffcf83 collected 1,945 from pot
*** SUMMARY ***
Total pot 1,945 | Rake 0 | Jackpot 0 | Bingo 0 | Fortune 0 | Tax 0
Board [Jc 6d 4s]
Seat 1: e4ed9462 (button) folded on the Flop
Seat 2: 33e83bfb (small blind) folded before Flop
Seat 4: Hero (big blind) folded on the Flop
Seat 5: 8dffcf83 won (1,945)
Seat 6: a59fbcc folded before Flop
Seat 7: fd34e284 folded before Flop
Seat 8: 63283e02 folded before Flop


Poker Hand #TM3558270751: Tournament #156882940, Bounty Hunters Special $3.20 Hold'em No Limit - Level5(125/250) - 2024/08/07 11:22:15
Table '66' 8-max Seat #8 is the button
Seat 1: e4ed9462 (8,290 in chips)
Seat 2: 33e83bfb (16,812 in chips)
Seat 4: Hero (10,180 in chips)
Seat 5: 8dffcf83 (14,818 in chips)
Seat 6: a59fbcc (26,876 in chips)
Seat 7: fd34e284 (39,076 in chips)
Seat 8: 63283e02 (8,620 in chips)
e4ed9462: posts the ante 35
8dffcf83: posts the ante 35
33e83bfb: posts the ante 35
fd34e284: posts the ante 35
a59fbcc: posts the ante 35
Hero: posts the ante 35
63283e02: posts the ante 35
e4ed9462: posts small blind 125
33e83bfb: posts big blind 250
*** HOLE CARDS ***
Dealt to e4ed9462 
Dealt to 33e83bfb 
Dealt to Hero [Jc 7s]
Dealt to 8dffcf83 
Dealt to a59fbcc 
Dealt to fd34e284 
Dealt to 63283e02 
Hero: folds
8dffcf83: folds
a59fbcc: raises 300 to 550
fd34e284: folds
63283e02: folds
e4ed9462: folds
33e83bfb: folds
Uncalled bet (300) returned to a59fbcc
*** SHOWDOWN ***
a59fbcc collected 870 from pot
*** SUMMARY ***
Total pot 870 | Rake 0 | Jackpot 0 | Bingo 0 | Fortune 0 | Tax 0
Seat 1: e4ed9462 (small blind) folded before Flop
Seat 2: 33e83bfb (big blind) folded before Flop
Seat 4: Hero folded before Flop
Seat 5: 8dffcf83 folded before Flop
Seat 6: a59fbcc collected (870)
Seat 7: fd34e284 folded before Flop
Seat 8: 63283e02 (button) folded before Flop


Poker Hand #TM3558270720: Tournament #156882940, Bounty Hunters Special $3.20 Hold'em No Limit - Level5(125/250) - 2024/08/07 11:21:37
Table '66' 8-max Seat #7 is the button
Seat 1: e4ed9462 (9,075 in chips)
Seat 2: 33e83bfb (15,727 in chips)
Seat 4: Hero (10,215 in chips)
Seat 5: 8dffcf83 (14,853 in chips)
Seat 6: a59fbcc (26,911 in chips)
Seat 7: fd34e284 (39,111 in chips)
Seat 8: 63283e02 (8,780 in chips)
e4ed9462: posts the ante 35
8dffcf83: posts the ante 35
33e83bfb: posts the ante 35
fd34e284: posts the ante 35
a59fbcc: posts the ante 35
Hero: posts the ante 35
63283e02: posts the ante 35
63283e02: posts small blind 125
e4ed9462: posts big blind 250
*** HOLE CARDS ***
Dealt to e4ed9462 
Dealt to 33e83bfb 
Dealt to Hero [3h 2s]
Dealt to 8dffcf83 
Dealt to a59fbcc 
Dealt to fd34e284 
Dealt to 63283e02 
33e83bfb: raises 500 to 750
Hero: folds
8dffcf83: folds
a59fbcc: folds
fd34e284: folds
63283e02: folds
e4ed9462: calls 500
*** FLOP *** [8d 5c Ac]
e4ed9462: checks
33e83bfb: bets 935
e4ed9462: folds
Uncalled bet (935) returned to 33e83bfb
*** SHOWDOWN ***
33e83bfb collected 1,870 from pot
*** SUMMARY ***
Total pot 1,870 | Rake 0 | Jackpot 0 | Bingo 0 | Fortune 0 | Tax 0
Board [8d 5c Ac]
Seat 1: e4ed9462 (big blind) folded on the Flop
Seat 2: 33e83bfb won (1,870)
Seat 4: Hero folded before Flop
Seat 5: 8dffcf83 folded before Flop
Seat 6: a59fbcc folded before Flop
Seat 7: fd34e284 (button) folded before Flop
Seat 8: 63283e02 (small blind) folded before Flop


Poker Hand #TM3558270681: Tournament #156882940, Bounty Hunters Special $3.20 Hold'em No Limit - Level5(125/250) - 2024/08/07 11:20:47
Table '66' 8-max Seat #6 is the button
Seat 1: e4ed9462 (9,110 in chips)
Seat 2: 33e83bfb (15,762 in chips)
Seat 3: 597cc151 (13,539 in chips)
Seat 4: Hero (10,250 in chips)
Seat 5: 8dffcf83 (14,888 in chips)
Seat 6: a1924cdb (1,207 in chips)
Seat 7: fd34e284 (23,018 in chips)
Seat 8: 63283e02 (9,987 in chips)
e4ed9462: posts the ante 35
a1924cdb: posts the ante 35
8dffcf83: posts the ante 35
597cc151: posts the ante 35
33e83bfb: posts the ante 35
fd34e284: posts the ante 35
Hero: posts the ante 35
63283e02: posts the ante 35
fd34e284: posts small blind 125
63283e02: posts big blind 250
*** HOLE CARDS ***
Dealt to e4ed9462 
Dealt to 33e83bfb 
Dealt to 597cc151 
Dealt to Hero [8c As]
Dealt to 8dffcf83 
Dealt to a1924cdb 
Dealt to fd34e284 
Dealt to 63283e02 
e4ed9462: folds
33e83bfb: folds
597cc151: raises 250 to 500
Hero: folds
8dffcf83: folds
a1924cdb: raises 672 to 1,172 and is all-in
fd34e284: calls 1,047
63283e02: calls 922
597cc151: raises 12,332 to 13,504 and is all-in
fd34e284: calls 12,332
63283e02: folds
597cc151: shows [2d Tc]
a1924cdb: shows [Qs Qh]
fd34e284: shows [Jc 9s]
*** FLOP *** [9c 6c Jd]
*** TURN *** [9c 6c Jd] [5d]
*** RIVER *** [9c 6c Jd 5d] [Kc]
*** SHOWDOWN ***
fd34e284 collected 4,968 from pot
fd34e284 collected 24,664 from pot
*** SUMMARY ***
Total pot 29,632 | Rake 0 | Jackpot 0 | Bingo 0 | Fortune 0 | Tax 0
Board [9c 6c Jd 5d Kc]
Seat 1: e4ed9462 folded before Flop
Seat 2: 33e83bfb folded before Flop
Seat 3: 597cc151 showed [2d Tc] and lost with King-High
Seat 4: Hero folded before Flop
Seat 5: 8dffcf83 folded before Flop
Seat 6: a1924cdb (button) showed [Qs Qh] and lost with Pair of Queens
Seat 7: fd34e284 (small blind) showed [Jc 9s] and won (29,632) with Pair of Jacks and Pair of Nines
Seat 8: 63283e02 (big blind) folded before Flop


Poker Hand #TM3558270643: Tournament #156882940, Bounty Hunters Special $3.20 Hold'em No Limit - Level5(125/250) - 2024/08/07 11:19:48
Table '66' 8-max Seat #5 is the button
Seat 1: e4ed9462 (9,895 in chips)
Seat 2: 33e83bfb (7,276 in chips)
Seat 3: 597cc151 (13,574 in chips)
Seat 4: Hero (10,285 in chips)
Seat 5: 8dffcf83 (14,923 in chips)
Seat 6: a1924cdb (8,483 in chips)
Seat 7: fd34e284 (23,303 in chips)
Seat 8: 63283e02 (10,022 in chips)
e4ed9462: posts the ante 35
8dffcf83: posts the ante 35
a1924cdb: posts the ante 35
597cc151: posts the ante 35
33e83bfb: posts the ante 35
fd34e284: posts the ante 35
Hero: posts the ante 35
63283e02: posts the ante 35
a1924cdb: posts small blind 125
fd34e284: posts big blind 250
*** HOLE CARDS ***
Dealt to e4ed9462 
Dealt to 33e83bfb 
Dealt to 597cc151 
Dealt to Hero [4d 3d]
Dealt to 8dffcf83 
Dealt to a1924cdb 
Dealt to fd34e284 
Dealt to 63283e02 
63283e02: folds
e4ed9462: raises 500 to 750
33e83bfb: raises 750 to 1,500
597cc151: folds
Hero: folds
8dffcf83: folds
a1924cdb: raises 6,948 to 8,448 and is all-in
fd34e284: folds
e4ed9462: folds
33e83bfb: calls 5,741 and is all-in
Uncalled bet (1,207) returned to a1924cdb
a1924cdb: shows [Kd Kh]
33e83bfb: shows [Qc Qd]
*** FLOP *** [4s Jd 4h]
*** TURN *** [4s Jd 4h] [Qh]
*** RIVER *** [4s Jd 4h Qh] [7d]
Hero: shows [4d] (Three Fours)
597cc151: shows [Kc] (Pair of Fours)
*** SHOWDOWN ***
33e83bfb collected 15,762 from pot
*** SUMMARY ***
Total pot 15,762 | Rake 0 | Jackpot 0 | Bingo 0 | Fortune 0 | Tax 0
Board [4s Jd 4h Qh 7d]
Seat 1: e4ed9462 folded before Flop
Seat 2: 33e83bfb showed [Qc Qd] and won (15,762) with Queens Full over Fours
Seat 3: 597cc151 folded before Flop
Seat 4: Hero folded before Flop
Seat 5: 8dffcf83 (button) folded before Flop
Seat 6: a1924cdb (small blind) showed [Kd Kh] and lost with Pair of Kings and Pair of Fours
Seat 7: fd34e284 (big blind) folded before Flop
Seat 8: 63283e02 folded before Flop


Poker Hand #TM3558270603: Tournament #156882940, Bounty Hunters Special $3.20 Hold'em No Limit - Level5(125/250) - 2024/08/07 11:18:51
Table '66' 8-max Seat #4 is the button
Seat 1: e4ed9462 (9,930 in chips)
Seat 2: 33e83bfb (7,311 in chips)
Seat 3: 597cc151 (9,570 in chips)
Seat 4: Hero (13,704 in chips)
Seat 5: 8dffcf83 (15,083 in chips)
Seat 6: a1924cdb (8,768 in chips)
Seat 7: fd34e284 (23,338 in chips)
Seat 8: 63283e02 (10,057 in chips)
e4ed9462: posts the ante 35
a1924cdb: posts the ante 35
8dffcf83: posts the ante 35
597cc151: posts the ante 35
33e83bfb: posts the ante 35
fd34e284: posts the ante 35
Hero: posts the ante 35
63283e02: posts the ante 35
8dffcf83: posts small blind 125
a1924cdb: posts big blind 250
*** HOLE CARDS ***
Dealt to e4ed9462 
Dealt to 33e83bfb 
Dealt to 597cc151 
Dealt to Hero [Jc Jd]
Dealt to 8dffcf83 
Dealt to a1924cdb 
Dealt to fd34e284 
Dealt to 63283e02 
fd34e284: folds
63283e02: folds
e4ed9462: folds
33e83bfb: folds
597cc151: raises 350 to 600
Hero: raises 928 to 1,528
8dffcf83: folds
a1924cdb: folds
597cc151: raises 1,856 to 3,384
Hero: calls 1,856
*** FLOP *** [4c Kd 8h]
597cc151: bets 6,151 and is all-in
Hero: folds
Uncalled bet (6,151) returned to 597cc151
Hero: shows [Jc Jd] (Pair of Jacks)
*** SHOWDOWN ***
597cc151 collected 7,423 from pot
*** SUMMARY ***
Total pot 7,423 | Rake 0 | Jackpot 0 | Bingo 0 | Fortune 0 | Tax 0
Board [4c Kd 8h]
Seat 1: e4ed9462 folded before Flop
Seat 2: 33e83bfb folded before Flop
Seat 3: 597cc151 won (7,423)
Seat 4: Hero (button) folded on the Flop
Seat 5: 8dffcf83 (small blind) folded before Flop
Seat 6: a1924cdb (big blind) folded before Flop
Seat 7: fd34e284 folded before Flop
Seat 8: 63283e02 folded before Flop


Poker Hand #TM3558270570: Tournament #156882940, Bounty Hunters Special $3.20 Hold'em No Limit - Level5(125/250) - 2024/08/07 11:18:05
Table '66' 8-max Seat #3 is the button
Seat 1: e4ed9462 (9,965 in chips)
Seat 2: 33e83bfb (7,346 in chips)
Seat 3: 597cc151 (10,355 in chips)
Seat 4: Hero (13,864 in chips)
Seat 5: 8dffcf83 (15,368 in chips)
Seat 6: a1924cdb (7,398 in chips)
Seat 7: fd34e284 (23,373 in chips)
Seat 8: 63283e02 (10,092 in chips)
e4ed9462: posts the ante 35
a1924cdb: posts the ante 35
8dffcf83: posts the ante 35
597cc151: posts the ante 35
33e83bfb: posts the ante 35
fd34e284: posts the ante 35
Hero: posts the ante 35
63283e02: posts the ante 35
Hero: posts small blind 125
8dffcf83: posts big blind 250
*** HOLE CARDS ***
Dealt to e4ed9462 
Dealt to 33e83bfb 
Dealt to 597cc151 
Dealt to Hero [4c Kc]
Dealt to 8dffcf83 
Dealt to a1924cdb 
Dealt to fd34e284 
Dealt to 63283e02 
a1924cdb: raises 500 to 750
fd34e284: folds
63283e02: folds
e4ed9462: folds
33e83bfb: folds
597cc151: calls 750
Hero: folds
8dffcf83: folds
*** FLOP *** [7d 7c 4d]
a1924cdb: bets 1,617
597cc151: folds
Uncalled bet (1,617) returned to a1924cdb
*** SHOWDOWN ***
a1924cdb collected 2,155 from pot
*** SUMMARY ***
Total pot 2,155 | Rake 0 | Jackpot 0 | Bingo 0 | Fortune 0 | Tax 0
Board [7d 7c 4d]
Seat 1: e4ed9462 folded before Flop
Seat 2: 33e83bfb folded before Flop
Seat 3: 597cc151 (button) folded on the Flop
Seat 4: Hero (small blind) folded before Flop
Seat 5: 8dffcf83 (big blind) folded before Flop
Seat 6: a1924cdb won (2,155)
Seat 7: fd34e284 folded before Flop
Seat 8: 63283e02 folded before Flop


Poker Hand #TM3558270525: Tournament #156882940, Bounty Hunters Special $3.20 Hold'em No Limit - Level5(125/250) - 2024/08/07 11:16:57
Table '66' 8-max Seat #2 is the button
Seat 1: e4ed9462 (10,000 in chips)
Seat 2: 33e83bfb (7,381 in chips)
Seat 3: 597cc151 (10,890 in chips)
Seat 4: Hero (14,399 in chips)
Seat 5: 8dffcf83 (15,403 in chips)
Seat 6: a1924cdb (8,933 in chips)
Seat 7: fd34e284 (23,408 in chips)
Seat 8: 63283e02 (7,347 in chips)
e4ed9462: posts the ante 35
a1924cdb: posts the ante 35
8dffcf83: posts the ante 35
33e83bfb: posts the ante 35
597cc151: posts the ante 35
fd34e284: posts the ante 35
Hero: posts the ante 35
63283e02: posts the ante 35
597cc151: posts small blind 125
Hero: posts big blind 250
*** HOLE CARDS ***
Dealt to e4ed9462 
Dealt to 33e83bfb 
Dealt to 597cc151 
Dealt to Hero [Ks Qd]
Dealt to 8dffcf83 
Dealt to a1924cdb 
Dealt to fd34e284 
Dealt to 63283e02 
8dffcf83: folds
a1924cdb: raises 250 to 500
fd34e284: folds
63283e02: calls 500
e4ed9462: folds
33e83bfb: folds
597cc151: calls 375
Hero: calls 250
*** FLOP *** [2d Jc 3c]
597cc151: checks
Hero: checks
a1924cdb: checks
63283e02: bets 1,000
597cc151: folds
Hero: folds
a1924cdb: calls 1,000
*** TURN *** [2d Jc 3c] [6d]
a1924cdb: checks
63283e02: bets 1,750
a1924cdb: folds
Uncalled bet (1,750) returned to 63283e02
*** SHOWDOWN ***
63283e02 collected 4,280 from pot
*** SUMMARY ***
Total pot 4,280 | Rake 0 | Jackpot 0 | Bingo 0 | Fortune 0 | Tax 0
Board [2d Jc 3c 6d]
Seat 1: e4ed9462 folded before Flop
Seat 2: 33e83bfb (button) folded before Flop
Seat 3: 597cc151 (small blind) folded on the Flop
Seat 4: Hero (big blind) folded on the Flop
Seat 5: 8dffcf83 folded before Flop
Seat 6: a1924cdb folded on the Turn
Seat 7: fd34e284 folded before Flop
Seat 8: 63283e02 won (4,280)


Poker Hand #TM3558270499: Tournament #156882940, Bounty Hunters Special $3.20 Hold'em No Limit - Level4(100/200) - 2024/08/07 11:16:23
Table '66' 8-max Seat #8 is the button
Seat 2: 33e83bfb (7,511 in chips)
Seat 3: 597cc151 (11,420 in chips)
Seat 4: Hero (14,429 in chips)
Seat 5: 8dffcf83 (15,433 in chips)
Seat 6: a1924cdb (8,963 in chips)
Seat 7: fd34e284 (22,628 in chips)
Seat 8: 63283e02 (7,377 in chips)
a1924cdb: posts the ante 30
8dffcf83: posts the ante 30
597cc151: posts the ante 30
33e83bfb: posts the ante 30
fd34e284: posts the ante 30
Hero: posts the ante 30
63283e02: posts the ante 30
33e83bfb: posts small blind 100
597cc151: posts big blind 200
*** HOLE CARDS ***
Dealt to 33e83bfb 
Dealt to 597cc151 
Dealt to Hero [Kc 3h]
Dealt to 8dffcf83 
Dealt to a1924cdb 
Dealt to fd34e284 
Dealt to 63283e02 
Hero: folds
8dffcf83: folds
a1924cdb: folds
fd34e284: raises 300 to 500
63283e02: folds
33e83bfb: folds
597cc151: calls 300
*** FLOP *** [4c Jd Ad]
597cc151: checks
fd34e284: bets 655
597cc151: folds
Uncalled bet (655) returned to fd34e284
*** SHOWDOWN ***
fd34e284 collected 1,310 from pot
*** SUMMARY ***
Total pot 1,310 | Rake 0 | Jackpot 0 | Bingo 0 | Fortune 0 | Tax 0
Board [4c Jd Ad]
Seat 2: 33e83bfb (small blind) folded before Flop
Seat 3: 597cc151 (big blind) folded on the Flop
Seat 4: Hero folded before Flop
Seat 5: 8dffcf83 folded before Flop
Seat 6: a1924cdb folded before Flop
Seat 7: fd34e284 won (1,310)
Seat 8: 63283e02 (button) folded before Flop


Poker Hand #TM3558270473: Tournament #156882940, Bounty Hunters Special $3.20 Hold'em No Limit - Level4(100/200) - 2024/08/07 11:15:45
Table '66' 8-max Seat #7 is the button
Seat 2: 33e83bfb (7,941 in chips)
Seat 3: 597cc151 (9,540 in chips)
Seat 4: Hero (14,859 in chips)
Seat 5: 8dffcf83 (15,463 in chips)
Seat 6: a1924cdb (9,393 in chips)
Seat 7: fd34e284 (23,058 in chips)
Seat 8: 63283e02 (7,507 in chips)
a1924cdb: posts the ante 30
8dffcf83: posts the ante 30
597cc151: posts the ante 30
33e83bfb: posts the ante 30
fd34e284: posts the ante 30
Hero: posts the ante 30
63283e02: posts the ante 30
63283e02: posts small blind 100
33e83bfb: posts big blind 200
*** HOLE CARDS ***
Dealt to 33e83bfb 
Dealt to 597cc151 
Dealt to Hero [Ac 9c]
Dealt to 8dffcf83 
Dealt to a1924cdb 
Dealt to fd34e284 
Dealt to 63283e02 
597cc151: raises 200 to 400
Hero: calls 400
8dffcf83: folds
a1924cdb: calls 400
fd34e284: calls 400
63283e02: folds
33e83bfb: calls 200
*** FLOP *** [7h 6h Ks]
33e83bfb: checks
597cc151: bets 1,155
Hero: folds
a1924cdb: folds
fd34e284: folds
33e83bfb: folds
Uncalled bet (1,155) returned to 597cc151
*** SHOWDOWN ***
597cc151 collected 2,310 from pot
*** SUMMARY ***
Total pot 2,310 | Rake 0 | Jackpot 0 | Bingo 0 | Fortune 0 | Tax 0
Board [7h 6h Ks]
Seat 2: 33e83bfb (big blind) folded on the Flop
Seat 3: 597cc151 won (2,310)
Seat 4: Hero folded on the Flop
Seat 5: 8dffcf83 folded before Flop
Seat 6: a1924cdb folded on the Flop
Seat 7: fd34e284 (button) folded on the Flop
Seat 8: 63283e02 (small blind) folded before Flop


Poker Hand #TM3558270434: Tournament #156882940, Bounty Hunters Special $3.20 Hold'em No Limit - Level4(100/200) - 2024/08/07 11:14:52
Table '66' 8-max Seat #6 is the button
Seat 1: 9b7af51c (11,329 in chips)
Seat 2: 33e83bfb (7,971 in chips)
Seat 3: 597cc151 (9,570 in chips)
Seat 4: Hero (14,889 in chips)
Seat 5: 8dffcf83 (15,493 in chips)
Seat 6: a1924cdb (9,423 in chips)
Seat 7: fd34e284 (22,968 in chips)
Seat 8: 63283e02 (7,417 in chips)
9b7af51c: posts the ante 30
a1924cdb: posts the ante 30
8dffcf83: posts the ante 30
597cc151: posts the ante 30
33e83bfb: posts the ante 30
fd34e284: posts the ante 30
Hero: posts the ante 30
63283e02: posts the ante 30
fd34e284: posts small blind 100
63283e02: posts big blind 200
*** HOLE CARDS ***
Dealt to 9b7af51c 
Dealt to 33e83bfb 
Dealt to 597cc151 
Dealt to Hero [7h 2c]
Dealt to 8dffcf83 
Dealt to a1924cdb 
Dealt to fd34e284 
Dealt to 63283e02 
9b7af51c: folds
33e83bfb: folds
597cc151: folds
Hero: folds
8dffcf83: folds
a1924cdb: folds
fd34e284: calls 100
63283e02: checks
*** FLOP *** [Td 3c 3s]
fd34e284: checks
63283e02: checks
*** TURN *** [Td 3c 3s] [Jh]
fd34e284: bets 320
63283e02: raises 480 to 800
fd34e284: calls 480
*** RIVER *** [Td 3c 3s Jh] [6d]
fd34e284: checks
63283e02: bets 1,000
fd34e284: calls 1,000
63283e02: shows [Js 8h] (Pair of Jacks and Pair of Treys)
fd34e284: shows [4c Jc] (Pair of Jacks and Pair of Treys)
*** SHOWDOWN ***
63283e02 collected 2,120 from pot
fd34e284 collected 2,120 from pot
*** SUMMARY ***
Total pot 4,240 | Rake 0 | Jackpot 0 | Bingo 0 | Fortune 0 | Tax 0
Board [Td 3c 3s Jh 6d]
Seat 1: 9b7af51c folded before Flop
Seat 2: 33e83bfb folded before Flop
Seat 3: 597cc151 folded before Flop
Seat 4: Hero folded before Flop
Seat 5: 8dffcf83 folded before Flop
Seat 6: a1924cdb (button) folded before Flop
Seat 7: fd34e284 (small blind) showed [4c Jc] and won (2,120) with Pair of Jacks and Pair of Treys
Seat 8: 63283e02 (big blind) showed [Js 8h] and won (2,120) with Pair of Jacks and Pair of Treys


Poker Hand #TM3558270391: Tournament #156882940, Bounty Hunters Special $3.20 Hold'em No Limit - Level4(100/200) - 2024/08/07 11:13:55
Table '66' 8-max Seat #5 is the button
Seat 1: 9b7af51c (11,359 in chips)
Seat 2: 33e83bfb (8,001 in chips)
Seat 3: 597cc151 (10,000 in chips)
Seat 4: Hero (14,919 in chips)
Seat 5: 8dffcf83 (15,523 in chips)
Seat 6: a1924cdb (9,853 in chips)
Seat 7: fd34e284 (21,958 in chips)
Seat 8: 63283e02 (7,447 in chips)
9b7af51c: posts the ante 30
8dffcf83: posts the ante 30
a1924cdb: posts the ante 30
597cc151: posts the ante 30
33e83bfb: posts the ante 30
fd34e284: posts the ante 30
Hero: posts the ante 30
63283e02: posts the ante 30
a1924cdb: posts small blind 100
fd34e284: posts big blind 200
*** HOLE CARDS ***
Dealt to 9b7af51c 
Dealt to 33e83bfb 
Dealt to 597cc151 
Dealt to Hero [3h Jh]
Dealt to 8dffcf83 
Dealt to a1924cdb 
Dealt to fd34e284 
Dealt to 63283e02 
63283e02: folds
9b7af51c: folds
33e83bfb: folds
597cc151: raises 200 to 400
Hero: folds
8dffcf83: folds
a1924cdb: calls 300
fd34e284: calls 200
*** FLOP *** [7d 5s 2h]
a1924cdb: checks
fd34e284: checks
597cc151: checks
*** TURN *** [7d 5s 2h] [2d]
a1924cdb: checks
fd34e284: checks
597cc151: checks
*** RIVER *** [7d 5s 2h 2d] [6c]
a1924cdb: checks
fd34e284: bets 720
597cc151: folds
a1924cdb: folds
Uncalled bet (720) returned to fd34e284
*** SHOWDOWN ***
fd34e284 collected 1,440 from pot
*** SUMMARY ***
Total pot 1,440 | Rake 0 | Jackpot 0 | Bingo 0 | Fortune 0 | Tax 0
Board [7d 5s 2h 2d 6c]
Seat 1: 9b7af51c folded before Flop
Seat 2: 33e83bfb folded before Flop
Seat 3: 597cc151 folded on the River
Seat 4: Hero folded before Flop
Seat 5: 8dffcf83 (button) folded before Flop
Seat 6: a1924cdb (small blind) folded on the River
Seat 7: fd34e284 (big blind) won (1,440)
Seat 8: 63283e02 folded before Flop


Poker Hand #TM3558270342: Tournament #156882940, Bounty Hunters Special $3.20 Hold'em No Limit - Level4(100/200) - 2024/08/07 11:12:52
Table '66' 8-max Seat #4 is the button
Seat 1: 9b7af51c (11,389 in chips)
Seat 2: 33e83bfb (8,031 in chips)
Seat 4: Hero (14,949 in chips)
Seat 5: 8dffcf83 (14,606 in chips)
Seat 6: a1924cdb (10,620 in chips)
Seat 7: fd34e284 (21,988 in chips)
Seat 8: 63283e02 (7,477 in chips)
9b7af51c: posts the ante 30
a1924cdb: posts the ante 30
8dffcf83: posts the ante 30
33e83bfb: posts the ante 30
fd34e284: posts the ante 30
Hero: posts the ante 30
63283e02: posts the ante 30
8dffcf83: posts small blind 100
a1924cdb: posts big blind 200
*** HOLE CARDS ***
Dealt to 9b7af51c 
Dealt to 33e83bfb 
Dealt to Hero [6h Ks]
Dealt to 8dffcf83 
Dealt to a1924cdb 
Dealt to fd34e284 
Dealt to 63283e02 
fd34e284: folds
63283e02: folds
9b7af51c: folds
33e83bfb: folds
Hero: folds
8dffcf83: calls 100
a1924cdb: checks
*** FLOP *** [Ac 8c 8d]
8dffcf83: bets 202
a1924cdb: raises 335 to 537
8dffcf83: calls 335
*** TURN *** [Ac 8c 8d] [9s]
8dffcf83: checks
a1924cdb: checks
*** RIVER *** [Ac 8c 8d 9s] [2s]
8dffcf83: bets 556
a1924cdb: folds
Uncalled bet (556) returned to 8dffcf83
*** SHOWDOWN ***
8dffcf83 collected 1,684 from pot
*** SUMMARY ***
Total pot 1,684 | Rake 0 | Jackpot 0 | Bingo 0 | Fortune 0 | Tax 0
Board [Ac 8c 8d 9s 2s]
Seat 1: 9b7af51c folded before Flop
Seat 2: 33e83bfb folded before Flop
Seat 4: Hero (button) folded before Flop
Seat 5: 8dffcf83 (small blind) won (1,684)
Seat 6: a1924cdb (big blind) folded on the River
Seat 7: fd34e284 folded before Flop
Seat 8: 63283e02 folded before Flop


Poker Hand #TM3558270299: Tournament #156882940, Bounty Hunters Special $3.20 Hold'em No Limit - Level4(100/200) - 2024/08/07 11:11:59
Table '66' 8-max Seat #2 is the button
Seat 1: 9b7af51c (11,419 in chips)
Seat 2: 33e83bfb (8,061 in chips)
Seat 3: 28dec1c4 (6,399 in chips)
Seat 4: Hero (15,179 in chips)
Seat 5: 8dffcf83 (15,056 in chips)
Seat 6: a1924cdb (10,650 in chips)
Seat 7: fd34e284 (14,789 in chips)
Seat 8: 63283e02 (7,507 in chips)
9b7af51c: posts the ante 30
28dec1c4: posts the ante 30
a1924cdb: posts the ante 30
8dffcf83: posts the ante 30
33e83bfb: posts the ante 30
fd34e284: posts the ante 30
Hero: posts the ante 30
63283e02: posts the ante 30
28dec1c4: posts small blind 100
Hero: posts big blind 200
*** HOLE CARDS ***
Dealt to 9b7af51c 
Dealt to 33e83bfb 
Dealt to 28dec1c4 
Dealt to Hero [2s 5h]
Dealt to 8dffcf83 
Dealt to a1924cdb 
Dealt to fd34e284 
Dealt to 63283e02 
8dffcf83: raises 220 to 420
a1924cdb: folds
fd34e284: calls 420
63283e02: folds
9b7af51c: folds
33e83bfb: folds
28dec1c4: raises 1,870 to 2,290
Hero: folds
8dffcf83: folds
fd34e284: calls 1,870
*** FLOP *** [5s 6s Qs]
28dec1c4: bets 4,079 and is all-in
fd34e284: calls 4,079
28dec1c4: shows [Kh Qh] (Pair of Queens)
fd34e284: shows [3s As] (Ace High Flush)
*** TURN *** [5s 6s Qs] [7d]
*** RIVER *** [5s 6s Qs 7d] [7c]
*** SHOWDOWN ***
fd34e284 collected 13,598 from pot
*** SUMMARY ***
Total pot 13,598 | Rake 0 | Jackpot 0 | Bingo 0 | Fortune 0 | Tax 0
Board [5s 6s Qs 7d 7c]
Seat 1: 9b7af51c folded before Flop
Seat 2: 33e83bfb (button) folded before Flop
Seat 3: 28dec1c4 (small blind) showed [Kh Qh] and lost with Pair of Queens and Pair of Sevens
Seat 4: Hero (big blind) folded before Flop
Seat 5: 8dffcf83 folded before Flop
Seat 6: a1924cdb folded before Flop
Seat 7: fd34e284 showed [3s As] and won (13,598) with Ace High Flush
Seat 8: 63283e02 folded before Flop


Poker Hand #TM3558270232: Tournament #156882940, Bounty Hunters Special $3.20 Hold'em No Limit - Level4(100/200) - 2024/08/07 11:10:41
Table '66' 8-max Seat #1 is the button
Seat 1: 9b7af51c (11,449 in chips)
Seat 2: 33e83bfb (8,191 in chips)
Seat 3: 28dec1c4 (8,484 in chips)
Seat 4: Hero (12,814 in chips)
Seat 5: 8dffcf83 (15,086 in chips)
Seat 6: a1924cdb (10,680 in chips)
Seat 7: fd34e284 (14,819 in chips)
Seat 8: 63283e02 (7,537 in chips)
9b7af51c: posts the ante 30
28dec1c4: posts the ante 30
a1924cdb: posts the ante 30
8dffcf83: posts the ante 30
33e83bfb: posts the ante 30
fd34e284: posts the ante 30
Hero: posts the ante 30
63283e02: posts the ante 30
33e83bfb: posts small blind 100
28dec1c4: posts big blind 200
*** HOLE CARDS ***
Dealt to 9b7af51c 
Dealt to 33e83bfb 
Dealt to 28dec1c4 
Dealt to Hero [Kc Jd]
Dealt to 8dffcf83 
Dealt to a1924cdb 
Dealt to fd34e284 
Dealt to 63283e02 
Hero: raises 300 to 500
8dffcf83: folds
a1924cdb: folds
fd34e284: folds
63283e02: folds
9b7af51c: folds
33e83bfb: folds
28dec1c4: calls 300
*** FLOP *** [As Kh Qs]
28dec1c4: checks
Hero: bets 670
28dec1c4: calls 670
*** TURN *** [As Kh Qs] [3s]
28dec1c4: checks
Hero: checks
*** RIVER *** [As Kh Qs 3s] [Th]
28dec1c4: bets 885
Hero: raises 1,115 to 2,000
28dec1c4: folds
Uncalled bet (1,115) returned to Hero
*** SHOWDOWN ***
Hero collected 4,450 from pot
*** SUMMARY ***
Total pot 4,450 | Rake 0 | Jackpot 0 | Bingo 0 | Fortune 0 | Tax 0
Board [As Kh Qs 3s Th]
Seat 1: 9b7af51c (button) folded before Flop
Seat 2: 33e83bfb (small blind) folded before Flop
Seat 3: 28dec1c4 (big blind) folded on the River
Seat 4: Hero won (4,450)
Seat 5: 8dffcf83 folded before Flop
Seat 6: a1924cdb folded before Flop
Seat 7: fd34e284 folded before Flop
Seat 8: 63283e02 folded before Flop


Poker Hand #TM3558270207: Tournament #156882940, Bounty Hunters Special $3.20 Hold'em No Limit - Level4(100/200) - 2024/08/07 11:10:05
Table '66' 8-max Seat #8 is the button
Seat 1: 9b7af51c (10,639 in chips)
Seat 2: 33e83bfb (8,421 in chips)
Seat 3: 28dec1c4 (8,914 in chips)
Seat 4: Hero (12,844 in chips)
Seat 5: 8dffcf83 (15,116 in chips)
Seat 6: a1924cdb (10,710 in chips)
Seat 7: fd34e284 (14,849 in chips)
Seat 8: 63283e02 (7,567 in chips)
9b7af51c: posts the ante 30
28dec1c4: posts the ante 30
a1924cdb: posts the ante 30
8dffcf83: posts the ante 30
33e83bfb: posts the ante 30
fd34e284: posts the ante 30
Hero: posts the ante 30
63283e02: posts the ante 30
9b7af51c: posts small blind 100
33e83bfb: posts big blind 200
*** HOLE CARDS ***
Dealt to 9b7af51c 
Dealt to 33e83bfb 
Dealt to 28dec1c4 
Dealt to Hero [Ks 7c]
Dealt to 8dffcf83 
Dealt to a1924cdb 
Dealt to fd34e284 
Dealt to 63283e02 
28dec1c4: raises 200 to 400
Hero: folds
8dffcf83: folds
a1924cdb: folds
fd34e284: folds
63283e02: folds
9b7af51c: raises 955 to 1,355
33e83bfb: folds
28dec1c4: folds
Uncalled bet (955) returned to 9b7af51c
*** SHOWDOWN ***
9b7af51c collected 1,240 from pot
*** SUMMARY ***
Total pot 1,240 | Rake 0 | Jackpot 0 | Bingo 0 | Fortune 0 | Tax 0
Seat 1: 9b7af51c (small blind) collected (1,240)
Seat 2: 33e83bfb (big blind) folded before Flop
Seat 3: 28dec1c4 folded before Flop
Seat 4: Hero folded before Flop
Seat 5: 8dffcf83 folded before Flop
Seat 6: a1924cdb folded before Flop
Seat 7: fd34e284 folded before Flop
Seat 8: 63283e02 (button) folded before Flop


Poker Hand #TM3558270162: Tournament #156882940, Bounty Hunters Special $3.20 Hold'em No Limit - Level4(100/200) - 2024/08/07 11:09:17
Table '66' 8-max Seat #7 is the button
Seat 1: 9b7af51c (10,869 in chips)
Seat 2: 33e83bfb (9,478 in chips)
Seat 3: 28dec1c4 (8,944 in chips)
Seat 4: Hero (12,874 in chips)
Seat 5: 8dffcf83 (15,146 in chips)
Seat 6: a1924cdb (10,740 in chips)
Seat 7: fd34e284 (13,312 in chips)
Seat 8: 63283e02 (7,697 in chips)
9b7af51c: posts the ante 30
28dec1c4: posts the ante 30
a1924cdb: posts the ante 30
8dffcf83: posts the ante 30
33e83bfb: posts the ante 30
fd34e284: posts the ante 30
Hero: posts the ante 30
63283e02: posts the ante 30
63283e02: posts small blind 100
9b7af51c: posts big blind 200
*** HOLE CARDS ***
Dealt to 9b7af51c 
Dealt to 33e83bfb 
Dealt to 28dec1c4 
Dealt to Hero [Qh 2d]
Dealt to 8dffcf83 
Dealt to a1924cdb 
Dealt to fd34e284 
Dealt to 63283e02 
33e83bfb: calls 200
28dec1c4: folds
Hero: folds
8dffcf83: folds
a1924cdb: folds
fd34e284: raises 311 to 511
63283e02: folds
9b7af51c: folds
33e83bfb: calls 311
*** FLOP *** [5s 9h Ac]
33e83bfb: checks
fd34e284: bets 516
33e83bfb: calls 516
*** TURN *** [5s 9h Ac] [Kh]
33e83bfb: checks
fd34e284: bets 857
33e83bfb: folds
Uncalled bet (857) returned to fd34e284
*** SHOWDOWN ***
fd34e284 collected 2,594 from pot
*** SUMMARY ***
Total pot 2,594 | Rake 0 | Jackpot 0 | Bingo 0 | Fortune 0 | Tax 0
Board [5s 9h Ac Kh]
Seat 1: 9b7af51c (big blind) folded before Flop
Seat 2: 33e83bfb folded on the Turn
Seat 3: 28dec1c4 folded before Flop
Seat 4: Hero folded before Flop
Seat 5: 8dffcf83 folded before Flop
Seat 6: a1924cdb folded before Flop
Seat 7: fd34e284 (button) won (2,594)
Seat 8: 63283e02 (small blind) folded before Flop


Poker Hand #TM3558270115: Tournament #156882940, Bounty Hunters Special $3.20 Hold'em No Limit - Level4(100/200) - 2024/08/07 11:08:06
Table '66' 8-max Seat #6 is the button
Seat 1: 9b7af51c (10,899 in chips)
Seat 2: 33e83bfb (9,508 in chips)
Seat 3: 28dec1c4 (8,974 in chips)
Seat 4: Hero (12,904 in chips)
Seat 5: 8dffcf83 (15,176 in chips)
Seat 6: a1924cdb (9,520 in chips)
Seat 7: fd34e284 (14,152 in chips)
Seat 8: 63283e02 (7,927 in chips)
9b7af51c: posts the ante 30
28dec1c4: posts the ante 30
a1924cdb: posts the ante 30
8dffcf83: posts the ante 30
33e83bfb: posts the ante 30
fd34e284: posts the ante 30
Hero: posts the ante 30
63283e02: posts the ante 30
fd34e284: posts small blind 100
63283e02: posts big blind 200
*** HOLE CARDS ***
Dealt to 9b7af51c 
Dealt to 33e83bfb 
Dealt to 28dec1c4 
Dealt to Hero [Qs 4c]
Dealt to 8dffcf83 
Dealt to a1924cdb 
Dealt to fd34e284 
Dealt to 63283e02 
9b7af51c: folds
33e83bfb: folds
28dec1c4: folds
Hero: folds
8dffcf83: folds
a1924cdb: raises 200 to 400
fd34e284: calls 300
63283e02: folds
*** FLOP *** [Td 4s 5s]
fd34e284: bets 410
a1924cdb: calls 410
*** TURN *** [Td 4s 5s] [7h]
fd34e284: checks
a1924cdb: bets 680
fd34e284: folds
Uncalled bet (680) returned to a1924cdb
*** SHOWDOWN ***
a1924cdb collected 2,060 from pot
*** SUMMARY ***
Total pot 2,060 | Rake 0 | Jackpot 0 | Bingo 0 | Fortune 0 | Tax 0
Board [Td 4s 5s 7h]
Seat 1: 9b7af51c folded before Flop
Seat 2: 33e83bfb folded before Flop
Seat 3: 28dec1c4 folded before Flop
Seat 4: Hero folded before Flop
Seat 5: 8dffcf83 folded before Flop
Seat 6: a1924cdb (button) won (2,060)
Seat 7: fd34e284 (small blind) folded on the Turn
Seat 8: 63283e02 (big blind) folded before Flop


Poker Hand #TM3558270090: Tournament #156882940, Bounty Hunters Special $3.20 Hold'em No Limit - Level4(100/200) - 2024/08/07 11:07:34
Table '66' 8-max Seat #5 is the button
Seat 1: 9b7af51c (10,929 in chips)
Seat 2: 33e83bfb (9,538 in chips)
Seat 3: 28dec1c4 (9,004 in chips)
Seat 4: Hero (13,434 in chips)
Seat 5: 8dffcf83 (15,206 in chips)
Seat 6: a1924cdb (9,650 in chips)
Seat 7: fd34e284 (13,342 in chips)
Seat 8: 63283e02 (7,957 in chips)
9b7af51c: posts the ante 30
28dec1c4: posts the ante 30
8dffcf83: posts the ante 30
a1924cdb: posts the ante 30
33e83bfb: posts the ante 30
fd34e284: posts the ante 30
Hero: posts the ante 30
63283e02: posts the ante 30
a1924cdb: posts small blind 100
fd34e284: posts big blind 200
*** HOLE CARDS ***
Dealt to 9b7af51c 
Dealt to 33e83bfb 
Dealt to 28dec1c4 
Dealt to Hero [As Jh]
Dealt to 8dffcf83 
Dealt to a1924cdb 
Dealt to fd34e284 
Dealt to 63283e02 
63283e02: folds
9b7af51c: folds
33e83bfb: folds
28dec1c4: folds
Hero: raises 300 to 500
8dffcf83: folds
a1924cdb: folds
fd34e284: calls 300
*** FLOP *** [Th 3s 4h]
fd34e284: bets 670
Hero: folds
Uncalled bet (670) returned to fd34e284
*** SHOWDOWN ***
fd34e284 collected 1,340 from pot
*** SUMMARY ***
Total pot 1,340 | Rake 0 | Jackpot 0 | Bingo 0 | Fortune 0 | Tax 0
Board [Th 3s 4h]
Seat 1: 9b7af51c folded before Flop
Seat 2: 33e83bfb folded before Flop
Seat 3: 28dec1c4 folded before Flop
Seat 4: Hero folded on the Flop
Seat 5: 8dffcf83 (button) folded before Flop
Seat 6: a1924cdb (small blind) folded before Flop
Seat 7: fd34e284 (big blind) won (1,340)
Seat 8: 63283e02 folded before Flop


Poker Hand #TM3558270069: Tournament #156882940, Bounty Hunters Special $3.20 Hold'em No Limit - Level4(100/200) - 2024/08/07 11:07:01
Table '66' 8-max Seat #4 is the button
Seat 1: 9b7af51c (10,959 in chips)
Seat 2: 33e83bfb (9,568 in chips)
Seat 3: 28dec1c4 (9,454 in chips)
Seat 4: Hero (13,464 in chips)
Seat 5: 8dffcf83 (14,376 in chips)
Seat 6: a1924cdb (9,880 in chips)
Seat 7: fd34e284 (13,372 in chips)
Seat 8: 63283e02 (7,987 in chips)
9b7af51c: posts the ante 30
28dec1c4: posts the ante 30
a1924cdb: posts the ante 30
8dffcf83: posts the ante 30
33e83bfb: posts the ante 30
fd34e284: posts the ante 30
Hero: posts the ante 30
63283e02: posts the ante 30
8dffcf83: posts small blind 100
a1924cdb: posts big blind 200
*** HOLE CARDS ***
Dealt to 9b7af51c 
Dealt to 33e83bfb 
Dealt to 28dec1c4 
Dealt to Hero [Ac 2s]
Dealt to 8dffcf83 
Dealt to a1924cdb 
Dealt to fd34e284 
Dealt to 63283e02 
fd34e284: folds
63283e02: folds
9b7af51c: folds
33e83bfb: folds
28dec1c4: raises 220 to 420
Hero: folds
8dffcf83: raises 1,480 to 1,900
a1924cdb: folds
28dec1c4: folds
Uncalled bet (1,480) returned to 8dffcf83
*** SHOWDOWN ***
8dffcf83 collected 1,280 from pot
*** SUMMARY ***
Total pot 1,280 | Rake 0 | Jackpot 0 | Bingo 0 | Fortune 0 | Tax 0
Seat 1: 9b7af51c folded before Flop
Seat 2: 33e83bfb folded before Flop
Seat 3: 28dec1c4 folded before Flop
Seat 4: Hero (button) folded before Flop
Seat 5: 8dffcf83 (small blind) collected (1,280)
Seat 6: a1924cdb (big blind) folded before Flop
Seat 7: fd34e284 folded before Flop
Seat 8: 63283e02 folded before Flop


Poker Hand #TM3558270018: Tournament #156882940, Bounty Hunters Special $3.20 Hold'em No Limit - Level3(80/160) - 2024/08/07 11:05:55
Table '66' 8-max Seat #3 is the button
Seat 1: 9b7af51c (9,150 in chips)
Seat 2: 33e83bfb (9,592 in chips)
Seat 3: 28dec1c4 (9,478 in chips)
Seat 4: Hero (13,568 in chips)
Seat 5: 8dffcf83 (15,961 in chips)
Seat 6: a1924cdb (9,904 in chips)
Seat 7: fd34e284 (13,396 in chips)
Seat 8: 63283e02 (8,011 in chips)
9b7af51c: posts the ante 24
28dec1c4: posts the ante 24
a1924cdb: posts the ante 24
8dffcf83: posts the ante 24
33e83bfb: posts the ante 24
fd34e284: posts the ante 24
Hero: posts the ante 24
63283e02: posts the ante 24
Hero: posts small blind 80
8dffcf83: posts big blind 160
*** HOLE CARDS ***
Dealt to 9b7af51c 
Dealt to 33e83bfb 
Dealt to 28dec1c4 
Dealt to Hero [8c 3h]
Dealt to 8dffcf83 
Dealt to a1924cdb 
Dealt to fd34e284 
Dealt to 63283e02 
a1924cdb: folds
fd34e284: folds
63283e02: folds
9b7af51c: raises 192 to 352
33e83bfb: folds
28dec1c4: folds
Hero: folds
8dffcf83: calls 192
*** FLOP *** [4c Js Ah]
8dffcf83: checks
9b7af51c: bets 320
8dffcf83: calls 320
*** TURN *** [4c Js Ah] [5d]
8dffcf83: checks
9b7af51c: bets 889
8dffcf83: calls 889
*** RIVER *** [4c Js Ah 5d] [8d]
8dffcf83: checks
9b7af51c: checks
8dffcf83: shows [As 2h] (Pair of Aces)
9b7af51c: shows [6s Ad] (Pair of Aces)
*** SHOWDOWN ***
9b7af51c collected 3,394 from pot
*** SUMMARY ***
Total pot 3,394 | Rake 0 | Jackpot 0 | Bingo 0 | Fortune 0 | Tax 0
Board [4c Js Ah 5d 8d]
Seat 1: 9b7af51c showed [6s Ad] and won (3,394) with Pair of Aces
Seat 2: 33e83bfb folded before Flop
Seat 3: 28dec1c4 (button) folded before Flop
Seat 4: Hero (small blind) folded before Flop
Seat 5: 8dffcf83 (big blind) showed [As 2h] and lost with Pair of Aces
Seat 6: a1924cdb folded before Flop
Seat 7: fd34e284 folded before Flop
Seat 8: 63283e02 folded before Flop


Poker Hand #TM3558269966: Tournament #156882940, Bounty Hunters Special $3.20 Hold'em No Limit - Level3(80/160) - 2024/08/07 11:04:50
Table '66' 8-max Seat #2 is the button
Seat 1: 9b7af51c (10,063 in chips)
Seat 2: 33e83bfb (9,616 in chips)
Seat 3: 28dec1c4 (9,582 in chips)
Seat 4: Hero (12,431 in chips)
Seat 5: 8dffcf83 (15,985 in chips)
Seat 6: a1924cdb (9,928 in chips)
Seat 7: fd34e284 (13,420 in chips)
Seat 8: 63283e02 (8,035 in chips)
9b7af51c: posts the ante 24
28dec1c4: posts the ante 24
a1924cdb: posts the ante 24
8dffcf83: posts the ante 24
33e83bfb: posts the ante 24
fd34e284: posts the ante 24
Hero: posts the ante 24
63283e02: posts the ante 24
28dec1c4: posts small blind 80
Hero: posts big blind 160
*** HOLE CARDS ***
Dealt to 9b7af51c 
Dealt to 33e83bfb 
Dealt to 28dec1c4 
Dealt to Hero [2c 2s]
Dealt to 8dffcf83 
Dealt to a1924cdb 
Dealt to fd34e284 
Dealt to 63283e02 
8dffcf83: folds
a1924cdb: folds
fd34e284: folds
63283e02: folds
9b7af51c: raises 192 to 352
33e83bfb: folds
28dec1c4: folds
Hero: calls 192
*** FLOP *** [9d 4h 3c]
Hero: checks
9b7af51c: bets 537
Hero: calls 537
*** TURN *** [9d 4h 3c] [6s]
Hero: checks
9b7af51c: checks
*** RIVER *** [9d 4h 3c 6s] [Td]
Hero: bets 677
9b7af51c: folds
Uncalled bet (677) returned to Hero
*** SHOWDOWN ***
Hero collected 2,050 from pot
*** SUMMARY ***
Total pot 2,050 | Rake 0 | Jackpot 0 | Bingo 0 | Fortune 0 | Tax 0
Board [9d 4h 3c 6s Td]
Seat 1: 9b7af51c folded on the River
Seat 2: 33e83bfb (button) folded before Flop
Seat 3: 28dec1c4 (small blind) folded before Flop
Seat 4: Hero (big blind) won (2,050)
Seat 5: 8dffcf83 folded before Flop
Seat 6: a1924cdb folded before Flop
Seat 7: fd34e284 folded before Flop
Seat 8: 63283e02 folded before Flop


Poker Hand #TM3558269950: Tournament #156882940, Bounty Hunters Special $3.20 Hold'em No Limit - Level3(80/160) - 2024/08/07 11:04:27
Table '66' 8-max Seat #1 is the button
Seat 1: 9b7af51c (10,087 in chips)
Seat 2: 33e83bfb (9,720 in chips)
Seat 3: 28dec1c4 (9,334 in chips)
Seat 4: Hero (12,455 in chips)
Seat 5: 8dffcf83 (16,009 in chips)
Seat 6: a1924cdb (9,952 in chips)
Seat 7: fd34e284 (13,444 in chips)
Seat 8: 63283e02 (8,059 in chips)
9b7af51c: posts the ante 24
28dec1c4: posts the ante 24
a1924cdb: posts the ante 24
8dffcf83: posts the ante 24
33e83bfb: posts the ante 24
fd34e284: posts the ante 24
Hero: posts the ante 24
63283e02: posts the ante 24
33e83bfb: posts small blind 80
28dec1c4: posts big blind 160
*** HOLE CARDS ***
Dealt to 9b7af51c 
Dealt to 33e83bfb 
Dealt to 28dec1c4 
Dealt to Hero [7h 6c]
Dealt to 8dffcf83 
Dealt to a1924cdb 
Dealt to fd34e284 
Dealt to 63283e02 
Hero: folds
8dffcf83: folds
a1924cdb: folds
fd34e284: folds
63283e02: folds
9b7af51c: folds
33e83bfb: folds
Uncalled bet (80) returned to 28dec1c4
*** SHOWDOWN ***
28dec1c4 collected 352 from pot
*** SUMMARY ***
Total pot 352 | Rake 0 | Jackpot 0 | Bingo 0 | Fortune 0 | Tax 0
Seat 1: 9b7af51c (button) folded before Flop
Seat 2: 33e83bfb (small blind) folded before Flop
Seat 3: 28dec1c4 (big blind) collected (352)
Seat 4: Hero folded before Flop
Seat 5: 8dffcf83 folded before Flop
Seat 6: a1924cdb folded before Flop
Seat 7: fd34e284 folded before Flop
Seat 8: 63283e02 folded before Flop


Poker Hand #TM3558269902: Tournament #156882940, Bounty Hunters Special $3.20 Hold'em No Limit - Level3(80/160) - 2024/08/07 11:03:11
Table '66' 8-max Seat #8 is the button
Seat 1: 9b7af51c (8,580 in chips)
Seat 2: 33e83bfb (9,904 in chips)
Seat 3: 28dec1c4 (9,358 in chips)
Seat 4: Hero (12,479 in chips)
Seat 5: 8dffcf83 (16,033 in chips)
Seat 6: a1924cdb (9,976 in chips)
Seat 7: fd34e284 (13,468 in chips)
Seat 8: 63283e02 (9,262 in chips)
9b7af51c: posts the ante 24
28dec1c4: posts the ante 24
a1924cdb: posts the ante 24
8dffcf83: posts the ante 24
33e83bfb: posts the ante 24
fd34e284: posts the ante 24
Hero: posts the ante 24
63283e02: posts the ante 24
9b7af51c: posts small blind 80
33e83bfb: posts big blind 160
*** HOLE CARDS ***
Dealt to 9b7af51c 
Dealt to 33e83bfb 
Dealt to 28dec1c4 
Dealt to Hero [9c Ah]
Dealt to 8dffcf83 
Dealt to a1924cdb 
Dealt to fd34e284 
Dealt to 63283e02 
28dec1c4: folds
Hero: folds
8dffcf83: folds
a1924cdb: folds
fd34e284: folds
63283e02: raises 160 to 320
9b7af51c: calls 240
33e83bfb: folds
*** FLOP *** [9d 2c Ts]
9b7af51c: checks
63283e02: bets 219
9b7af51c: calls 219
*** TURN *** [9d 2c Ts] [Kd]
9b7af51c: checks
63283e02: bets 640
9b7af51c: calls 640
*** RIVER *** [9d 2c Ts Kd] [Jc]
9b7af51c: checks
63283e02: checks
9b7af51c: shows [7h Kc] (Pair of Kings)
63283e02: shows [Ac 8c] (Ace-High)
*** SHOWDOWN ***
9b7af51c collected 2,710 from pot
*** SUMMARY ***
Total pot 2,710 | Rake 0 | Jackpot 0 | Bingo 0 | Fortune 0 | Tax 0
Board [9d 2c Ts Kd Jc]
Seat 1: 9b7af51c (small blind) showed [7h Kc] and won (2,710) with Pair of Kings
Seat 2: 33e83bfb (big blind) folded before Flop
Seat 3: 28dec1c4 folded before Flop
Seat 4: Hero folded before Flop
Seat 5: 8dffcf83 folded before Flop
Seat 6: a1924cdb folded before Flop
Seat 7: fd34e284 folded before Flop
Seat 8: 63283e02 (button) showed [Ac 8c] and lost with Ace-High


Poker Hand #TM3558269877: Tournament #156882940, Bounty Hunters Special $3.20 Hold'em No Limit - Level3(80/160) - 2024/08/07 11:02:30
Table '66' 8-max Seat #7 is the button
Seat 1: 9b7af51c (8,940 in chips)
Seat 2: 33e83bfb (9,928 in chips)
Seat 3: 28dec1c4 (8,438 in chips)
Seat 4: Hero (12,503 in chips)
Seat 5: 8dffcf83 (16,057 in chips)
Seat 6: a1924cdb (10,000 in chips)
Seat 7: fd34e284 (13,828 in chips)
Seat 8: 63283e02 (9,366 in chips)
9b7af51c: posts the ante 24
28dec1c4: posts the ante 24
a1924cdb: posts the ante 24
8dffcf83: posts the ante 24
33e83bfb: posts the ante 24
fd34e284: posts the ante 24
Hero: posts the ante 24
63283e02: posts the ante 24
63283e02: posts small blind 80
9b7af51c: posts big blind 160
*** HOLE CARDS ***
Dealt to 9b7af51c 
Dealt to 33e83bfb 
Dealt to 28dec1c4 
Dealt to Hero [4c 2h]
Dealt to 8dffcf83 
Dealt to a1924cdb 
Dealt to fd34e284 
Dealt to 63283e02 
33e83bfb: folds
28dec1c4: raises 176 to 336
Hero: folds
8dffcf83: folds
a1924cdb: folds
fd34e284: calls 336
63283e02: folds
9b7af51c: calls 176
*** FLOP *** [4s 7h Ac]
9b7af51c: checks
28dec1c4: bets 423
fd34e284: folds
9b7af51c: folds
Uncalled bet (423) returned to 28dec1c4
*** SHOWDOWN ***
28dec1c4 collected 1,280 from pot
*** SUMMARY ***
Total pot 1,280 | Rake 0 | Jackpot 0 | Bingo 0 | Fortune 0 | Tax 0
Board [4s 7h Ac]
Seat 1: 9b7af51c (big blind) folded on the Flop
Seat 2: 33e83bfb folded before Flop
Seat 3: 28dec1c4 won (1,280)
Seat 4: Hero folded before Flop
Seat 5: 8dffcf83 folded before Flop
Seat 6: a1924cdb folded before Flop
Seat 7: fd34e284 (button) folded on the Flop
Seat 8: 63283e02 (small blind) folded before Flop


Poker Hand #TM3558269848: Tournament #156882940, Bounty Hunters Special $3.20 Hold'em No Limit - Level3(80/160) - 2024/08/07 11:01:37
Table '66' 8-max Seat #5 is the button
Seat 1: 9b7af51c (8,964 in chips)
Seat 2: 33e83bfb (9,952 in chips)
Seat 3: 28dec1c4 (8,462 in chips)
Seat 4: Hero (12,527 in chips)
Seat 5: 8dffcf83 (15,497 in chips)
Seat 7: fd34e284 (13,932 in chips)
Seat 8: 63283e02 (9,726 in chips)
9b7af51c: posts the ante 24
28dec1c4: posts the ante 24
8dffcf83: posts the ante 24
33e83bfb: posts the ante 24
fd34e284: posts the ante 24
Hero: posts the ante 24
63283e02: posts the ante 24
fd34e284: posts small blind 80
63283e02: posts big blind 160
*** HOLE CARDS ***
Dealt to 9b7af51c 
Dealt to 33e83bfb 
Dealt to 28dec1c4 
Dealt to Hero [9h 6c]
Dealt to 8dffcf83 
Dealt to fd34e284 
Dealt to 63283e02 
9b7af51c: folds
33e83bfb: folds
28dec1c4: folds
Hero: folds
8dffcf83: raises 176 to 336
fd34e284: folds
63283e02: calls 176
*** FLOP *** [8h 5c Ah]
63283e02: checks
8dffcf83: bets 304
63283e02: folds
Uncalled bet (304) returned to 8dffcf83
*** SHOWDOWN ***
8dffcf83 collected 920 from pot
*** SUMMARY ***
Total pot 920 | Rake 0 | Jackpot 0 | Bingo 0 | Fortune 0 | Tax 0
Board [8h 5c Ah]
Seat 1: 9b7af51c folded before Flop
Seat 2: 33e83bfb folded before Flop
Seat 3: 28dec1c4 folded before Flop
Seat 4: Hero folded before Flop
Seat 5: 8dffcf83 (button) won (920)
Seat 7: fd34e284 (small blind) folded before Flop
Seat 8: 63283e02 (big blind) folded on the Flop


Poker Hand #TM3558269796: Tournament #156882940, Bounty Hunters Special $3.20 Hold'em No Limit - Level3(80/160) - 2024/08/07 10:54:22
Table '66' 8-max Seat #4 is the button
Seat 1: 9b7af51c (8,988 in chips)
Seat 2: 33e83bfb (9,976 in chips)
Seat 3: 28dec1c4 (8,486 in chips)
Seat 4: Hero (12,551 in chips)
Seat 5: 8dffcf83 (15,841 in chips)
Seat 7: fd34e284 (13,712 in chips)
Seat 8: 63283e02 (9,506 in chips)
9b7af51c: posts the ante 24
28dec1c4: posts the ante 24
8dffcf83: posts the ante 24
33e83bfb: posts the ante 24
fd34e284: posts the ante 24
Hero: posts the ante 24
63283e02: posts the ante 24
8dffcf83: posts small blind 80
fd34e284: posts big blind 160
*** HOLE CARDS ***
Dealt to 9b7af51c 
Dealt to 33e83bfb 
Dealt to 28dec1c4 
Dealt to Hero [4d Jh]
Dealt to 8dffcf83 
Dealt to fd34e284 
Dealt to 63283e02 
63283e02: raises 160 to 320
9b7af51c: folds
33e83bfb: folds
28dec1c4: folds
Hero: folds
8dffcf83: calls 240
fd34e284: calls 160
*** FLOP *** [Ac 5h Ad]
8dffcf83: checks
fd34e284: checks
63283e02: checks
*** TURN *** [Ac 5h Ad] [Qh]
8dffcf83: checks
fd34e284: checks
63283e02: checks
*** RIVER *** [Ac 5h Ad Qh] [Qc]
8dffcf83: checks
fd34e284: bets 320
63283e02: calls 320
8dffcf83: folds
fd34e284: shows [9d 7c] (Pair of Aces and Pair of Queens)
63283e02: shows [6s 9s] (Pair of Aces and Pair of Queens)
*** SHOWDOWN ***
63283e02 collected 884 from pot
fd34e284 collected 884 from pot
*** SUMMARY ***
Total pot 1,768 | Rake 0 | Jackpot 0 | Bingo 0 | Fortune 0 | Tax 0
Board [Ac 5h Ad Qh Qc]
Seat 1: 9b7af51c folded before Flop
Seat 2: 33e83bfb folded before Flop
Seat 3: 28dec1c4 folded before Flop
Seat 4: Hero (button) folded before Flop
Seat 5: 8dffcf83 (small blind) folded on the River
Seat 7: fd34e284 (big blind) showed [9d 7c] and won (884) with Pair of Aces and Pair of Queens
Seat 8: 63283e02 showed [6s 9s] and won (884) with Pair of Aces and Pair of Queens


Poker Hand #TM3558269766: Tournament #156882940, Bounty Hunters Special $3.20 Hold'em No Limit - Level3(80/160) - 2024/08/07 10:53:31
Table '66' 8-max Seat #3 is the button
Seat 1: 9b7af51c (8,580 in chips)
Seat 2: 33e83bfb (10,000 in chips)
Seat 3: 28dec1c4 (8,510 in chips)
Seat 4: Hero (12,655 in chips)
Seat 5: 8dffcf83 (16,025 in chips)
Seat 6: 2ac61340 (9,753 in chips)
Seat 7: fd34e284 (13,736 in chips)
Seat 8: 63283e02 (9,530 in chips)
9b7af51c: posts the ante 24
28dec1c4: posts the ante 24
2ac61340: posts the ante 24
8dffcf83: posts the ante 24
33e83bfb: posts the ante 24
fd34e284: posts the ante 24
Hero: posts the ante 24
63283e02: posts the ante 24
Hero: posts small blind 80
8dffcf83: posts big blind 160
*** HOLE CARDS ***
Dealt to 9b7af51c 
Dealt to 33e83bfb 
Dealt to 28dec1c4 
Dealt to Hero [2s 6h]
Dealt to 8dffcf83 
Dealt to 2ac61340 
Dealt to fd34e284 
Dealt to 63283e02 
2ac61340: folds
fd34e284: folds
63283e02: folds
9b7af51c: raises 192 to 352
33e83bfb: folds
28dec1c4: folds
Hero: folds
8dffcf83: folds
Uncalled bet (192) returned to 9b7af51c
*** SHOWDOWN ***
9b7af51c collected 592 from pot
*** SUMMARY ***
Total pot 592 | Rake 0 | Jackpot 0 | Bingo 0 | Fortune 0 | Tax 0
Seat 1: 9b7af51c collected (592)
Seat 2: 33e83bfb folded before Flop
Seat 3: 28dec1c4 (button) folded before Flop
Seat 4: Hero (small blind) folded before Flop
Seat 5: 8dffcf83 (big blind) folded before Flop
Seat 6: 2ac61340 folded before Flop
Seat 7: fd34e284 folded before Flop
Seat 8: 63283e02 folded before Flop


Poker Hand #TM3558269734: Tournament #156882940, Bounty Hunters Special $3.20 Hold'em No Limit - Level3(80/160) - 2024/08/07 10:52:42
Table '66' 8-max Seat #1 is the button
Seat 1: 9b7af51c (8,956 in chips)
Seat 2: 62d04186 (2,219 in chips)
Seat 3: 28dec1c4 (8,694 in chips)
Seat 4: Hero (9,780 in chips)
Seat 5: 8dffcf83 (16,049 in chips)
Seat 6: 2ac61340 (9,777 in chips)
Seat 7: fd34e284 (13,760 in chips)
Seat 8: 63283e02 (9,554 in chips)
9b7af51c: posts the ante 24
28dec1c4: posts the ante 24
2ac61340: posts the ante 24
8dffcf83: posts the ante 24
fd34e284: posts the ante 24
62d04186: posts the ante 24
Hero: posts the ante 24
63283e02: posts the ante 24
62d04186: posts small blind 80
28dec1c4: posts big blind 160
*** HOLE CARDS ***
Dealt to 9b7af51c 
Dealt to 62d04186 
Dealt to 28dec1c4 
Dealt to Hero [Ac Kc]
Dealt to 8dffcf83 
Dealt to 2ac61340 
Dealt to fd34e284 
Dealt to 63283e02 
Hero: calls 160
8dffcf83: folds
2ac61340: folds
fd34e284: folds
63283e02: folds
9b7af51c: raises 192 to 352
62d04186: raises 1,843 to 2,195 and is all-in
28dec1c4: folds
Hero: raises 7,561 to 9,756 and is all-in
9b7af51c: folds
Uncalled bet (7,561) returned to Hero
Hero: shows [Ac Kc]
62d04186: shows [Jc Kh]
*** FLOP *** [5d 9h 3c]
*** TURN *** [5d 9h 3c] [4s]
*** RIVER *** [5d 9h 3c 4s] [Qc]
*** SHOWDOWN ***
Hero collected 5,094 from pot
*** SUMMARY ***
Total pot 5,094 | Rake 0 | Jackpot 0 | Bingo 0 | Fortune 0 | Tax 0
Board [5d 9h 3c 4s Qc]
Seat 1: 9b7af51c (button) folded before Flop
Seat 2: 62d04186 (small blind) showed [Jc Kh] and lost with King-High
Seat 3: 28dec1c4 (big blind) folded before Flop
Seat 4: Hero showed [Ac Kc] and won (5,094) with Ace-High
Seat 5: 8dffcf83 folded before Flop
Seat 6: 2ac61340 folded before Flop
Seat 7: fd34e284 folded before Flop
Seat 8: 63283e02 folded before Flop


Poker Hand #TM3558269701: Tournament #156882940, Bounty Hunters Special $3.20 Hold'em No Limit - Level3(80/160) - 2024/08/07 10:51:56
Table '66' 8-max Seat #8 is the button
Seat 1: 9b7af51c (8,724 in chips)
Seat 2: 62d04186 (1,987 in chips)
Seat 3: 28dec1c4 (8,718 in chips)
Seat 4: Hero (9,804 in chips)
Seat 5: 8dffcf83 (16,073 in chips)
Seat 6: 2ac61340 (9,801 in chips)
Seat 7: fd34e284 (13,944 in chips)
Seat 8: 63283e02 (9,738 in chips)
9b7af51c: posts the ante 24
28dec1c4: posts the ante 24
2ac61340: posts the ante 24
8dffcf83: posts the ante 24
fd34e284: posts the ante 24
62d04186: posts the ante 24
Hero: posts the ante 24
63283e02: posts the ante 24
9b7af51c: posts small blind 80
62d04186: posts big blind 160
*** HOLE CARDS ***
Dealt to 9b7af51c 
Dealt to 62d04186 
Dealt to 28dec1c4 
Dealt to Hero [3h 5s]
Dealt to 8dffcf83 
Dealt to 2ac61340 
Dealt to fd34e284 
Dealt to 63283e02 
28dec1c4: folds
Hero: folds
8dffcf83: folds
2ac61340: folds
fd34e284: calls 160
63283e02: calls 160
9b7af51c: calls 80
62d04186: checks
*** FLOP *** [Td 4h Qs]
9b7af51c: checks
62d04186: bets 416
fd34e284: folds
63283e02: folds
9b7af51c: calls 416
*** TURN *** [Td 4h Qs] [7s]
9b7af51c: checks
62d04186: bets 1,387 and is all-in
9b7af51c: calls 1,387
62d04186: shows [7h Ts] (Pair of Tens and Pair of Sevens)
9b7af51c: shows [Tc 7c] (Pair of Tens and Pair of Sevens)
*** RIVER *** [Td 4h Qs 7s] [9d]
*** SHOWDOWN ***
62d04186 collected 2,219 from pot
9b7af51c collected 2,219 from pot
*** SUMMARY ***
Total pot 4,438 | Rake 0 | Jackpot 0 | Bingo 0 | Fortune 0 | Tax 0
Board [Td 4h Qs 7s 9d]
Seat 1: 9b7af51c (small blind) showed [Tc 7c] and won (2,219) with Pair of Tens and Pair of Sevens
Seat 2: 62d04186 (big blind) showed [7h Ts] and won (2,219) with Pair of Tens and Pair of Sevens
Seat 3: 28dec1c4 folded before Flop
Seat 4: Hero folded before Flop
Seat 5: 8dffcf83 folded before Flop
Seat 6: 2ac61340 folded before Flop
Seat 7: fd34e284 folded on the Flop
Seat 8: 63283e02 (button) folded on the Flop


Poker Hand #TM3558269652: Tournament #156882940, Bounty Hunters Special $3.20 Hold'em No Limit - Level3(80/160) - 2024/08/07 10:50:40
Table '66' 8-max Seat #7 is the button
Seat 1: 9b7af51c (8,908 in chips)
Seat 2: 62d04186 (8,447 in chips)
Seat 3: 28dec1c4 (9,062 in chips)
Seat 4: Hero (10,148 in chips)
Seat 5: 8dffcf83 (16,097 in chips)
Seat 6: 2ac61340 (9,825 in chips)
Seat 7: fd34e284 (6,460 in chips)
Seat 8: 63283e02 (9,842 in chips)
9b7af51c: posts the ante 24
28dec1c4: posts the ante 24
2ac61340: posts the ante 24
8dffcf83: posts the ante 24
fd34e284: posts the ante 24
62d04186: posts the ante 24
Hero: posts the ante 24
63283e02: posts the ante 24
63283e02: posts small blind 80
9b7af51c: posts big blind 160
*** HOLE CARDS ***
Dealt to 9b7af51c 
Dealt to 62d04186 
Dealt to 28dec1c4 
Dealt to Hero [8h 6h]
Dealt to 8dffcf83 
Dealt to 2ac61340 
Dealt to fd34e284 
Dealt to 63283e02 
62d04186: calls 160
28dec1c4: raises 160 to 320
Hero: calls 320
8dffcf83: folds
2ac61340: folds
fd34e284: raises 1,552 to 1,872
63283e02: folds
9b7af51c: folds
62d04186: calls 1,712
28dec1c4: folds
Hero: folds
*** FLOP *** [2h 4c 7h]
62d04186: checks
fd34e284: checks
*** TURN *** [2h 4c 7h] [3h]
62d04186: bets 4,800
fd34e284: calls 4,564 and is all-in
Uncalled bet (236) returned to 62d04186
62d04186: shows [Qd 8c] (Queen-High)
fd34e284: shows [Kh Qc] (King-High)
*** RIVER *** [2h 4c 7h 3h] [9s]
*** SHOWDOWN ***
fd34e284 collected 13,944 from pot
*** SUMMARY ***
Total pot 13,944 | Rake 0 | Jackpot 0 | Bingo 0 | Fortune 0 | Tax 0
Board [2h 4c 7h 3h 9s]
Seat 1: 9b7af51c (big blind) folded before Flop
Seat 2: 62d04186 showed [Qd 8c] and lost with Queen-High
Seat 3: 28dec1c4 folded before Flop
Seat 4: Hero folded before Flop
Seat 5: 8dffcf83 folded before Flop
Seat 6: 2ac61340 folded before Flop
Seat 7: fd34e284 (button) showed [Kh Qc] and won (13,944) with King-High
Seat 8: 63283e02 (small blind) folded before Flop


Poker Hand #TM3558269624: Tournament #156882940, Bounty Hunters Special $3.20 Hold'em No Limit - Level2(60/120) - 2024/08/07 10:49:53
Table '66' 8-max Seat #6 is the button
Seat 1: 9b7af51c (9,688 in chips)
Seat 2: 62d04186 (7,235 in chips)
Seat 3: 28dec1c4 (9,080 in chips)
Seat 4: Hero (10,166 in chips)
Seat 5: 8dffcf83 (16,115 in chips)
Seat 6: 2ac61340 (9,843 in chips)
Seat 7: fd34e284 (6,538 in chips)
Seat 8: 63283e02 (10,124 in chips)
9b7af51c: posts the ante 18
28dec1c4: posts the ante 18
2ac61340: posts the ante 18
8dffcf83: posts the ante 18
62d04186: posts the ante 18
fd34e284: posts the ante 18
Hero: posts the ante 18
63283e02: posts the ante 18
fd34e284: posts small blind 60
63283e02: posts big blind 120
*** HOLE CARDS ***
Dealt to 9b7af51c 
Dealt to 62d04186 
Dealt to 28dec1c4 
Dealt to Hero [Jc 3h]
Dealt to 8dffcf83 
Dealt to 2ac61340 
Dealt to fd34e284 
Dealt to 63283e02 
9b7af51c: raises 144 to 264
62d04186: calls 264
28dec1c4: folds
Hero: folds
8dffcf83: folds
2ac61340: folds
fd34e284: folds
63283e02: calls 144
*** FLOP *** [2s As 4h]
63283e02: checks
9b7af51c: bets 498
62d04186: raises 1,494 to 1,992
63283e02: folds
9b7af51c: folds
Uncalled bet (1,494) returned to 62d04186
*** SHOWDOWN ***
62d04186 collected 1,992 from pot
*** SUMMARY ***
Total pot 1,992 | Rake 0 | Jackpot 0 | Bingo 0 | Fortune 0 | Tax 0
Board [2s As 4h]
Seat 1: 9b7af51c folded on the Flop
Seat 2: 62d04186 won (1,992)
Seat 3: 28dec1c4 folded before Flop
Seat 4: Hero folded before Flop
Seat 5: 8dffcf83 folded before Flop
Seat 6: 2ac61340 (button) folded before Flop
Seat 7: fd34e284 (small blind) folded before Flop
Seat 8: 63283e02 (big blind) folded on the Flop


Poker Hand #TM3558269558: Tournament #156882940, Bounty Hunters Special $3.20 Hold'em No Limit - Level2(60/120) - 2024/08/07 10:48:04
Table '66' 8-max Seat #5 is the button
Seat 1: 9b7af51c (9,706 in chips)
Seat 2: 62d04186 (7,493 in chips)
Seat 3: 28dec1c4 (9,338 in chips)
Seat 4: Hero (10,184 in chips)
Seat 5: 8dffcf83 (16,133 in chips)
Seat 6: 2ac61340 (10,397 in chips)
Seat 7: fd34e284 (6,796 in chips)
Seat 8: 63283e02 (8,742 in chips)
9b7af51c: posts the ante 18
28dec1c4: posts the ante 18
8dffcf83: posts the ante 18
2ac61340: posts the ante 18
62d04186: posts the ante 18
fd34e284: posts the ante 18
Hero: posts the ante 18
63283e02: posts the ante 18
2ac61340: posts small blind 60
fd34e284: posts big blind 120
*** HOLE CARDS ***
Dealt to 9b7af51c 
Dealt to 62d04186 
Dealt to 28dec1c4 
Dealt to Hero [7s 8c]
Dealt to 8dffcf83 
Dealt to 2ac61340 
Dealt to fd34e284 
Dealt to 63283e02 
63283e02: raises 120 to 240
9b7af51c: folds
62d04186: calls 240
28dec1c4: calls 240
Hero: folds
8dffcf83: folds
2ac61340: calls 180
fd34e284: calls 120
*** FLOP *** [2d 6s Kh]
2ac61340: checks
fd34e284: checks
63283e02: bets 296
62d04186: folds
28dec1c4: folds
2ac61340: calls 296
fd34e284: folds
*** TURN *** [2d 6s Kh] [4c]
2ac61340: checks
63283e02: bets 1,200
2ac61340: folds
Uncalled bet (1,200) returned to 63283e02
*** SHOWDOWN ***
63283e02 collected 1,936 from pot
*** SUMMARY ***
Total pot 1,936 | Rake 0 | Jackpot 0 | Bingo 0 | Fortune 0 | Tax 0
Board [2d 6s Kh 4c]
Seat 1: 9b7af51c folded before Flop
Seat 2: 62d04186 folded on the Flop
Seat 3: 28dec1c4 folded on the Flop
Seat 4: Hero folded before Flop
Seat 5: 8dffcf83 (button) folded before Flop
Seat 6: 2ac61340 (small blind) folded on the Turn
Seat 7: fd34e284 (big blind) folded on the Flop
Seat 8: 63283e02 won (1,936)


Poker Hand #TM3558269516: Tournament #156882940, Bounty Hunters Special $3.20 Hold'em No Limit - Level2(60/120) - 2024/08/07 10:47:00
Table '66' 8-max Seat #4 is the button
Seat 1: 9b7af51c (9,724 in chips)
Seat 2: 62d04186 (7,631 in chips)
Seat 3: 28dec1c4 (9,356 in chips)
Seat 4: Hero (10,202 in chips)
Seat 5: 8dffcf83 (16,211 in chips)
Seat 6: 2ac61340 (9,971 in chips)
Seat 7: fd34e284 (6,934 in chips)
Seat 8: 63283e02 (8,760 in chips)
9b7af51c: posts the ante 18
28dec1c4: posts the ante 18
2ac61340: posts the ante 18
8dffcf83: posts the ante 18
62d04186: posts the ante 18
fd34e284: posts the ante 18
Hero: posts the ante 18
63283e02: posts the ante 18
8dffcf83: posts small blind 60
2ac61340: posts big blind 120
*** HOLE CARDS ***
Dealt to 9b7af51c 
Dealt to 62d04186 
Dealt to 28dec1c4 
Dealt to Hero [8h 2s]
Dealt to 8dffcf83 
Dealt to 2ac61340 
Dealt to fd34e284 
Dealt to 63283e02 
fd34e284: calls 120
63283e02: folds
9b7af51c: folds
62d04186: calls 120
28dec1c4: folds
Hero: folds
8dffcf83: folds
2ac61340: checks
*** FLOP *** [2c 8d Tc]
2ac61340: checks
fd34e284: checks
62d04186: checks
*** TURN *** [2c 8d Tc] [Ks]
2ac61340: bets 423
fd34e284: folds
62d04186: folds
Uncalled bet (423) returned to 2ac61340
*** SHOWDOWN ***
2ac61340 collected 564 from pot
*** SUMMARY ***
Total pot 564 | Rake 0 | Jackpot 0 | Bingo 0 | Fortune 0 | Tax 0
Board [2c 8d Tc Ks]
Seat 1: 9b7af51c folded before Flop
Seat 2: 62d04186 folded on the Turn
Seat 3: 28dec1c4 folded before Flop
Seat 4: Hero (button) folded before Flop
Seat 5: 8dffcf83 (small blind) folded before Flop
Seat 6: 2ac61340 (big blind) won (564)
Seat 7: fd34e284 folded on the Turn
Seat 8: 63283e02 folded before Flop


Poker Hand #TM3558269481: Tournament #156882940, Bounty Hunters Special $3.20 Hold'em No Limit - Level2(60/120) - 2024/08/07 10:46:15
Table '66' 8-max Seat #3 is the button
Seat 1: 9b7af51c (9,982 in chips)
Seat 2: 62d04186 (7,649 in chips)
Seat 3: 28dec1c4 (9,374 in chips)
Seat 4: Hero (10,280 in chips)
Seat 5: 8dffcf83 (16,349 in chips)
Seat 6: 2ac61340 (9,425 in chips)
Seat 7: fd34e284 (6,952 in chips)
Seat 8: 63283e02 (8,778 in chips)
9b7af51c: posts the ante 18
28dec1c4: posts the ante 18
2ac61340: posts the ante 18
8dffcf83: posts the ante 18
62d04186: posts the ante 18
fd34e284: posts the ante 18
Hero: posts the ante 18
63283e02: posts the ante 18
Hero: posts small blind 60
8dffcf83: posts big blind 120
*** HOLE CARDS ***
Dealt to 9b7af51c 
Dealt to 62d04186 
Dealt to 28dec1c4 
Dealt to Hero [8s Td]
Dealt to 8dffcf83 
Dealt to 2ac61340 
Dealt to fd34e284 
Dealt to 63283e02 
2ac61340: raises 120 to 240
fd34e284: folds
63283e02: folds
9b7af51c: calls 240
62d04186: folds
28dec1c4: folds
Hero: folds
8dffcf83: folds
*** FLOP *** [7h 6c Js]
2ac61340: bets 603
9b7af51c: folds
Uncalled bet (603) returned to 2ac61340
*** SHOWDOWN ***
2ac61340 collected 804 from pot
*** SUMMARY ***
Total pot 804 | Rake 0 | Jackpot 0 | Bingo 0 | Fortune 0 | Tax 0
Board [7h 6c Js]
Seat 1: 9b7af51c folded on the Flop
Seat 2: 62d04186 folded before Flop
Seat 3: 28dec1c4 (button) folded before Flop
Seat 4: Hero (small blind) folded before Flop
Seat 5: 8dffcf83 (big blind) folded before Flop
Seat 6: 2ac61340 won (804)
Seat 7: fd34e284 folded before Flop
Seat 8: 63283e02 folded before Flop


Poker Hand #TM3558269444: Tournament #156882940, Bounty Hunters Special $3.20 Hold'em No Limit - Level2(60/120) - 2024/08/07 10:45:08
Table '66' 8-max Seat #2 is the button
Seat 1: 9b7af51c (10,000 in chips)
Seat 2: 62d04186 (7,667 in chips)
Seat 3: 28dec1c4 (9,918 in chips)
Seat 4: Hero (10,538 in chips)
Seat 5: 8dffcf83 (16,367 in chips)
Seat 6: 2ac61340 (9,443 in chips)
Seat 7: fd34e284 (6,060 in chips)
Seat 8: 63283e02 (8,796 in chips)
9b7af51c: posts the ante 18
28dec1c4: posts the ante 18
2ac61340: posts the ante 18
8dffcf83: posts the ante 18
62d04186: posts the ante 18
fd34e284: posts the ante 18
Hero: posts the ante 18
63283e02: posts the ante 18
28dec1c4: posts small blind 60
Hero: posts big blind 120
*** HOLE CARDS ***
Dealt to 9b7af51c 
Dealt to 62d04186 
Dealt to 28dec1c4 
Dealt to Hero [7s 4c]
Dealt to 8dffcf83 
Dealt to 2ac61340 
Dealt to fd34e284 
Dealt to 63283e02 
8dffcf83: folds
2ac61340: folds
fd34e284: raises 120 to 240
63283e02: folds
9b7af51c: folds
62d04186: folds
28dec1c4: calls 180
Hero: calls 120
*** FLOP *** [Ad Jc 8s]
28dec1c4: checks
Hero: checks
fd34e284: checks
*** TURN *** [Ad Jc 8s] [Qs]
28dec1c4: bets 286
Hero: folds
fd34e284: calls 286
*** RIVER *** [Ad Jc 8s Qs] [2h]
28dec1c4: checks
fd34e284: bets 1,436
28dec1c4: folds
Uncalled bet (1,436) returned to fd34e284
*** SHOWDOWN ***
fd34e284 collected 1,436 from pot
*** SUMMARY ***
Total pot 1,436 | Rake 0 | Jackpot 0 | Bingo 0 | Fortune 0 | Tax 0
Board [Ad Jc 8s Qs 2h]
Seat 1: 9b7af51c folded before Flop
Seat 2: 62d04186 (button) folded before Flop
Seat 3: 28dec1c4 (small blind) folded on the River
Seat 4: Hero (big blind) folded on the Turn
Seat 5: 8dffcf83 folded before Flop
Seat 6: 2ac61340 folded before Flop
Seat 7: fd34e284 won (1,436)
Seat 8: 63283e02 folded before Flop


Poker Hand #TM3558269389: Tournament #156882940, Bounty Hunters Special $3.20 Hold'em No Limit - Level2(60/120) - 2024/08/07 10:43:19
Table '66' 8-max Seat #8 is the button
Seat 2: 62d04186 (7,745 in chips)
Seat 3: 28dec1c4 (10,056 in chips)
Seat 4: Hero (10,556 in chips)
Seat 5: 8dffcf83 (12,164 in chips)
Seat 6: 2ac61340 (9,461 in chips)
Seat 7: fd34e284 (9,717 in chips)
Seat 8: 63283e02 (9,090 in chips)
28dec1c4: posts the ante 18
2ac61340: posts the ante 18
8dffcf83: posts the ante 18
fd34e284: posts the ante 18
62d04186: posts the ante 18
Hero: posts the ante 18
63283e02: posts the ante 18
62d04186: posts small blind 60
28dec1c4: posts big blind 120
*** HOLE CARDS ***
Dealt to 62d04186 
Dealt to 28dec1c4 
Dealt to Hero [8c Qd]
Dealt to 8dffcf83 
Dealt to 2ac61340 
Dealt to fd34e284 
Dealt to 63283e02 
Hero: folds
8dffcf83: raises 156 to 276
2ac61340: folds
fd34e284: calls 276
63283e02: calls 276
62d04186: folds
28dec1c4: folds
*** FLOP *** [3d Jh 9c]
8dffcf83: checks
fd34e284: bets 495
63283e02: folds
8dffcf83: raises 1,305 to 1,800
fd34e284: calls 1,305
*** TURN *** [3d Jh 9c] [Ad]
8dffcf83: bets 1,563
fd34e284: calls 1,563
*** RIVER *** [3d Jh 9c Ad] [Qs]
8dffcf83: bets 8,507 and is all-in
fd34e284: folds
Uncalled bet (8,507) returned to 8dffcf83
*** SHOWDOWN ***
8dffcf83 collected 7,860 from pot
*** SUMMARY ***
Total pot 7,860 | Rake 0 | Jackpot 0 | Bingo 0 | Fortune 0 | Tax 0
Board [3d Jh 9c Ad Qs]
Seat 2: 62d04186 (small blind) folded before Flop
Seat 3: 28dec1c4 (big blind) folded before Flop
Seat 4: Hero folded before Flop
Seat 5: 8dffcf83 won (7,860)
Seat 6: 2ac61340 folded before Flop
Seat 7: fd34e284 folded on the River
Seat 8: 63283e02 (button) folded on the Flop


Poker Hand #TM3558269358: Tournament #156882940, Bounty Hunters Special $3.20 Hold'em No Limit - Level2(60/120) - 2024/08/07 10:42:31
Table '66' 8-max Seat #7 is the button
Seat 2: 62d04186 (8,323 in chips)
Seat 3: 28dec1c4 (10,074 in chips)
Seat 4: Hero (10,574 in chips)
Seat 5: 8dffcf83 (12,182 in chips)
Seat 6: 2ac61340 (9,479 in chips)
Seat 7: fd34e284 (8,989 in chips)
Seat 8: 63283e02 (9,168 in chips)
28dec1c4: posts the ante 18
2ac61340: posts the ante 18
8dffcf83: posts the ante 18
fd34e284: posts the ante 18
62d04186: posts the ante 18
Hero: posts the ante 18
63283e02: posts the ante 18
63283e02: posts small blind 60
62d04186: posts big blind 120
*** HOLE CARDS ***
Dealt to 62d04186 
Dealt to 28dec1c4 
Dealt to Hero [5d 3h]
Dealt to 8dffcf83 
Dealt to 2ac61340 
Dealt to fd34e284 
Dealt to 63283e02 
28dec1c4: folds
Hero: folds
8dffcf83: folds
2ac61340: folds
fd34e284: raises 180 to 300
63283e02: folds
62d04186: calls 180
*** FLOP *** [2d 7d As]
62d04186: bets 260
fd34e284: raises 980 to 1,240
62d04186: folds
Uncalled bet (980) returned to fd34e284
fd34e284: shows [Qh 8h] (Ace-High)
*** SHOWDOWN ***
fd34e284 collected 1,306 from pot
*** SUMMARY ***
Total pot 1,306 | Rake 0 | Jackpot 0 | Bingo 0 | Fortune 0 | Tax 0
Board [2d 7d As]
Seat 2: 62d04186 (big blind) folded on the Flop
Seat 3: 28dec1c4 folded before Flop
Seat 4: Hero folded before Flop
Seat 5: 8dffcf83 folded before Flop
Seat 6: 2ac61340 folded before Flop
Seat 7: fd34e284 (button) showed [Qh 8h] and won (1,306)
Seat 8: 63283e02 (small blind) folded before Flop


Poker Hand #TM3558269317: Tournament #156882940, Bounty Hunters Special $3.20 Hold'em No Limit - Level2(60/120) - 2024/08/07 10:41:23
Table '66' 8-max Seat #6 is the button
Seat 1: f502980e (10,948 in chips)
Seat 2: 62d04186 (8,341 in chips)
Seat 3: 28dec1c4 (10,092 in chips)
Seat 4: Hero (10,490 in chips)
Seat 5: 8dffcf83 (12,200 in chips)
Seat 6: 2ac61340 (9,497 in chips)
Seat 7: fd34e284 (9,067 in chips)
Seat 8: 63283e02 (9,084 in chips)
28dec1c4: posts the ante 18
2ac61340: posts the ante 18
8dffcf83: posts the ante 18
62d04186: posts the ante 18
fd34e284: posts the ante 18
Hero: posts the ante 18
f502980e: posts the ante 18
63283e02: posts the ante 18
fd34e284: posts small blind 60
63283e02: posts big blind 120
*** HOLE CARDS ***
Dealt to f502980e 
Dealt to 62d04186 
Dealt to 28dec1c4 
Dealt to Hero [Qh Td]
Dealt to 8dffcf83 
Dealt to 2ac61340 
Dealt to fd34e284 
Dealt to 63283e02 
f502980e: folds
62d04186: folds
28dec1c4: folds
Hero: raises 120 to 240
8dffcf83: folds
2ac61340: folds
fd34e284: folds
63283e02: calls 120
*** FLOP *** [4d Qc 6c]
63283e02: checks
Hero: bets 342
63283e02: calls 342
*** TURN *** [4d Qc 6c] [7c]
63283e02: checks
Hero: checks
*** RIVER *** [4d Qc 6c 7c] [Kh]
63283e02: bets 360
Hero: calls 360
63283e02: shows [Qs Tc] (Pair of Queens)
Hero: shows [Qh Td] (Pair of Queens)
*** SHOWDOWN ***
Hero collected 1,044 from pot
63283e02 collected 1,044 from pot
*** SUMMARY ***
Total pot 2,088 | Rake 0 | Jackpot 0 | Bingo 0 | Fortune 0 | Tax 0
Board [4d Qc 6c 7c Kh]
Seat 1: f502980e folded before Flop
Seat 2: 62d04186 folded before Flop
Seat 3: 28dec1c4 folded before Flop
Seat 4: Hero showed [Qh Td] and won (1,044) with Pair of Queens
Seat 5: 8dffcf83 folded before Flop
Seat 6: 2ac61340 (button) folded before Flop
Seat 7: fd34e284 (small blind) folded before Flop
Seat 8: 63283e02 (big blind) showed [Qs Tc] and won (1,044) with Pair of Queens


Poker Hand #TM3558269292: Tournament #156882940, Bounty Hunters Special $3.20 Hold'em No Limit - Level2(60/120) - 2024/08/07 10:40:43
Table '66' 8-max Seat #5 is the button
Seat 1: f502980e (10,966 in chips)
Seat 2: 62d04186 (8,359 in chips)
Seat 3: 28dec1c4 (10,110 in chips)
Seat 4: Hero (9,944 in chips)
Seat 5: 8dffcf83 (12,218 in chips)
Seat 6: 2ac61340 (9,575 in chips)
Seat 7: fd34e284 (9,445 in chips)
Seat 8: 63283e02 (9,102 in chips)
28dec1c4: posts the ante 18
8dffcf83: posts the ante 18
2ac61340: posts the ante 18
62d04186: posts the ante 18
fd34e284: posts the ante 18
Hero: posts the ante 18
f502980e: posts the ante 18
63283e02: posts the ante 18
2ac61340: posts small blind 60
fd34e284: posts big blind 120
*** HOLE CARDS ***
Dealt to f502980e 
Dealt to 62d04186 
Dealt to 28dec1c4 
Dealt to Hero [Qc Js]
Dealt to 8dffcf83 
Dealt to 2ac61340 
Dealt to fd34e284 
Dealt to 63283e02 
63283e02: folds
f502980e: folds
62d04186: folds
28dec1c4: folds
Hero: raises 240 to 360
8dffcf83: folds
2ac61340: folds
fd34e284: calls 240
*** FLOP *** [Ks 8d Kd]
fd34e284: checks
Hero: bets 305
fd34e284: folds
Uncalled bet (305) returned to Hero
fd34e284: shows [Ac]
*** SHOWDOWN ***
Hero collected 924 from pot
*** SUMMARY ***
Total pot 924 | Rake 0 | Jackpot 0 | Bingo 0 | Fortune 0 | Tax 0
Board [Ks 8d Kd]
Seat 1: f502980e folded before Flop
Seat 2: 62d04186 folded before Flop
Seat 3: 28dec1c4 folded before Flop
Seat 4: Hero won (924)
Seat 5: 8dffcf83 (button) folded before Flop
Seat 6: 2ac61340 (small blind) folded before Flop
Seat 7: fd34e284 (big blind) folded on the Flop
Seat 8: 63283e02 folded before Flop


Poker Hand #TM3558269221: Tournament #156882940, Bounty Hunters Special $3.20 Hold'em No Limit - Level1(50/100) - 2024/08/07 10:38:57
Table '66' 8-max Seat #4 is the button
Seat 1: f502980e (9,890 in chips)
Seat 2: 62d04186 (8,895 in chips)
Seat 3: 28dec1c4 (10,125 in chips)
Seat 4: Hero (10,159 in chips)
Seat 5: 8dffcf83 (12,283 in chips)
Seat 6: 2ac61340 (9,790 in chips)
Seat 7: fd34e284 (9,460 in chips)
Seat 8: 63283e02 (9,117 in chips)
28dec1c4: posts the ante 15
2ac61340: posts the ante 15
8dffcf83: posts the ante 15
62d04186: posts the ante 15
fd34e284: posts the ante 15
Hero: posts the ante 15
f502980e: posts the ante 15
63283e02: posts the ante 15
8dffcf83: posts small blind 50
2ac61340: posts big blind 100
*** HOLE CARDS ***
Dealt to f502980e 
Dealt to 62d04186 
Dealt to 28dec1c4 
Dealt to Hero [Qd Ah]
Dealt to 8dffcf83 
Dealt to 2ac61340 
Dealt to fd34e284 
Dealt to 63283e02 
fd34e284: folds
63283e02: folds
f502980e: raises 100 to 200
62d04186: calls 200
28dec1c4: folds
Hero: calls 200
8dffcf83: folds
2ac61340: calls 100
*** FLOP *** [3c 8s Jd]
2ac61340: checks
f502980e: checks
62d04186: bets 321
Hero: folds
2ac61340: folds
f502980e: calls 321
*** TURN *** [3c 8s Jd] [6s]
f502980e: checks
62d04186: checks
*** RIVER *** [3c 8s Jd 6s] [5c]
f502980e: checks
62d04186: checks
f502980e: shows [2h 2d] (Pair of Twos)
62d04186: shows [9h As] (Ace-High)
*** SHOWDOWN ***
f502980e collected 1,612 from pot
*** SUMMARY ***
Total pot 1,612 | Rake 0 | Jackpot 0 | Bingo 0 | Fortune 0 | Tax 0
Board [3c 8s Jd 6s 5c]
Seat 1: f502980e showed [2h 2d] and won (1,612) with Pair of Twos
Seat 2: 62d04186 showed [9h As] and lost with Ace-High
Seat 3: 28dec1c4 folded before Flop
Seat 4: Hero (button) folded on the Flop
Seat 5: 8dffcf83 (small blind) folded before Flop
Seat 6: 2ac61340 (big blind) folded on the Flop
Seat 7: fd34e284 folded before Flop
Seat 8: 63283e02 folded before Flop


Poker Hand #TM3558269201: Tournament #156882940, Bounty Hunters Special $3.20 Hold'em No Limit - Level1(50/100) - 2024/08/07 10:38:21
Table '66' 8-max Seat #3 is the button
Seat 1: f502980e (9,905 in chips)
Seat 2: 62d04186 (8,292 in chips)
Seat 3: 28dec1c4 (10,140 in chips)
Seat 4: Hero (10,224 in chips)
Seat 5: 8dffcf83 (12,398 in chips)
Seat 6: 2ac61340 (9,805 in chips)
Seat 7: fd34e284 (9,475 in chips)
Seat 8: 63283e02 (9,480 in chips)
28dec1c4: posts the ante 15
2ac61340: posts the ante 15
8dffcf83: posts the ante 15
62d04186: posts the ante 15
fd34e284: posts the ante 15
f502980e: posts the ante 15
Hero: posts the ante 15
63283e02: posts the ante 15
Hero: posts small blind 50
8dffcf83: posts big blind 100
*** HOLE CARDS ***
Dealt to f502980e 
Dealt to 62d04186 
Dealt to 28dec1c4 
Dealt to Hero [8s Kd]
Dealt to 8dffcf83 
Dealt to 2ac61340 
Dealt to fd34e284 
Dealt to 63283e02 
2ac61340: folds
fd34e284: folds
63283e02: raises 100 to 200
f502980e: folds
62d04186: calls 200
28dec1c4: folds
Hero: folds
8dffcf83: folds
*** FLOP *** [8h 3d 6c]
63283e02: checks
62d04186: checks
*** TURN *** [8h 3d 6c] [Ts]
63283e02: bets 148
62d04186: calls 148
*** RIVER *** [8h 3d 6c Ts] [9c]
63283e02: checks
62d04186: checks
63283e02: shows [5d 6d] (Pair of Sixes)
62d04186: shows [9h Jc] (Pair of Nines)
*** SHOWDOWN ***
62d04186 collected 966 from pot
*** SUMMARY ***
Total pot 966 | Rake 0 | Jackpot 0 | Bingo 0 | Fortune 0 | Tax 0
Board [8h 3d 6c Ts 9c]
Seat 1: f502980e folded before Flop
Seat 2: 62d04186 showed [9h Jc] and won (966) with Pair of Nines
Seat 3: 28dec1c4 (button) folded before Flop
Seat 4: Hero (small blind) folded before Flop
Seat 5: 8dffcf83 (big blind) folded before Flop
Seat 6: 2ac61340 folded before Flop
Seat 7: fd34e284 folded before Flop
Seat 8: 63283e02 showed [5d 6d] and lost with Pair of Sixes


Poker Hand #TM3558269153: Tournament #156882940, Bounty Hunters Special $3.20 Hold'em No Limit - Level1(50/100) - 2024/08/07 10:36:59
Table '66' 8-max Seat #2 is the button
Seat 1: f502980e (9,920 in chips)
Seat 2: 62d04186 (9,405 in chips)
Seat 3: 28dec1c4 (10,205 in chips)
Seat 4: Hero (10,449 in chips)
Seat 5: 8dffcf83 (10,725 in chips)
Seat 6: 2ac61340 (9,820 in chips)
Seat 7: fd34e284 (9,700 in chips)
Seat 8: 63283e02 (9,495 in chips)
28dec1c4: posts the ante 15
2ac61340: posts the ante 15
8dffcf83: posts the ante 15
62d04186: posts the ante 15
fd34e284: posts the ante 15
f502980e: posts the ante 15
Hero: posts the ante 15
63283e02: posts the ante 15
28dec1c4: posts small blind 50
Hero: posts big blind 100
*** HOLE CARDS ***
Dealt to f502980e 
Dealt to 62d04186 
Dealt to 28dec1c4 
Dealt to Hero [6c 3c]
Dealt to 8dffcf83 
Dealt to 2ac61340 
Dealt to fd34e284 
Dealt to 63283e02 
8dffcf83: raises 110 to 210
2ac61340: folds
fd34e284: calls 210
63283e02: folds
f502980e: folds
62d04186: calls 210
28dec1c4: folds
Hero: calls 110
*** FLOP *** [Kc 9s Ah]
Hero: checks
8dffcf83: checks
fd34e284: checks
62d04186: bets 334
Hero: folds
8dffcf83: calls 334
fd34e284: folds
*** TURN *** [Kc 9s Ah] [Qd]
8dffcf83: checks
62d04186: bets 554
8dffcf83: calls 554
*** RIVER *** [Kc 9s Ah Qd] [Jh]
8dffcf83: checks
62d04186: checks
8dffcf83: shows [Jd Qs] (Pair of Queens and Pair of Jacks)
62d04186: shows [Ac 8d] (Pair of Aces)
*** SHOWDOWN ***
8dffcf83 collected 2,786 from pot
*** SUMMARY ***
Total pot 2,786 | Rake 0 | Jackpot 0 | Bingo 0 | Fortune 0 | Tax 0
Board [Kc 9s Ah Qd Jh]
Seat 1: f502980e folded before Flop
Seat 2: 62d04186 (button) showed [Ac 8d] and lost with Pair of Aces
Seat 3: 28dec1c4 (small blind) folded before Flop
Seat 4: Hero (big blind) folded on the Flop
Seat 5: 8dffcf83 showed [Jd Qs] and won (2,786) with Pair of Queens and Pair of Jacks
Seat 6: 2ac61340 folded before Flop
Seat 7: fd34e284 folded on the Flop
Seat 8: 63283e02 folded before Flop


Poker Hand #TM3558269130: Tournament #156882940, Bounty Hunters Special $3.20 Hold'em No Limit - Level1(50/100) - 2024/08/07 10:36:21
Table '66' 8-max Seat #1 is the button
Seat 1: f502980e (9,935 in chips)
Seat 2: 62d04186 (9,520 in chips)
Seat 3: 28dec1c4 (10,000 in chips)
Seat 4: Hero (10,464 in chips)
Seat 5: 8dffcf83 (10,740 in chips)
Seat 6: 2ac61340 (9,835 in chips)
Seat 7: fd34e284 (9,715 in chips)
Seat 8: 63283e02 (9,510 in chips)
28dec1c4: posts the ante 15
2ac61340: posts the ante 15
8dffcf83: posts the ante 15
fd34e284: posts the ante 15
62d04186: posts the ante 15
f502980e: posts the ante 15
Hero: posts the ante 15
63283e02: posts the ante 15
62d04186: posts small blind 50
28dec1c4: posts big blind 100
*** HOLE CARDS ***
Dealt to f502980e 
Dealt to 62d04186 
Dealt to 28dec1c4 
Dealt to Hero [9d 6c]
Dealt to 8dffcf83 
Dealt to 2ac61340 
Dealt to fd34e284 
Dealt to 63283e02 
Hero: folds
8dffcf83: folds
2ac61340: folds
fd34e284: folds
63283e02: folds
f502980e: folds
62d04186: calls 50
28dec1c4: checks
*** FLOP *** [Kh 2c 4d]
62d04186: checks
28dec1c4: bets 100
62d04186: folds
Uncalled bet (100) returned to 28dec1c4
*** SHOWDOWN ***
28dec1c4 collected 320 from pot
*** SUMMARY ***
Total pot 320 | Rake 0 | Jackpot 0 | Bingo 0 | Fortune 0 | Tax 0
Board [Kh 2c 4d]
Seat 1: f502980e (button) folded before Flop
Seat 2: 62d04186 (small blind) folded on the Flop
Seat 3: 28dec1c4 (big blind) won (320)
Seat 4: Hero folded before Flop
Seat 5: 8dffcf83 folded before Flop
Seat 6: 2ac61340 folded before Flop
Seat 7: fd34e284 folded before Flop
Seat 8: 63283e02 folded before Flop


Poker Hand #TM3558062261: Tournament #156882940, Bounty Hunters Special $3.20 Hold'em No Limit - Level1(50/100) - 2024/08/07 10:34:42
Table '41' 8-max Seat #4 is the button
Seat 1: e6cc8927 (9,970 in chips)
Seat 2: c442e2db (9,760 in chips)
Seat 3: d2f0a130 (8,991 in chips)
Seat 4: a84b48e4 (11,270 in chips)
Seat 5: 264c31b1 (15,270 in chips)
Seat 6: 64c63b58 (3,723 in chips)
Seat 7: b6ce17 (10,425 in chips)
Seat 8: Hero (10,679 in chips)
a84b48e4: posts the ante 15
b6ce17: posts the ante 15
c442e2db: posts the ante 15
64c63b58: posts the ante 15
264c31b1: posts the ante 15
e6cc8927: posts the ante 15
d2f0a130: posts the ante 15
Hero: posts the ante 15
264c31b1: posts small blind 50
64c63b58: posts big blind 100
*** HOLE CARDS ***
Dealt to e6cc8927 
Dealt to c442e2db 
Dealt to d2f0a130 
Dealt to a84b48e4 
Dealt to 264c31b1 
Dealt to 64c63b58 
Dealt to b6ce17 
Dealt to Hero [Ac 9h]
b6ce17: folds
Hero: raises 100 to 200
e6cc8927: folds
c442e2db: folds
d2f0a130: calls 200
a84b48e4: folds
264c31b1: folds
64c63b58: calls 100
*** FLOP *** [Jd 6h 6c]
64c63b58: checks
Hero: checks
d2f0a130: checks
*** TURN *** [Jd 6h 6c] [Qd]
64c63b58: checks
Hero: checks
d2f0a130: bets 385
64c63b58: folds
Hero: folds
Uncalled bet (385) returned to d2f0a130
*** SHOWDOWN ***
d2f0a130 collected 770 from pot
*** SUMMARY ***
Total pot 770 | Rake 0 | Jackpot 0 | Bingo 0 | Fortune 0 | Tax 0
Board [Jd 6h 6c Qd]
Seat 1: e6cc8927 folded before Flop
Seat 2: c442e2db folded before Flop
Seat 3: d2f0a130 won (770)
Seat 4: a84b48e4 (button) folded before Flop
Seat 5: 264c31b1 (small blind) folded before Flop
Seat 6: 64c63b58 (big blind) folded on the Turn
Seat 7: b6ce17 folded before Flop
Seat 8: Hero folded on the Turn


Poker Hand #TM3558062246: Tournament #156882940, Bounty Hunters Special $3.20 Hold'em No Limit - Level1(50/100) - 2024/08/07 10:34:05
Table '41' 8-max Seat #3 is the button
Seat 1: e6cc8927 (9,985 in chips)
Seat 2: c442e2db (9,775 in chips)
Seat 3: d2f0a130 (9,006 in chips)
Seat 4: a84b48e4 (11,335 in chips)
Seat 5: 264c31b1 (15,585 in chips)
Seat 6: 64c63b58 (3,738 in chips)
Seat 7: b6ce17 (9,970 in chips)
Seat 8: Hero (10,694 in chips)
a84b48e4: posts the ante 15
b6ce17: posts the ante 15
c442e2db: posts the ante 15
64c63b58: posts the ante 15
264c31b1: posts the ante 15
e6cc8927: posts the ante 15
d2f0a130: posts the ante 15
Hero: posts the ante 15
a84b48e4: posts small blind 50
264c31b1: posts big blind 100
*** HOLE CARDS ***
Dealt to e6cc8927 
Dealt to c442e2db 
Dealt to d2f0a130 
Dealt to a84b48e4 
Dealt to 264c31b1 
Dealt to 64c63b58 
Dealt to b6ce17 
Dealt to Hero [2s 7h]
64c63b58: folds
b6ce17: raises 200 to 300
Hero: folds
e6cc8927: folds
c442e2db: folds
d2f0a130: folds
a84b48e4: folds
264c31b1: calls 200
*** FLOP *** [Qs Ah 3c]
264c31b1: checks
b6ce17: bets 385
264c31b1: folds
Uncalled bet (385) returned to b6ce17
*** SHOWDOWN ***
b6ce17 collected 770 from pot
*** SUMMARY ***
Total pot 770 | Rake 0 | Jackpot 0 | Bingo 0 | Fortune 0 | Tax 0
Board [Qs Ah 3c]
Seat 1: e6cc8927 folded before Flop
Seat 2: c442e2db folded before Flop
Seat 3: d2f0a130 (button) folded before Flop
Seat 4: a84b48e4 (small blind) folded before Flop
Seat 5: 264c31b1 (big blind) folded on the Flop
Seat 6: 64c63b58 folded before Flop
Seat 7: b6ce17 won (770)
Seat 8: Hero folded before Flop


Poker Hand #TM3558062215: Tournament #156882940, Bounty Hunters Special $3.20 Hold'em No Limit - Level1(50/100) - 2024/08/07 10:33:23
Table '41' 8-max Seat #2 is the button
Seat 1: e6cc8927 (10,000 in chips)
Seat 2: c442e2db (9,790 in chips)
Seat 3: d2f0a130 (9,121 in chips)
Seat 4: a84b48e4 (10,430 in chips)
Seat 5: 264c31b1 (15,600 in chips)
Seat 6: 64c63b58 (4,353 in chips)
Seat 7: b6ce17 (9,985 in chips)
Seat 8: Hero (10,809 in chips)
a84b48e4: posts the ante 15
b6ce17: posts the ante 15
c442e2db: posts the ante 15
64c63b58: posts the ante 15
264c31b1: posts the ante 15
e6cc8927: posts the ante 15
Hero: posts the ante 15
d2f0a130: posts the ante 15
d2f0a130: posts small blind 50
a84b48e4: posts big blind 100
*** HOLE CARDS ***
Dealt to e6cc8927 
Dealt to c442e2db 
Dealt to d2f0a130 
Dealt to a84b48e4 
Dealt to 264c31b1 
Dealt to 64c63b58 
Dealt to b6ce17 
Dealt to Hero [8s Ts]
264c31b1: folds
64c63b58: calls 100
b6ce17: folds
Hero: calls 100
e6cc8927: folds
c442e2db: folds
d2f0a130: calls 50
a84b48e4: raises 500 to 600
64c63b58: calls 500
Hero: folds
d2f0a130: folds
*** FLOP *** [8c Td 4s]
a84b48e4: bets 502
64c63b58: folds
Uncalled bet (502) returned to a84b48e4
*** SHOWDOWN ***
a84b48e4 collected 1,520 from pot
*** SUMMARY ***
Total pot 1,520 | Rake 0 | Jackpot 0 | Bingo 0 | Fortune 0 | Tax 0
Board [8c Td 4s]
Seat 1: e6cc8927 folded before Flop
Seat 2: c442e2db (button) folded before Flop
Seat 3: d2f0a130 (small blind) folded before Flop
Seat 4: a84b48e4 (big blind) won (1,520)
Seat 5: 264c31b1 folded before Flop
Seat 6: 64c63b58 folded on the Flop
Seat 7: b6ce17 folded before Flop
Seat 8: Hero folded before Flop


Poker Hand #TM3558062186: Tournament #156882940, Bounty Hunters Special $3.20 Hold'em No Limit - Level1(50/100) - 2024/08/07 10:32:31
Table '41' 8-max Seat #8 is the button
Seat 2: c442e2db (9,855 in chips)
Seat 3: d2f0a130 (10,000 in chips)
Seat 4: a84b48e4 (10,445 in chips)
Seat 5: 264c31b1 (15,615 in chips)
Seat 6: 64c63b58 (4,368 in chips)
Seat 7: b6ce17 (10,000 in chips)
Seat 8: Hero (9,805 in chips)
a84b48e4: posts the ante 15
b6ce17: posts the ante 15
c442e2db: posts the ante 15
64c63b58: posts the ante 15
264c31b1: posts the ante 15
Hero: posts the ante 15
d2f0a130: posts the ante 15
c442e2db: posts small blind 50
d2f0a130: posts big blind 100
*** HOLE CARDS ***
Dealt to c442e2db 
Dealt to d2f0a130 
Dealt to a84b48e4 
Dealt to 264c31b1 
Dealt to 64c63b58 
Dealt to b6ce17 
Dealt to Hero [4s 9s]
a84b48e4: folds
264c31b1: folds
64c63b58: folds
b6ce17: folds
Hero: raises 100 to 200
c442e2db: folds
d2f0a130: calls 100
*** FLOP *** [8s Js 2c]
d2f0a130: checks
Hero: checks
*** TURN *** [8s Js 2c] [Th]
d2f0a130: bets 234
Hero: calls 234
*** RIVER *** [8s Js 2c Th] [5s]
d2f0a130: bets 430
Hero: raises 770 to 1,200
d2f0a130: folds
Uncalled bet (770) returned to Hero
*** SHOWDOWN ***
Hero collected 1,883 from pot
*** SUMMARY ***
Total pot 1,883 | Rake 0 | Jackpot 0 | Bingo 0 | Fortune 0 | Tax 0
Board [8s Js 2c Th 5s]
Seat 2: c442e2db (small blind) folded before Flop
Seat 3: d2f0a130 (big blind) folded on the River
Seat 4: a84b48e4 folded before Flop
Seat 5: 264c31b1 folded before Flop
Seat 6: 64c63b58 folded before Flop
Seat 7: b6ce17 folded before Flop
Seat 8: Hero (button) won (1,883)


Poker Hand #TM3558062168: Tournament #156882940, Bounty Hunters Special $3.20 Hold'em No Limit - Level1(50/100) - 2024/08/07 10:32:00
Table '41' 8-max Seat #6 is the button
Seat 2: c442e2db (9,970 in chips)
Seat 3: 14d0ae6a (9,972 in chips)
Seat 4: a84b48e4 (9,970 in chips)
Seat 5: 264c31b1 (15,630 in chips)
Seat 6: 64c63b58 (4,633 in chips)
Seat 8: Hero (9,870 in chips)
a84b48e4: posts the ante 15
c442e2db: posts the ante 15
14d0ae6a: posts the ante 15
64c63b58: posts the ante 15
264c31b1: posts the ante 15
Hero: posts the ante 15
Hero: posts small blind 50
c442e2db: posts big blind 100
*** HOLE CARDS ***
Dealt to c442e2db 
Dealt to 14d0ae6a 
Dealt to a84b48e4 
Dealt to 264c31b1 
Dealt to 64c63b58 
Dealt to Hero [7c 4c]
14d0ae6a: folds
a84b48e4: raises 150 to 250
264c31b1: folds
64c63b58: calls 250
Hero: folds
c442e2db: folds
*** FLOP *** [4h 7s Ad]
a84b48e4: bets 200
64c63b58: folds
Uncalled bet (200) returned to a84b48e4
*** SHOWDOWN ***
a84b48e4 collected 740 from pot
*** SUMMARY ***
Total pot 740 | Rake 0 | Jackpot 0 | Bingo 0 | Fortune 0 | Tax 0
Board [4h 7s Ad]
Seat 2: c442e2db (big blind) folded before Flop
Seat 3: 14d0ae6a folded before Flop
Seat 4: a84b48e4 won (740)
Seat 5: 264c31b1 folded before Flop
Seat 6: 64c63b58 (button) folded on the Flop
Seat 8: Hero (small blind) folded before Flop


Poker Hand #TM3558062136: Tournament #156882940, Bounty Hunters Special $3.20 Hold'em No Limit - Level1(50/100) - 2024/08/07 10:30:55
Table '41' 8-max Seat #5 is the button
Seat 1: 28bcf0bc (9,985 in chips)
Seat 2: c442e2db (9,985 in chips)
Seat 3: 14d0ae6a (9,785 in chips)
Seat 4: a84b48e4 (9,985 in chips)
Seat 5: 264c31b1 (15,845 in chips)
Seat 6: 64c63b58 (4,445 in chips)
Seat 8: Hero (9,985 in chips)
a84b48e4: posts the ante 15
28bcf0bc: posts the ante 15
c442e2db: posts the ante 15
14d0ae6a: posts the ante 15
64c63b58: posts the ante 15
264c31b1: posts the ante 15
Hero: posts the ante 15
64c63b58: posts small blind 50
Hero: posts big blind 100
*** HOLE CARDS ***
Dealt to 28bcf0bc 
Dealt to c442e2db 
Dealt to 14d0ae6a 
Dealt to a84b48e4 
Dealt to 264c31b1 
Dealt to 64c63b58 
Dealt to Hero [2h Jc]
28bcf0bc: folds
c442e2db: folds
14d0ae6a: raises 100 to 200
a84b48e4: folds
264c31b1: calls 200
64c63b58: calls 150
Hero: folds
*** FLOP *** [2c 3d 6c]
64c63b58: checks
14d0ae6a: bets 332
264c31b1: folds
64c63b58: calls 332
*** TURN *** [2c 3d 6c] [5s]
64c63b58: checks
14d0ae6a: bets 650
64c63b58: raises 3,248 to 3,898 and is all-in
14d0ae6a: calls 3,248
64c63b58: shows [4d 8c] (Sixes-High Straight)
14d0ae6a: shows [Ac 4c] (Sixes-High Straight)
*** RIVER *** [2c 3d 6c 5s] [Ts]
*** SHOWDOWN ***
14d0ae6a collected 4,632 from pot
64c63b58 collected 4,633 from pot
*** SUMMARY ***
Total pot 9,265 | Rake 0 | Jackpot 0 | Bingo 0 | Fortune 0 | Tax 0
Board [2c 3d 6c 5s Ts]
Seat 1: 28bcf0bc folded before Flop
Seat 2: c442e2db folded before Flop
Seat 3: 14d0ae6a showed [Ac 4c] and won (4,632) with Sixes-High Straight
Seat 4: a84b48e4 folded before Flop
Seat 5: 264c31b1 (button) folded on the Flop
Seat 6: 64c63b58 (small blind) showed [4d 8c] and won (4,633) with Sixes-High Straight
Seat 8: Hero (big blind) folded before Flop


Poker Hand #TM3558062110: Tournament #156882940, Bounty Hunters Special $3.20 Hold'em No Limit - Level1(50/100) - 2024/08/07 10:30:02
Table '41' 8-max Seat #4 is the button
Seat 1: 28bcf0bc (10,000 in chips)
Seat 2: c442e2db (10,000 in chips)
Seat 3: 14d0ae6a (10,000 in chips)
Seat 4: a84b48e4 (10,000 in chips)
Seat 5: 264c31b1 (10,000 in chips)
Seat 6: 64c63b58 (10,000 in chips)
Seat 7: 11e3d952 (10,000 in chips)
Seat 8: Hero (10,000 in chips)
a84b48e4: posts the ante 15
28bcf0bc: posts the ante 15
c442e2db: posts the ante 15
14d0ae6a: posts the ante 15
64c63b58: posts the ante 15
264c31b1: posts the ante 15
11e3d952: posts the ante 15
Hero: posts the ante 15
264c31b1: posts small blind 50
64c63b58: posts big blind 100
*** HOLE CARDS ***
Dealt to 28bcf0bc 
Dealt to c442e2db 
Dealt to 14d0ae6a 
Dealt to a84b48e4 
Dealt to 264c31b1 
Dealt to 64c63b58 
Dealt to 11e3d952 
Dealt to Hero [3c 6c]
11e3d952: folds
Hero: folds
28bcf0bc: folds
c442e2db: folds
14d0ae6a: raises 100 to 200
a84b48e4: folds
264c31b1: raises 620 to 820
64c63b58: calls 720
14d0ae6a: folds
*** FLOP *** [Kd Jd Th]
264c31b1: bets 1,300
64c63b58: calls 1,300
*** TURN *** [Kd Jd Th] [Kh]
264c31b1: bets 3,420
64c63b58: calls 3,420
*** RIVER *** [Kd Jd Th Kh] [3h]
264c31b1: bets 4,445 and is all-in
64c63b58: folds
Uncalled bet (4,445) returned to 264c31b1
*** SHOWDOWN ***
264c31b1 collected 11,400 from pot
*** SUMMARY ***
Total pot 11,400 | Rake 0 | Jackpot 0 | Bingo 0 | Fortune 0 | Tax 0
Board [Kd Jd Th Kh 3h]
Seat 1: 28bcf0bc folded before Flop
Seat 2: c442e2db folded before Flop
Seat 3: 14d0ae6a folded before Flop
Seat 4: a84b48e4 (button) folded before Flop
Seat 5: 264c31b1 (small blind) won (11,400)
Seat 6: 64c63b58 (big blind) folded on the River
Seat 7: 11e3d952 folded before Flop
Seat 8: Hero folded before Flop


